Day;Configuracion;NOperations;SOperations;TotalOperations;ConfigNorm
2018-01-01 02:30:00;NORTE;1;0;1;1
2018-01-01 03:00:00;NORTE;1;0;1;1
2018-01-01 03:30:00;NORTE;2;0;2;1
2018-01-01 04:00:00;NORTE;2;0;2;1
2018-01-01 04:30:00;NORTE;3;0;3;1
2018-01-01 05:00:00;NORTE;5;0;5;1
2018-01-01 05:30:00;NORTE;3;0;3;1
2018-01-01 06:00:00;NORTE;13;0;13;1
2018-01-01 06:30:00;NORTE;18;0;18;1
2018-01-01 07:00:00;NORTE;15;0;15;1
2018-01-01 07:30:00;NORTE;14;0;14;1
2018-01-01 08:00:00;NORTE;19;0;19;1
2018-01-01 08:30:00;NORTE;19;0;19;1
2018-01-01 09:00:00;NORTE;26;0;26;1
2018-01-01 09:30:00;NORTE;21;0;21;1
2018-01-01 10:00:00;NORTE;11;0;11;1
2018-01-01 10:30:00;NORTE;27;0;27;1
2018-01-01 11:00:00;NORTE;23;0;23;1
2018-01-01 11:30:00;SUR;0;26;26;1
2018-01-01 12:00:00;SUR;0;20;20;1
2018-01-01 12:30:00;SUR;0;17;17;1
2018-01-01 13:00:00;SUR;0;18;18;1
2018-01-01 13:30:00;SUR;0;22;22;1
2018-01-01 14:00:00;SUR;0;24;24;1
2018-01-01 14:30:00;SUR;0;25;25;1
2018-01-01 15:00:00;SUR;0;37;37;1
2018-01-01 15:30:00;SUR;0;15;15;1
2018-01-01 16:00:00;SUR;0;15;15;1
2018-01-01 16:30:00;SUR;0;18;18;1
2018-01-01 17:00:00;SUR;0;24;24;1
2018-01-01 17:30:00;SUR;0;30;30;1
2018-01-01 18:00:00;SUR;0;23;23;1
2018-01-01 18:30:00;SUR;0;29;29;1
2018-01-01 19:00:00;SUR;0;27;27;1
2018-01-01 19:30:00;SUR;0;19;19;1
2018-01-01 20:00:00;SUR;0;22;22;1
2018-01-01 20:30:00;SUR;0;23;23;1
2018-01-01 21:00:00;SUR;0;23;23;1
2018-01-01 21:30:00;SUR;0;18;18;1
2018-01-01 22:00:00;SUR;0;10;10;1
2018-01-01 22:30:00;SUR;0;9;9;1
2018-01-01 23:00:00;SUR;0;9;9;1
2018-01-01 23:30:00;SUR;0;4;4;1
2018-01-02 00:00:00;SUR;0;1;1;1
2018-01-02 00:30:00;SUR;0;2;2;1
2018-01-02 01:00:00;SUR;0;1;1;1
2018-01-02 01:30:00;SUR;0;1;1;1
2018-01-02 03:30:00;SUR;0;3;3;1
2018-01-02 04:00:00;SUR;0;4;4;1
2018-01-02 04:30:00;SUR;0;2;2;1
2018-01-02 05:00:00;CONFLICTIVA;7;1;8;2
2018-01-02 05:30:00;NORTE;12;0;12;1
2018-01-02 06:00:00;NORTE;12;0;12;1
2018-01-02 06:30:00;NORTE;37;0;37;1
2018-01-02 07:00:00;NORTE;20;0;20;1
2018-01-02 07:30:00;NORTE;17;0;17;1
2018-01-02 08:00:00;NORTE;28;0;28;1
2018-01-02 08:30:00;NORTE;23;0;23;1
2018-01-02 09:00:00;NORTE;33;0;33;1
2018-01-02 09:30:00;CONFLICTIVA;15;8;23;2
2018-01-02 10:00:00;SUR;0;21;21;1
2018-01-02 10:30:00;SUR;0;28;28;1
2018-01-02 11:00:00;SUR;0;25;25;1
2018-01-02 11:30:00;SUR;0;35;35;1
2018-01-02 12:00:00;SUR;0;28;28;1
2018-01-02 12:30:00;SUR;0;26;26;1
2018-01-02 13:00:00;SUR;0;28;28;1
2018-01-02 13:30:00;SUR;0;22;22;1
2018-01-02 14:00:00;SUR;0;28;28;1
2018-01-02 14:30:00;SUR;0;32;32;1
2018-01-02 15:00:00;SUR;0;31;31;1
2018-01-02 15:30:00;SUR;0;33;33;1
2018-01-02 16:00:00;SUR;0;18;18;1
2018-01-02 16:30:00;SUR;0;17;17;1
2018-01-02 17:00:00;CONFLICTIVA;5;12;17;2
2018-01-02 17:30:00;NORTE;28;0;28;1
2018-01-02 18:00:00;NORTE;24;0;24;1
2018-01-02 18:30:00;NORTE;25;0;25;1
2018-01-02 19:00:00;NORTE;29;0;29;1
2018-01-02 19:30:00;NORTE;34;0;34;1
2018-01-02 20:00:00;NORTE;21;0;21;1
2018-01-02 20:30:00;NORTE;19;0;19;1
2018-01-02 21:00:00;NORTE;29;0;29;1
2018-01-02 21:30:00;NORTE;21;0;21;1
2018-01-02 22:00:00;NORTE;8;0;8;1
2018-01-02 22:30:00;NORTE;10;0;10;1
2018-01-02 23:00:00;NORTE;10;0;10;1
2018-01-02 23:30:00;NORTE;4;0;4;1
2018-01-03 00:00:00;NORTE;1;0;1;1
2018-01-03 00:30:00;NORTE;3;0;3;1
2018-01-03 02:30:00;NORTE;2;0;2;1
2018-01-03 03:00:00;NORTE;3;0;3;1
2018-01-03 03:30:00;NORTE;1;0;1;1
2018-01-03 04:00:00;NORTE;5;0;5;1
2018-01-03 04:30:00;NORTE;4;0;4;1
2018-01-03 05:00:00;NORTE;7;0;7;1
2018-01-03 05:20:00;NORTE;4;0;4;1
2018-01-03 05:30:00;NORTE;9;0;9;1
2018-01-03 06:00:00;NORTE;9;0;9;1
2018-01-03 06:30:00;NORTE;23;0;23;1
2018-01-03 07:00:00;NORTE;19;0;19;1
2018-01-03 07:30:00;NORTE;11;0;11;1
2018-01-03 07:45:00;NORTE;12;0;12;1
2018-01-03 08:00:00;NORTE;26;0;26;1
2018-01-03 08:30:00;NORTE;16;0;16;1
2018-01-03 08:48:00;NORTE;8;0;8;1
2018-01-03 09:00:00;NORTE;16;0;16;1
2018-01-03 09:22:00;NORTE;7;0;7;1
2018-01-03 09:30:00;NORTE;30;0;30;1
2018-01-03 10:00:00;NORTE;28;0;28;1
2018-01-03 10:30:00;NORTE;27;0;27;1
2018-01-03 11:00:00;NORTE;29;0;29;1
2018-01-03 11:30:00;NORTE;29;0;29;1
2018-01-03 12:00:00;NORTE;31;0;31;1
2018-01-03 12:30:00;NORTE;17;0;17;1
2018-01-03 13:00:00;SUR;0;20;20;1
2018-01-03 13:30:00;SUR;0;30;30;1
2018-01-03 14:00:00;SUR;0;25;25;1
2018-01-03 14:30:00;SUR;0;34;34;1
2018-01-03 15:00:00;SUR;0;31;31;1
2018-01-03 15:30:00;SUR;0;29;29;1
2018-01-03 16:00:00;SUR;0;27;27;1
2018-01-03 16:30:00;SUR;0;18;18;1
2018-01-03 17:00:00;SUR;0;15;15;1
2018-01-03 17:30:00;SUR;0;20;20;1
2018-01-03 18:00:00;SUR;0;23;23;1
2018-01-03 18:30:00;SUR;0;27;27;1
2018-01-03 19:00:00;SUR;0;32;32;1
2018-01-03 19:30:00;SUR;0;25;25;1
2018-01-03 20:00:00;SUR;0;29;29;1
2018-01-03 20:30:00;SUR;0;22;22;1
2018-01-03 21:00:00;SUR;0;35;35;1
2018-01-03 21:30:00;SUR;0;18;18;1
2018-01-03 22:00:00;SUR;0;12;12;1
2018-01-03 22:30:00;CONFLICTIVA;2;3;5;2
2018-01-03 23:00:00;NORTE;11;0;11;1
2018-01-03 23:30:00;NORTE;6;0;6;1
2018-01-04 00:00:00;NORTE;1;0;1;1
2018-01-04 00:42:00;NORTE;1;0;1;1
2018-01-04 01:30:00;NORTE;1;0;1;1
2018-01-04 03:00:00;NORTE;4;0;4;1
2018-01-04 03:30:00;NORTE;3;0;3;1
2018-01-04 04:00:00;NORTE;4;0;4;1
2018-01-04 04:30:00;NORTE;4;0;4;1
2018-01-04 05:00:00;NORTE;10;0;10;1
2018-01-04 05:30:00;NORTE;5;0;5;1
2018-01-04 05:50:00;NORTE;4;0;4;1
2018-01-04 06:00:00;NORTE;12;0;12;1
2018-01-04 06:30:00;NORTE;36;0;36;1
2018-01-04 07:00:00;NORTE;14;0;14;1
2018-01-04 07:30:00;NORTE;17;0;17;1
2018-01-04 08:00:00;NORTE;29;0;29;1
2018-01-04 08:30:00;NORTE;20;0;20;1
2018-01-04 09:00:00;NORTE;22;0;22;1
2018-01-04 09:30:00;NORTE;30;0;30;1
2018-01-04 10:00:00;NORTE;21;0;21;1
2018-01-04 10:30:00;SUR;0;28;28;1
2018-01-04 11:00:00;SUR;0;35;35;1
2018-01-04 11:30:00;SUR;0;23;23;1
2018-01-04 12:00:00;SUR;0;29;29;1
2018-01-04 12:30:00;SUR;0;25;25;1
2018-01-04 13:00:00;SUR;0;23;23;1
2018-01-04 13:30:00;SUR;0;24;24;1
2018-01-04 14:00:00;SUR;0;28;28;1
2018-01-04 14:30:00;SUR;0;30;30;1
2018-01-04 15:00:00;SUR;0;30;30;1
2018-01-04 15:30:00;SUR;0;26;26;1
2018-01-04 16:00:00;SUR;0;10;10;1
2018-01-04 16:30:00;SUR;0;22;22;1
2018-01-04 17:00:00;SUR;0;19;19;1
2018-01-04 17:30:00;SUR;0;23;23;1
2018-01-04 18:00:00;SUR;0;31;31;1
2018-01-04 18:30:00;SUR;0;22;22;1
2018-01-04 19:00:00;SUR;0;31;31;1
2018-01-04 19:30:00;SUR;0;31;31;1
2018-01-04 20:00:00;SUR;0;18;18;1
2018-01-04 20:30:00;SUR;0;26;26;1
2018-01-04 21:00:00;SUR;0;28;28;1
2018-01-04 21:30:00;SUR;0;16;16;1
2018-01-04 22:00:00;SUR;0;13;13;1
2018-01-04 22:30:00;SUR;0;12;12;1
2018-01-04 23:00:00;SUR;0;11;11;1
2018-01-04 23:30:00;SUR;0;5;5;1
2018-01-05 00:00:00;SUR;0;1;1;1
2018-01-05 01:00:00;SUR;0;1;1;1
2018-01-05 01:30:00;SUR;0;1;1;1
2018-01-05 02:00:00;SUR;0;1;1;1
2018-01-05 02:30:00;SUR;0;1;1;1
2018-01-05 03:00:00;SUR;0;6;6;1
2018-01-05 03:30:00;SUR;0;1;1;1
2018-01-05 04:00:00;SUR;0;3;3;1
2018-01-05 04:30:00;SUR;0;5;5;1
2018-01-05 05:00:00;SUR;0;6;6;1
2018-01-05 05:30:00;SUR;0;10;10;1
2018-01-05 06:00:00;SUR;0;17;17;1
2018-01-05 06:30:00;SUR;0;28;28;1
2018-01-05 07:00:00;SUR;0;14;14;1
2018-01-05 07:30:00;SUR;0;19;19;1
2018-01-05 08:00:00;SUR;0;29;29;1
2018-01-05 08:30:00;SUR;0;23;23;1
2018-01-05 09:00:00;SUR;0;29;29;1
2018-01-05 09:30:00;SUR;0;27;27;1
2018-01-05 10:00:00;SUR;0;27;27;1
2018-01-05 10:30:00;SUR;0;25;25;1
2018-01-05 11:00:00;SUR;0;36;36;1
2018-01-05 11:30:00;SUR;0;26;26;1
2018-01-05 12:00:00;SUR;0;21;21;1
2018-01-05 12:30:00;SUR;0;23;23;1
2018-01-05 13:00:00;SUR;0;29;29;1
2018-01-05 13:30:00;SUR;0;30;30;1
2018-01-05 14:00:00;SUR;0;27;27;1
2018-01-05 14:30:00;SUR;0;29;29;1
2018-01-05 15:00:00;SUR;0;34;34;1
2018-01-05 15:30:00;SUR;0;29;29;1
2018-01-05 16:00:00;SUR;0;18;18;1
2018-01-05 16:30:00;SUR;0;17;17;1
2018-01-05 17:00:00;SUR;0;19;19;1
2018-01-05 17:30:00;SUR;0;22;22;1
2018-01-05 18:00:00;SUR;0;21;21;1
2018-01-05 18:30:00;SUR;0;28;28;1
2018-01-05 19:00:00;SUR;0;33;33;1
2018-01-05 19:30:00;SUR;0;20;20;1
2018-01-05 20:00:00;SUR;0;33;33;1
2018-01-05 20:30:00;SUR;0;26;26;1
2018-01-05 21:00:00;SUR;0;22;22;1
2018-01-05 21:30:00;SUR;0;22;22;1
2018-01-05 22:00:00;SUR;0;9;9;1
2018-01-05 22:30:00;CONFLICTIVA;2;5;7;2
2018-01-05 23:00:00;NORTE;11;0;11;1
2018-01-05 23:30:00;NORTE;4;0;4;1
2018-01-06 00:00:00;NORTE;2;0;2;1
2018-01-06 00:30:00;NORTE;1;0;1;1
2018-01-06 01:00:00;NORTE;1;0;1;1
2018-01-06 01:30:00;NORTE;1;0;1;1
2018-01-06 02:00:00;NORTE;1;0;1;1
2018-01-06 02:30:00;NORTE;1;0;1;1
2018-01-06 03:00:00;NORTE;3;0;3;1
2018-01-06 03:30:00;NORTE;2;0;2;1
2018-01-06 04:00:00;NORTE;2;0;2;1
2018-01-06 04:30:00;NORTE;1;0;1;1
2018-01-06 05:00:00;NORTE;8;0;8;1
2018-01-06 05:30:00;NORTE;11;0;11;1
2018-01-06 06:00:00;NORTE;15;0;15;1
2018-01-06 06:30:00;NORTE;23;0;23;1
2018-01-06 07:00:00;NORTE;12;0;12;1
2018-01-06 07:30:00;NORTE;15;0;15;1
2018-01-06 08:00:00;NORTE;29;0;29;1
2018-01-06 08:30:00;NORTE;20;0;20;1
2018-01-06 09:00:00;NORTE;34;0;34;1
2018-01-06 09:30:00;NORTE;25;0;25;1
2018-01-06 10:00:00;NORTE;20;0;20;1
2018-01-06 10:30:00;NORTE;30;0;30;1
2018-01-06 11:00:00;NORTE;32;0;32;1
2018-01-06 11:30:00;NORTE;27;0;27;1
2018-01-06 12:00:00;NORTE;21;0;21;1
2018-01-06 12:30:00;NORTE;26;0;26;1
2018-01-06 13:00:00;NORTE;24;0;24;1
2018-01-06 13:30:00;NORTE;25;0;25;1
2018-01-06 14:00:00;NORTE;26;0;26;1
2018-01-06 14:30:00;NORTE;24;0;24;1
2018-01-06 15:00:00;NORTE;30;0;30;1
2018-01-06 15:30:00;NORTE;27;0;27;1
2018-01-06 16:00:00;NORTE;15;0;15;1
2018-01-06 16:30:00;NORTE;16;0;16;1
2018-01-06 17:00:00;NORTE;21;0;21;1
2018-01-06 17:30:00;NORTE;22;0;22;1
2018-01-06 18:00:00;NORTE;19;0;19;1
2018-01-06 18:30:00;NORTE;18;0;18;1
2018-01-06 19:00:00;NORTE;25;0;25;1
2018-01-06 19:30:00;NORTE;17;0;17;1
2018-01-06 20:00:00;NORTE;17;0;17;1
2018-01-06 20:30:00;NORTE;17;0;17;1
2018-01-06 21:00:00;NORTE;23;0;23;1
2018-01-06 21:30:00;NORTE;19;0;19;1
2018-01-06 22:00:00;NORTE;11;0;11;1
2018-01-06 22:30:00;NORTE;7;0;7;1
2018-01-06 23:00:00;NORTE;9;0;9;1
2018-01-06 23:30:00;NORTE;2;0;2;1
2018-01-07 00:00:00;NORTE;2;0;2;1
2018-01-07 00:30:00;NORTE;2;0;2;1
2018-01-07 01:30:00;NORTE;1;0;1;1
2018-01-07 02:00:00;NORTE;1;0;1;1
2018-01-07 03:00:00;NORTE;1;0;1;1
2018-01-07 03:30:00;NORTE;3;0;3;1
2018-01-07 04:00:00;NORTE;4;0;4;1
2018-01-07 04:30:00;NORTE;1;0;1;1
2018-01-07 05:00:00;NORTE;6;0;6;1
2018-01-07 05:30:00;NORTE;10;0;10;1
2018-01-07 06:00:00;NORTE;15;0;15;1
2018-01-07 06:30:00;NORTE;19;0;19;1
2018-01-07 07:00:00;NORTE;13;0;13;1
2018-01-07 07:30:00;NORTE;22;0;22;1
2018-01-07 08:00:00;NORTE;25;0;25;1
2018-01-07 08:30:00;NORTE;19;0;19;1
2018-01-07 09:00:00;NORTE;35;0;35;1
2018-01-07 09:30:00;NORTE;26;0;26;1
2018-01-07 10:00:00;NORTE;19;0;19;1
2018-01-07 10:30:00;NORTE;32;0;32;1
2018-01-07 11:00:00;NORTE;34;0;34;1
2018-01-07 11:30:00;NORTE;24;0;24;1
2018-01-07 12:00:00;NORTE;23;0;23;1
2018-01-07 12:30:00;NORTE;25;0;25;1
2018-01-07 13:00:00;NORTE;28;0;28;1
2018-01-07 13:30:00;NORTE;29;0;29;1
2018-01-07 14:00:00;NORTE;20;0;20;1
2018-01-07 14:30:00;NORTE;18;0;18;1
2018-01-07 15:00:00;NORTE;43;0;43;1
2018-01-07 15:30:00;NORTE;38;0;38;1
2018-01-07 16:00:00;NORTE;25;0;25;1
2018-01-07 16:30:00;NORTE;21;0;21;1
2018-01-07 17:00:00;NORTE;18;0;18;1
2018-01-07 17:30:00;NORTE;26;0;26;1
2018-01-07 18:00:00;NORTE;22;0;22;1
2018-01-07 18:30:00;NORTE;28;0;28;1
2018-01-07 19:00:00;NORTE;34;0;34;1
2018-01-07 19:30:00;NORTE;33;0;33;1
2018-01-07 20:00:00;NORTE;29;0;29;1
2018-01-07 20:30:00;NORTE;30;0;30;1
2018-01-07 21:00:00;NORTE;33;0;33;1
2018-01-07 21:30:00;NORTE;17;0;17;1
2018-01-07 22:00:00;NORTE;16;0;16;1
2018-01-07 22:30:00;NORTE;13;0;13;1
2018-01-07 23:00:00;NORTE;6;0;6;1
2018-01-07 23:30:00;NORTE;10;0;10;1
2018-01-08 00:00:00;NORTE;2;0;2;1
2018-01-08 00:30:00;NORTE;4;0;4;1
2018-01-08 01:30:00;NORTE;1;0;1;1
2018-01-08 03:00:00;NORTE;2;0;2;1
2018-01-08 03:30:00;NORTE;3;0;3;1
2018-01-08 04:00:00;NORTE;4;0;4;1
2018-01-08 04:30:00;NORTE;2;0;2;1
2018-01-08 05:00:00;NORTE;3;0;3;1
2018-01-08 05:30:00;NORTE;11;0;11;1
2018-01-08 06:00:00;NORTE;9;0;9;1
2018-01-08 06:30:00;NORTE;31;0;31;1
2018-01-08 07:00:00;NORTE;22;0;22;1
2018-01-08 07:30:00;NORTE;29;0;29;1
2018-01-08 08:00:00;NORTE;36;0;36;1
2018-01-08 08:30:00;NORTE;32;0;32;1
2018-01-08 09:00:00;NORTE;31;0;31;1
2018-01-08 09:30:00;NORTE;26;0;26;1
2018-01-08 10:00:00;NORTE;24;0;24;1
2018-01-08 10:30:00;NORTE;30;0;30;1
2018-01-08 11:00:00;NORTE;35;0;35;1
2018-01-08 11:30:00;NORTE;28;0;28;1
2018-01-08 12:00:00;NORTE;18;0;18;1
2018-01-08 12:30:00;NORTE;27;0;27;1
2018-01-08 13:00:00;NORTE;23;0;23;1
2018-01-08 13:30:00;NORTE;23;0;23;1
2018-01-08 14:00:00;NORTE;33;0;33;1
2018-01-08 14:30:00;NORTE;24;0;24;1
2018-01-08 15:00:00;NORTE;37;0;37;1
2018-01-08 15:30:00;NORTE;23;0;23;1
2018-01-08 16:00:00;NORTE;21;0;21;1
2018-01-08 16:30:00;NORTE;20;0;20;1
2018-01-08 17:00:00;NORTE;22;0;22;1
2018-01-08 17:30:00;NORTE;30;0;30;1
2018-01-08 18:00:00;NORTE;18;0;18;1
2018-01-08 18:30:00;NORTE;27;0;27;1
2018-01-08 19:00:00;NORTE;27;0;27;1
2018-01-08 19:30:00;NORTE;31;0;31;1
2018-01-08 20:00:00;NORTE;25;0;25;1
2018-01-08 20:30:00;NORTE;28;0;28;1
2018-01-08 21:00:00;NORTE;28;0;28;1
2018-01-08 21:30:00;NORTE;15;0;15;1
2018-01-08 22:00:00;NORTE;14;0;14;1
2018-01-08 22:30:00;NORTE;6;0;6;1
2018-01-08 23:00:00;NORTE;12;0;12;1
2018-01-08 23:30:00;NORTE;6;0;6;1
2018-01-09 00:30:00;NORTE;1;0;1;1
2018-01-09 01:30:00;NORTE;1;0;1;1
2018-01-09 02:30:00;NORTE;1;0;1;1
2018-01-09 03:00:00;NORTE;3;0;3;1
2018-01-09 03:30:00;NORTE;3;0;3;1
2018-01-09 04:00:00;NORTE;4;0;4;1
2018-01-09 04:30:00;NORTE;3;0;3;1
2018-01-09 05:00:00;NORTE;8;0;8;1
2018-01-09 05:30:00;NORTE;4;0;4;1
2018-01-09 05:38:00;NORTE;4;0;4;1
2018-01-09 06:00:00;NORTE;17;0;17;1
2018-01-09 06:30:00;NORTE;26;0;26;1
2018-01-09 07:00:00;NORTE;17;0;17;1
2018-01-09 07:30:00;NORTE;28;0;28;1
2018-01-09 08:00:00;NORTE;20;0;20;1
2018-01-09 08:30:00;NORTE;15;0;15;1
2018-01-09 09:00:00;NORTE;34;0;34;1
2018-01-09 09:30:00;NORTE;24;0;24;1
2018-01-09 10:00:00;NORTE;21;0;21;1
2018-01-09 10:30:00;NORTE;33;0;33;1
2018-01-09 11:00:00;NORTE;35;0;35;1
2018-01-09 11:30:00;NORTE;22;0;22;1
2018-01-09 12:00:00;NORTE;26;0;26;1
2018-01-09 12:30:00;NORTE;25;0;25;1
2018-01-09 13:00:00;NORTE;24;0;24;1
2018-01-09 13:30:00;NORTE;30;0;30;1
2018-01-09 14:00:00;NORTE;20;0;20;1
2018-01-09 14:30:00;NORTE;26;0;26;1
2018-01-09 15:00:00;NORTE;36;0;36;1
2018-01-09 15:30:00;NORTE;18;0;18;1
2018-01-09 16:00:00;NORTE;20;0;20;1
2018-01-09 16:30:00;NORTE;20;0;20;1
2018-01-09 17:00:00;NORTE;5;0;5;1
2018-01-09 17:16:00;NORTE;13;0;13;1
2018-01-09 17:30:00;NORTE;28;0;28;1
2018-01-09 18:00:00;NORTE;21;0;21;1
2018-01-09 18:30:00;NORTE;20;0;20;1
2018-01-09 19:00:00;NORTE;21;0;21;1
2018-01-09 19:18:00;NORTE;12;0;12;1
2018-01-09 19:30:00;NORTE;26;0;26;1
2018-01-09 20:00:00;NORTE;16;0;16;1
2018-01-09 20:30:00;NORTE;20;0;20;1
2018-01-09 21:00:00;NORTE;26;0;26;1
2018-01-09 21:30:00;NORTE;13;0;13;1
2018-01-09 22:00:00;NORTE;12;0;12;1
2018-01-09 22:30:00;NORTE;7;0;7;1
2018-01-09 23:00:00;NORTE;7;0;7;1
2018-01-09 23:30:00;NORTE;5;0;5;1
2018-01-10 00:00:00;NORTE;1;0;1;1
2018-01-10 00:30:00;NORTE;1;0;1;1
2018-01-10 01:00:00;NORTE;2;0;2;1
2018-01-10 01:30:00;NORTE;1;0;1;1
2018-01-10 03:00:00;NORTE;4;0;4;1
2018-01-10 03:30:00;NORTE;3;0;3;1
2018-01-10 04:00:00;NORTE;2;0;2;1
2018-01-10 04:30:00;NORTE;5;0;5;1
2018-01-10 05:00:00;NORTE;8;0;8;1
2018-01-10 05:30:00;NORTE;9;0;9;1
2018-01-10 06:00:00;NORTE;14;0;14;1
2018-01-10 06:30:00;NORTE;42;0;42;1
2018-01-10 07:00:00;NORTE;11;0;11;1
2018-01-10 07:30:00;NORTE;19;0;19;1
2018-01-10 08:00:00;NORTE;33;0;33;1
2018-01-10 08:30:00;NORTE;17;0;17;1
2018-01-10 09:00:00;NORTE;27;0;27;1
2018-01-10 09:30:00;CONFLICTIVA;2;18;20;2
2018-01-10 10:00:00;SUR;0;29;29;1
2018-01-10 10:30:00;SUR;0;33;33;1
2018-01-10 11:00:00;SUR;0;30;30;1
2018-01-10 11:30:00;SUR;0;28;28;1
2018-01-10 12:00:00;SUR;0;26;26;1
2018-01-10 12:30:00;SUR;0;24;24;1
2018-01-10 13:00:00;SUR;0;19;19;1
2018-01-10 13:30:00;SUR;0;21;21;1
2018-01-10 14:00:00;SUR;0;28;28;1
2018-01-10 14:30:00;SUR;0;22;22;1
2018-01-10 15:00:00;SUR;0;29;29;1
2018-01-10 15:30:00;SUR;0;31;31;1
2018-01-10 16:00:00;SUR;0;24;24;1
2018-01-10 16:30:00;SUR;0;19;19;1
2018-01-10 17:00:00;SUR;0;16;16;1
2018-01-10 17:30:00;SUR;0;26;26;1
2018-01-10 18:00:00;SUR;0;29;29;1
2018-01-10 18:30:00;CONFLICTIVA;7;11;18;2
2018-01-10 19:00:00;NORTE;32;0;32;1
2018-01-10 19:30:00;NORTE;26;0;26;1
2018-01-10 20:00:00;NORTE;19;0;19;1
2018-01-10 20:30:00;NORTE;22;0;22;1
2018-01-10 21:00:00;NORTE;25;0;25;1
2018-01-10 21:30:00;NORTE;18;0;18;1
2018-01-10 22:00:00;NORTE;17;0;17;1
2018-01-10 22:30:00;NORTE;5;0;5;1
2018-01-10 23:00:00;NORTE;11;0;11;1
2018-01-10 23:30:00;NORTE;4;0;4;1
2018-01-11 00:00:00;NORTE;2;0;2;1
2018-01-11 01:00:00;NORTE;1;0;1;1
2018-01-11 01:30:00;NORTE;1;0;1;1
2018-01-11 03:00:00;NORTE;3;0;3;1
2018-01-11 03:30:00;NORTE;4;0;4;1
2018-01-11 04:00:00;NORTE;3;0;3;1
2018-01-11 04:30:00;NORTE;3;0;3;1
2018-01-11 05:00:00;NORTE;4;0;4;1
2018-01-11 05:30:00;NORTE;17;0;17;1
2018-01-11 06:00:00;NORTE;11;0;11;1
2018-01-11 06:30:00;NORTE;34;0;34;1
2018-01-11 07:00:00;NORTE;17;0;17;1
2018-01-11 07:30:00;NORTE;20;0;20;1
2018-01-11 08:00:00;NORTE;27;0;27;1
2018-01-11 08:30:00;NORTE;22;0;22;1
2018-01-11 09:00:00;NORTE;34;0;34;1
2018-01-11 09:30:00;NORTE;27;0;27;1
2018-01-11 10:00:00;NORTE;17;0;17;1
2018-01-11 10:30:00;NORTE;28;0;28;1
2018-01-11 11:00:00;NORTE;30;0;30;1
2018-01-11 11:30:00;NORTE;20;0;20;1
2018-01-11 12:00:00;NORTE;25;1;26;1
2018-01-11 12:30:00;NORTE;24;0;24;1
2018-01-11 13:00:00;NORTE;21;0;21;1
2018-01-11 13:30:00;NORTE;28;0;28;1
2018-01-11 14:00:00;NORTE;24;0;24;1
2018-01-11 14:30:00;NORTE;24;0;24;1
2018-01-11 15:00:00;NORTE;31;0;31;1
2018-01-11 15:30:00;NORTE;24;0;24;1
2018-01-11 16:00:00;NORTE;23;0;23;1
2018-01-11 16:30:00;NORTE;20;0;20;1
2018-01-11 17:00:00;NORTE;20;0;20;1
2018-01-11 17:30:00;NORTE;26;0;26;1
2018-01-11 18:00:00;NORTE;27;0;27;1
2018-01-11 18:30:00;NORTE;27;0;27;1
2018-01-11 19:00:00;NORTE;31;0;31;1
2018-01-11 19:30:00;NORTE;25;0;25;1
2018-01-11 20:00:00;NORTE;23;0;23;1
2018-01-11 20:30:00;NORTE;20;0;20;1
2018-01-11 21:00:00;NORTE;31;0;31;1
2018-01-11 21:30:00;NORTE;15;0;15;1
2018-01-11 22:00:00;NORTE;14;0;14;1
2018-01-11 22:30:00;NORTE;2;0;2;1
2018-01-11 23:00:00;NORTE;9;0;9;1
2018-01-11 23:30:00;NORTE;2;0;2;1
2018-01-12 00:00:00;NORTE;3;0;3;1
2018-01-12 01:00:00;NORTE;1;0;1;1
2018-01-12 01:30:00;NORTE;1;0;1;1
2018-01-12 02:00:00;NORTE;2;0;2;1
2018-01-12 03:00:00;NORTE;3;0;3;1
2018-01-12 03:30:00;NORTE;4;0;4;1
2018-01-12 04:00:00;NORTE;4;0;4;1
2018-01-12 04:30:00;NORTE;3;0;3;1
2018-01-12 05:00:00;NORTE;7;0;7;1
2018-01-12 05:30:00;NORTE;12;0;12;1
2018-01-12 06:00:00;NORTE;15;0;15;1
2018-01-12 06:30:00;NORTE;31;0;31;1
2018-01-12 07:00:00;NORTE;20;0;20;1
2018-01-12 07:30:00;NORTE;23;0;23;1
2018-01-12 08:00:00;NORTE;31;0;31;1
2018-01-12 08:30:00;NORTE;20;0;20;1
2018-01-12 09:00:00;NORTE;35;0;35;1
2018-01-12 09:30:00;NORTE;26;0;26;1
2018-01-12 10:00:00;NORTE;20;0;20;1
2018-01-12 10:30:00;NORTE;33;0;33;1
2018-01-12 11:00:00;NORTE;36;0;36;1
2018-01-12 11:30:00;NORTE;23;0;23;1
2018-01-12 12:00:00;NORTE;30;0;30;1
2018-01-12 12:30:00;NORTE;22;0;22;1
2018-01-12 13:00:00;NORTE;25;0;25;1
2018-01-12 13:30:00;NORTE;27;0;27;1
2018-01-12 14:00:00;NORTE;27;0;27;1
2018-01-12 14:30:00;NORTE;31;0;31;1
2018-01-12 15:00:00;NORTE;35;0;35;1
2018-01-12 15:30:00;NORTE;32;0;32;1
2018-01-12 16:00:00;NORTE;22;0;22;1
2018-01-12 16:30:00;NORTE;15;0;15;1
2018-01-12 17:00:00;NORTE;29;0;29;1
2018-01-12 17:30:00;NORTE;25;0;25;1
2018-01-12 18:00:00;NORTE;26;0;26;1
2018-01-12 18:30:00;NORTE;30;0;30;1
2018-01-12 19:00:00;NORTE;36;0;36;1
2018-01-12 19:30:00;NORTE;29;1;30;1
2018-01-12 20:00:00;NORTE;27;0;27;1
2018-01-12 20:30:00;NORTE;23;0;23;1
2018-01-12 21:00:00;NORTE;23;0;23;1
2018-01-12 21:30:00;NORTE;16;0;16;1
2018-01-12 22:00:00;NORTE;7;0;7;1
2018-01-12 22:30:00;NORTE;9;0;9;1
2018-01-12 23:00:00;NORTE;11;0;11;1
2018-01-12 23:30:00;NORTE;3;0;3;1
2018-01-13 00:30:00;NORTE;1;0;1;1
2018-01-13 01:30:00;NORTE;2;0;2;1
2018-01-13 02:30:00;NORTE;1;0;1;1
2018-01-13 03:00:00;NORTE;1;0;1;1
2018-01-13 03:30:00;NORTE;5;0;5;1
2018-01-13 04:30:00;NORTE;5;0;5;1
2018-01-13 05:00:00;NORTE;8;0;8;1
2018-01-13 05:30:00;NORTE;9;0;9;1
2018-01-13 06:00:00;NORTE;12;0;12;1
2018-01-13 06:30:00;NORTE;19;0;19;1
2018-01-13 07:00:00;NORTE;17;0;17;1
2018-01-13 07:30:00;NORTE;20;0;20;1
2018-01-13 08:00:00;NORTE;25;0;25;1
2018-01-13 08:30:00;NORTE;24;0;24;1
2018-01-13 09:00:00;NORTE;32;0;32;1
2018-01-13 09:30:00;NORTE;28;0;28;1
2018-01-13 10:00:00;NORTE;16;0;16;1
2018-01-13 10:30:00;NORTE;33;0;33;1
2018-01-13 11:00:00;NORTE;28;0;28;1
2018-01-13 11:30:00;NORTE;19;0;19;1
2018-01-13 12:00:00;NORTE;23;0;23;1
2018-01-13 12:30:00;NORTE;21;0;21;1
2018-01-13 13:00:00;NORTE;22;0;22;1
2018-01-13 13:30:00;NORTE;23;0;23;1
2018-01-13 14:00:00;NORTE;20;0;20;1
2018-01-13 14:30:00;NORTE;22;0;22;1
2018-01-13 15:00:00;NORTE;34;0;34;1
2018-01-13 15:30:00;NORTE;21;0;21;1
2018-01-13 16:00:00;NORTE;17;0;17;1
2018-01-13 16:30:00;NORTE;9;0;9;1
2018-01-13 16:44:00;NORTE;10;0;10;1
2018-01-13 17:00:00;NORTE;4;0;4;1
2018-01-13 17:12:00;NORTE;8;0;8;1
2018-01-13 17:30:00;NORTE;9;0;9;1
2018-01-13 17:42:00;NORTE;15;0;15;1
2018-01-13 18:00:00;NORTE;17;0;17;1
2018-01-13 18:30:00;NORTE;16;0;16;1
2018-01-13 19:00:00;NORTE;23;0;23;1
2018-01-13 19:30:00;NORTE;23;0;23;1
2018-01-13 20:00:00;NORTE;11;0;11;1
2018-01-13 20:30:00;NORTE;11;0;11;1
2018-01-13 21:00:00;NORTE;22;0;22;1
2018-01-13 21:30:00;NORTE;12;0;12;1
2018-01-13 22:00:00;NORTE;8;0;8;1
2018-01-13 22:30:00;NORTE;5;0;5;1
2018-01-13 23:00:00;NORTE;8;0;8;1
2018-01-13 23:30:00;NORTE;3;0;3;1
2018-01-14 00:00:00;NORTE;1;0;1;1
2018-01-14 00:30:00;NORTE;1;0;1;1
2018-01-14 01:30:00;NORTE;1;0;1;1
2018-01-14 02:00:00;NORTE;2;0;2;1
2018-01-14 02:30:00;NORTE;1;0;1;1
2018-01-14 03:00:00;NORTE;1;0;1;1
2018-01-14 03:30:00;NORTE;5;0;5;1
2018-01-14 04:00:00;NORTE;1;0;1;1
2018-01-14 04:30:00;NORTE;4;0;4;1
2018-01-14 05:00:00;NORTE;7;0;7;1
2018-01-14 05:30:00;NORTE;9;0;9;1
2018-01-14 06:00:00;NORTE;15;0;15;1
2018-01-14 06:30:00;NORTE;19;0;19;1
2018-01-14 07:00:00;NORTE;18;0;18;1
2018-01-14 07:30:00;NORTE;13;0;13;1
2018-01-14 08:00:00;NORTE;23;0;23;1
2018-01-14 08:30:00;NORTE;18;0;18;1
2018-01-14 09:00:00;NORTE;16;0;16;1
2018-01-14 09:15:00;NORTE;13;0;13;1
2018-01-14 09:30:00;NORTE;32;0;32;1
2018-01-14 10:00:00;NORTE;20;0;20;1
2018-01-14 10:30:00;NORTE;32;0;32;1
2018-01-14 11:00:00;NORTE;32;0;32;1
2018-01-14 11:30:00;NORTE;27;0;27;1
2018-01-14 12:00:00;NORTE;21;0;21;1
2018-01-14 12:30:00;NORTE;25;0;25;1
2018-01-14 13:00:00;NORTE;19;0;19;1
2018-01-14 13:30:00;NORTE;25;0;25;1
2018-01-14 14:00:00;NORTE;26;0;26;1
2018-01-14 14:30:00;NORTE;23;0;23;1
2018-01-14 15:00:00;NORTE;39;0;39;1
2018-01-14 15:30:00;NORTE;22;0;22;1
2018-01-14 16:00:00;NORTE;19;0;19;1
2018-01-14 16:30:00;NORTE;29;0;29;1
2018-01-14 17:00:00;NORTE;20;0;20;1
2018-01-14 17:30:00;NORTE;32;0;32;1
2018-01-14 18:00:00;NORTE;26;0;26;1
2018-01-14 18:30:00;NORTE;27;0;27;1
2018-01-14 19:00:00;NORTE;35;0;35;1
2018-01-14 19:30:00;NORTE;33;0;33;1
2018-01-14 20:00:00;NORTE;23;0;23;1
2018-01-14 20:30:00;NORTE;26;0;26;1
2018-01-14 21:00:00;NORTE;27;0;27;1
2018-01-14 21:30:00;NORTE;12;0;12;1
2018-01-14 22:00:00;NORTE;12;0;12;1
2018-01-14 22:30:00;NORTE;9;0;9;1
2018-01-14 23:00:00;NORTE;11;0;11;1
2018-01-14 23:30:00;NORTE;3;0;3;1
2018-01-15 00:00:00;NORTE;2;0;2;1
2018-01-15 00:30:00;NORTE;4;0;4;1
2018-01-15 03:00:00;NORTE;2;0;2;1
2018-01-15 03:30:00;NORTE;3;0;3;1
2018-01-15 04:00:00;NORTE;2;0;2;1
2018-01-15 04:30:00;NORTE;2;0;2;1
2018-01-15 05:00:00;NORTE;7;0;7;1
2018-01-15 05:30:00;NORTE;13;0;13;1
2018-01-15 06:00:00;NORTE;19;0;19;1
2018-01-15 06:30:00;NORTE;30;0;30;1
2018-01-15 07:00:00;NORTE;18;0;18;1
2018-01-15 07:30:00;NORTE;20;0;20;1
2018-01-15 08:00:00;NORTE;29;0;29;1
2018-01-15 08:30:00;NORTE;27;0;27;1
2018-01-15 09:00:00;NORTE;25;0;25;1
2018-01-15 09:30:00;NORTE;28;0;28;1
2018-01-15 10:00:00;NORTE;24;0;24;1
2018-01-15 10:30:00;NORTE;35;0;35;1
2018-01-15 11:00:00;NORTE;26;0;26;1
2018-01-15 11:30:00;NORTE;29;0;29;1
2018-01-15 12:00:00;NORTE;22;0;22;1
2018-01-15 12:30:00;NORTE;19;0;19;1
2018-01-15 13:00:00;NORTE;30;0;30;1
2018-01-15 13:30:00;NORTE;27;0;27;1
2018-01-15 14:00:00;NORTE;32;0;32;1
2018-01-15 14:30:00;NORTE;28;0;28;1
2018-01-15 15:00:00;NORTE;29;0;29;1
2018-01-15 15:30:00;NORTE;19;0;19;1
2018-01-15 16:00:00;NORTE;26;0;26;1
2018-01-15 16:30:00;NORTE;22;0;22;1
2018-01-15 17:00:00;NORTE;23;0;23;1
2018-01-15 17:30:00;NORTE;32;0;32;1
2018-01-15 18:00:00;NORTE;28;0;28;1
2018-01-15 18:30:00;NORTE;25;0;25;1
2018-01-15 19:00:00;NORTE;37;0;37;1
2018-01-15 19:30:00;NORTE;22;0;22;1
2018-01-15 20:00:00;NORTE;20;0;20;1
2018-01-15 20:30:00;NORTE;25;0;25;1
2018-01-15 21:00:00;NORTE;22;0;22;1
2018-01-15 21:30:00;NORTE;19;0;19;1
2018-01-15 22:00:00;NORTE;11;0;11;1
2018-01-15 22:30:00;NORTE;5;0;5;1
2018-01-15 23:00:00;NORTE;12;0;12;1
2018-01-15 23:30:00;NORTE;2;0;2;1
2018-01-16 00:00:00;NORTE;1;0;1;1
2018-01-16 00:30:00;NORTE;1;0;1;1
2018-01-16 01:30:00;NORTE;1;0;1;1
2018-01-16 02:00:00;NORTE;1;0;1;1
2018-01-16 03:00:00;NORTE;3;0;3;1
2018-01-16 04:00:00;NORTE;6;0;6;1
2018-01-16 04:30:00;NORTE;6;0;6;1
2018-01-16 05:00:00;NORTE;6;0;6;1
2018-01-16 05:30:00;NORTE;14;0;14;1
2018-01-16 06:00:00;NORTE;15;0;15;1
2018-01-16 06:30:00;NORTE;33;0;33;1
2018-01-16 07:00:00;NORTE;17;0;17;1
2018-01-16 07:30:00;NORTE;19;0;19;1
2018-01-16 08:00:00;NORTE;24;0;24;1
2018-01-16 08:30:00;NORTE;20;0;20;1
2018-01-16 09:00:00;NORTE;25;0;25;1
2018-01-16 09:30:00;NORTE;33;0;33;1
2018-01-16 10:00:00;NORTE;21;0;21;1
2018-01-16 10:30:00;NORTE;35;0;35;1
2018-01-16 11:00:00;NORTE;25;0;25;1
2018-01-16 11:30:00;NORTE;29;0;29;1
2018-01-16 12:00:00;NORTE;22;0;22;1
2018-01-16 12:30:00;NORTE;21;0;21;1
2018-01-16 13:00:00;NORTE;24;0;24;1
2018-01-16 13:30:00;NORTE;29;0;29;1
2018-01-16 14:00:00;NORTE;22;0;22;1
2018-01-16 14:30:00;NORTE;20;0;20;1
2018-01-16 15:00:00;NORTE;31;0;31;1
2018-01-16 15:30:00;NORTE;19;0;19;1
2018-01-16 16:00:00;NORTE;24;0;24;1
2018-01-16 16:30:00;NORTE;19;0;19;1
2018-01-16 17:00:00;NORTE;16;0;16;1
2018-01-16 17:30:00;NORTE;31;0;31;1
2018-01-16 18:00:00;NORTE;27;0;27;1
2018-01-16 18:30:00;NORTE;25;0;25;1
2018-01-16 19:00:00;NORTE;27;0;27;1
2018-01-16 19:30:00;NORTE;23;0;23;1
2018-01-16 20:00:00;NORTE;17;0;17;1
2018-01-16 20:30:00;NORTE;23;0;23;1
2018-01-16 21:00:00;NORTE;28;0;28;1
2018-01-16 21:30:00;NORTE;12;0;12;1
2018-01-16 22:00:00;NORTE;10;0;10;1
2018-01-16 22:30:00;NORTE;7;0;7;1
2018-01-16 23:00:00;NORTE;8;0;8;1
2018-01-16 23:30:00;NORTE;4;0;4;1
2018-01-17 00:00:00;NORTE;1;0;1;1
2018-01-17 00:30:00;NORTE;1;0;1;1
2018-01-17 01:00:00;NORTE;2;0;2;1
2018-01-17 01:30:00;NORTE;1;0;1;1
2018-01-17 02:00:00;NORTE;1;0;1;1
2018-01-17 03:00:00;NORTE;5;0;5;1
2018-01-17 03:30:00;NORTE;2;0;2;1
2018-01-17 04:00:00;NORTE;3;0;3;1
2018-01-17 04:30:00;NORTE;5;0;5;1
2018-01-17 05:00:00;NORTE;8;0;8;1
2018-01-17 05:30:00;NORTE;12;0;12;1
2018-01-17 06:00:00;NORTE;5;0;5;1
2018-01-17 06:30:00;NORTE;6;0;6;1
2018-01-17 06:46:00;NORTE;11;0;11;1
2018-01-17 07:00:00;NORTE;22;0;22;1
2018-01-17 07:30:00;NORTE;27;0;27;1
2018-01-17 08:00:00;NORTE;31;0;31;1
2018-01-17 08:30:00;NORTE;17;0;17;1
2018-01-17 08:51:00;NORTE;7;0;7;1
2018-01-17 09:00:00;NORTE;20;0;20;1
2018-01-17 09:30:00;NORTE;24;0;24;1
2018-01-17 10:00:00;NORTE;37;0;37;1
2018-01-17 10:30:00;NORTE;28;0;28;1
2018-01-17 11:00:39;NORTE;1;0;1;1
2018-01-17 11:01:03;NORTE;1;0;1;1
2018-01-17 11:02:39;NORTE;1;0;1;1
2018-01-17 11:04:00;NORTE;1;0;1;1
2018-01-17 11:04:32;NORTE;1;0;1;1
2018-01-17 11:05:11;NORTE;1;0;1;1
2018-01-17 11:06:27;NORTE;1;0;1;1
2018-01-17 11:06:42;NORTE;1;0;1;1
2018-01-17 11:06:50;NORTE;1;0;1;1
2018-01-17 11:07:07;NORTE;1;0;1;1
2018-01-17 11:07:52;NORTE;1;0;1;1
2018-01-17 11:08:36;NORTE;1;0;1;1
2018-01-17 11:09:40;NORTE;1;0;1;1
2018-01-17 11:10:05;NORTE;1;0;1;1
2018-01-17 11:10:15;NORTE;1;0;1;1
2018-01-17 11:10:44;NORTE;1;0;1;1
2018-01-17 11:11:24;NORTE;1;0;1;1
2018-01-17 11:13:27;NORTE;1;0;1;1
2018-01-17 11:13:46;NORTE;1;0;1;1
2018-01-17 11:14:15;NORTE;1;0;1;1
2018-01-17 11:16:38;NORTE;1;0;1;1
2018-01-17 11:16:44;NORTE;1;0;1;1
2018-01-17 11:17:12;NORTE;1;0;1;1
2018-01-17 11:17:55;NORTE;1;0;1;1
2018-01-17 11:18:24;NORTE;1;0;1;1
2018-01-17 11:19:16;NORTE;1;0;1;1
2018-01-17 11:19:54;NORTE;1;0;1;1
2018-01-17 11:20:39;NORTE;1;0;1;1
2018-01-17 11:20:45;NORTE;1;0;1;1
2018-01-17 11:21:18;NORTE;1;0;1;1
2018-01-17 11:22:44;NORTE;1;0;1;1
2018-01-17 11:23:46;NORTE;1;0;1;1
2018-01-17 11:25:11;NORTE;1;0;1;1
2018-01-17 11:25:13;NORTE;1;0;1;1
2018-01-17 11:26:17;NORTE;1;0;1;1
2018-01-17 11:26:33;NORTE;1;0;1;1
2018-01-17 11:27:10;NORTE;1;0;1;1
2018-01-17 11:27:34;NORTE;1;0;1;1
2018-01-17 11:27:48;NORTE;1;0;1;1
2018-01-17 11:28:49;NORTE;1;0;1;1
2018-01-17 11:29:20;NORTE;1;0;1;1
2018-01-17 11:29:48;NORTE;1;0;1;1
2018-01-17 11:30:00;NORTE;25;0;25;1
2018-01-17 12:00:00;NORTE;19;0;19;1
2018-01-17 12:30:00;NORTE;21;0;21;1
2018-01-17 13:00:00;NORTE;20;0;20;1
2018-01-17 13:30:00;NORTE;32;0;32;1
2018-01-17 14:00:00;NORTE;27;0;27;1
2018-01-17 14:30:00;NORTE;23;0;23;1
2018-01-17 15:00:00;NORTE;36;0;36;1
2018-01-17 15:30:00;NORTE;28;0;28;1
2018-01-17 16:00:00;NORTE;21;0;21;1
2018-01-17 16:30:00;NORTE;16;0;16;1
2018-01-17 17:00:00;NORTE;18;0;18;1
2018-01-17 17:30:00;NORTE;28;0;28;1
2018-01-17 18:00:00;NORTE;28;0;28;1
2018-01-17 18:30:00;NORTE;17;0;17;1
2018-01-17 19:00:00;NORTE;34;0;34;1
2018-01-17 19:30:00;NORTE;30;0;30;1
2018-01-17 20:00:00;NORTE;19;0;19;1
2018-01-17 20:30:00;NORTE;28;0;28;1
2018-01-17 21:00:00;NORTE;28;0;28;1
2018-01-17 21:30:00;NORTE;22;0;22;1
2018-01-17 22:00:00;NORTE;11;0;11;1
2018-01-17 22:30:00;NORTE;6;0;6;1
2018-01-17 23:00:00;NORTE;8;0;8;1
2018-01-17 23:30:00;NORTE;4;0;4;1
2018-01-18 01:30:00;NORTE;2;0;2;1
2018-01-18 02:00:00;NORTE;1;0;1;1
2018-01-18 03:00:00;NORTE;2;0;2;1
2018-01-18 03:30:00;NORTE;1;0;1;1
2018-01-18 04:00:00;NORTE;6;0;6;1
2018-01-18 04:30:00;NORTE;4;0;4;1
2018-01-18 05:00:00;NORTE;5;0;5;1
2018-01-18 05:30:00;NORTE;16;0;16;1
2018-01-18 06:00:00;NORTE;20;0;20;1
2018-01-18 06:30:00;NORTE;30;0;30;1
2018-01-18 07:00:00;NORTE;15;0;15;1
2018-01-18 07:30:00;NORTE;18;0;18;1
2018-01-18 08:00:00;NORTE;33;0;33;1
2018-01-18 08:30:00;NORTE;24;0;24;1
2018-01-18 09:00:00;NORTE;30;0;30;1
2018-01-18 09:30:00;NORTE;29;0;29;1
2018-01-18 10:00:00;NORTE;21;0;21;1
2018-01-18 10:30:00;NORTE;30;0;30;1
2018-01-18 11:00:00;NORTE;29;0;29;1
2018-01-18 11:30:00;NORTE;25;0;25;1
2018-01-18 12:00:00;NORTE;22;0;22;1
2018-01-18 12:30:00;NORTE;21;0;21;1
2018-01-18 13:00:00;NORTE;24;0;24;1
2018-01-18 13:30:00;NORTE;29;0;29;1
2018-01-18 14:00:00;NORTE;26;0;26;1
2018-01-18 14:30:00;NORTE;22;0;22;1
2018-01-18 15:00:00;NORTE;34;0;34;1
2018-01-18 15:30:00;NORTE;22;0;22;1
2018-01-18 16:00:00;NORTE;12;0;12;1
2018-01-18 16:30:00;NORTE;18;0;18;1
2018-01-18 17:00:00;NORTE;25;0;25;1
2018-01-18 17:30:00;NORTE;28;0;28;1
2018-01-18 18:00:00;NORTE;28;0;28;1
2018-01-18 18:30:00;NORTE;31;0;31;1
2018-01-18 19:00:00;NORTE;33;0;33;1
2018-01-18 19:30:00;NORTE;27;0;27;1
2018-01-18 20:00:00;NORTE;18;0;18;1
2018-01-18 20:30:00;NORTE;25;0;25;1
2018-01-18 21:00:00;NORTE;28;0;28;1
2018-01-18 21:30:00;NORTE;15;0;15;1
2018-01-18 22:00:00;NORTE;11;0;11;1
2018-01-18 22:30:00;NORTE;10;0;10;1
2018-01-18 23:00:00;NORTE;11;0;11;1
2018-01-18 23:30:00;NORTE;6;0;6;1
2018-01-19 00:00:00;NORTE;1;0;1;1
2018-01-19 00:30:00;NORTE;1;0;1;1
2018-01-19 01:00:00;NORTE;2;0;2;1
2018-01-19 02:00:00;NORTE;1;0;1;1
2018-01-19 02:30:00;NORTE;1;0;1;1
2018-01-19 03:00:00;NORTE;5;0;5;1
2018-01-19 03:30:00;NORTE;3;0;3;1
2018-01-19 04:30:00;NORTE;4;0;4;1
2018-01-19 05:00:00;NORTE;12;0;12;1
2018-01-19 05:30:00;NORTE;10;0;10;1
2018-01-19 06:00:00;NORTE;19;0;19;1
2018-01-19 06:30:00;NORTE;25;0;25;1
2018-01-19 07:00:00;NORTE;20;0;20;1
2018-01-19 07:30:00;NORTE;23;0;23;1
2018-01-19 08:00:00;NORTE;29;0;29;1
2018-01-19 08:30:00;NORTE;22;0;22;1
2018-01-19 09:00:00;NORTE;33;0;33;1
2018-01-19 09:30:00;NORTE;27;0;27;1
2018-01-19 10:00:00;NORTE;21;0;21;1
2018-01-19 10:30:00;NORTE;33;0;33;1
2018-01-19 11:00:00;NORTE;39;0;39;1
2018-01-19 11:30:00;NORTE;25;0;25;1
2018-01-19 12:00:00;NORTE;21;0;21;1
2018-01-19 12:30:00;NORTE;24;0;24;1
2018-01-19 13:00:00;NORTE;23;0;23;1
2018-01-19 13:30:00;NORTE;3;0;3;1
2018-01-19 14:00:00;NORTE;18;0;18;1
2018-01-19 14:30:00;NORTE;28;0;28;1
2018-01-19 15:00:00;NORTE;31;0;31;1
2018-01-19 15:30:00;NORTE;22;0;22;1
2018-01-19 16:00:00;NORTE;3;0;3;1
2018-01-19 16:30:00;NORTE;13;0;13;1
2018-01-19 17:00:00;NORTE;23;0;23;1
2018-01-19 17:30:00;NORTE;29;0;29;1
2018-01-19 18:00:00;NORTE;29;0;29;1
2018-01-19 18:30:00;NORTE;23;0;23;1
2018-01-19 19:00:00;NORTE;38;0;38;1
2018-01-19 19:30:00;NORTE;31;0;31;1
2018-01-19 20:00:00;NORTE;24;0;24;1
2018-01-19 20:30:00;NORTE;24;0;24;1
2018-01-19 21:00:00;NORTE;30;0;30;1
2018-01-19 21:30:00;NORTE;17;0;17;1
2018-01-19 22:00:00;NORTE;7;0;7;1
2018-01-19 22:30:00;NORTE;8;0;8;1
2018-01-19 23:00:00;NORTE;13;0;13;1
2018-01-19 23:30:00;NORTE;3;0;3;1
2018-01-20 00:00:00;NORTE;1;0;1;1
2018-01-20 01:30:00;NORTE;1;0;1;1
2018-01-20 03:00:00;NORTE;4;0;4;1
2018-01-20 03:30:00;NORTE;3;0;3;1
2018-01-20 04:00:00;NORTE;1;0;1;1
2018-01-20 04:30:00;NORTE;4;0;4;1
2018-01-20 05:00:00;NORTE;7;0;7;1
2018-01-20 05:30:00;NORTE;15;0;15;1
2018-01-20 06:00:00;NORTE;16;0;16;1
2018-01-20 06:30:00;NORTE;20;0;20;1
2018-01-20 07:00:00;NORTE;18;0;18;1
2018-01-20 07:30:00;NORTE;17;0;17;1
2018-01-20 08:00:00;NORTE;28;0;28;1
2018-01-20 08:30:00;NORTE;16;0;16;1
2018-01-20 09:00:00;NORTE;32;0;32;1
2018-01-20 09:30:00;NORTE;23;0;23;1
2018-01-20 10:00:00;NORTE;22;0;22;1
2018-01-20 10:30:00;NORTE;26;0;26;1
2018-01-20 11:00:00;NORTE;28;0;28;1
2018-01-20 11:30:00;NORTE;22;0;22;1
2018-01-20 12:00:00;NORTE;24;0;24;1
2018-01-20 12:30:00;NORTE;20;0;20;1
2018-01-20 13:00:00;NORTE;18;0;18;1
2018-01-20 13:30:00;NORTE;26;0;26;1
2018-01-20 14:00:00;NORTE;21;0;21;1
2018-01-20 14:30:00;NORTE;15;0;15;1
2018-01-20 15:00:00;NORTE;31;0;31;1
2018-01-20 15:30:00;NORTE;17;0;17;1
2018-01-20 16:00:00;NORTE;17;0;17;1
2018-01-20 16:30:00;NORTE;14;0;14;1
2018-01-20 17:00:00;NORTE;15;0;15;1
2018-01-20 17:30:00;NORTE;21;0;21;1
2018-01-20 18:00:00;NORTE;16;0;16;1
2018-01-20 18:30:00;NORTE;23;0;23;1
2018-01-20 19:00:00;NORTE;26;0;26;1
2018-01-20 19:30:00;NORTE;14;0;14;1
2018-01-20 20:00:00;NORTE;15;0;15;1
2018-01-20 20:30:00;NORTE;20;0;20;1
2018-01-20 21:00:00;NORTE;14;0;14;1
2018-01-20 21:30:00;NORTE;10;0;10;1
2018-01-20 22:00:00;NORTE;9;0;9;1
2018-01-20 22:30:00;NORTE;5;0;5;1
2018-01-20 23:00:00;NORTE;9;0;9;1
2018-01-20 23:30:00;NORTE;3;0;3;1
2018-01-21 00:00:00;NORTE;1;0;1;1
2018-01-21 01:00:00;NORTE;1;0;1;1
2018-01-21 02:00:00;NORTE;3;0;3;1
2018-01-21 02:30:00;NORTE;2;0;2;1
2018-01-21 03:30:00;NORTE;1;0;1;1
2018-01-21 04:00:00;NORTE;4;0;4;1
2018-01-21 04:30:00;NORTE;4;0;4;1
2018-01-21 05:00:00;NORTE;7;0;7;1
2018-01-21 05:30:00;NORTE;7;0;7;1
2018-01-21 06:00:00;NORTE;16;0;16;1
2018-01-21 06:30:00;NORTE;22;0;22;1
2018-01-21 07:00:00;NORTE;16;0;16;1
2018-01-21 07:30:00;NORTE;18;0;18;1
2018-01-21 08:00:00;NORTE;18;0;18;1
2018-01-21 08:30:00;NORTE;26;0;26;1
2018-01-21 09:00:00;NORTE;25;0;25;1
2018-01-21 09:30:00;NORTE;27;0;27;1
2018-01-21 10:00:00;NORTE;16;0;16;1
2018-01-21 10:30:00;NORTE;27;0;27;1
2018-01-21 11:00:00;NORTE;32;0;32;1
2018-01-21 11:30:00;NORTE;26;0;26;1
2018-01-21 12:00:00;NORTE;29;0;29;1
2018-01-21 12:30:00;NORTE;19;0;19;1
2018-01-21 13:00:00;NORTE;24;0;24;1
2018-01-21 13:30:00;NORTE;26;0;26;1
2018-01-21 14:00:00;NORTE;29;0;29;1
2018-01-21 14:30:00;NORTE;27;1;28;1
2018-01-21 15:00:00;NORTE;32;0;32;1
2018-01-21 15:30:00;NORTE;29;0;29;1
2018-01-21 16:00:00;NORTE;19;0;19;1
2018-01-21 16:30:00;NORTE;19;0;19;1
2018-01-21 17:00:00;NORTE;19;0;19;1
2018-01-21 17:30:00;NORTE;30;0;30;1
2018-01-21 18:00:00;NORTE;25;0;25;1
2018-01-21 18:30:00;NORTE;21;0;21;1
2018-01-21 19:00:00;NORTE;29;0;29;1
2018-01-21 19:30:00;NORTE;33;0;33;1
2018-01-21 20:00:00;NORTE;23;0;23;1
2018-01-21 20:30:00;NORTE;26;0;26;1
2018-01-21 21:00:00;NORTE;29;0;29;1
2018-01-21 21:30:00;NORTE;12;0;12;1
2018-01-21 22:00:00;NORTE;14;0;14;1
2018-01-21 22:30:54;NORTE;1;0;1;1
2018-01-21 22:32:21;NORTE;1;0;1;1
2018-01-21 22:34:48;NORTE;1;0;1;1
2018-01-21 22:36:08;NORTE;1;0;1;1
2018-01-21 22:39:21;NORTE;1;0;1;1
2018-01-21 22:40:54;NORTE;1;0;1;1
2018-01-21 22:43:24;NORTE;1;0;1;1
2018-01-21 22:45:41;NORTE;1;0;1;1
2018-01-21 22:48:18;NORTE;1;0;1;1
2018-01-21 22:48:56;NORTE;1;0;1;1
2018-01-21 22:53:13;NORTE;1;0;1;1
2018-01-21 22:59:53;NORTE;1;0;1;1
2018-01-21 23:00:00;NORTE;11;0;11;1
2018-01-21 23:30:00;NORTE;5;0;5;1
2018-01-22 00:00:00;NORTE;1;0;1;1
2018-01-22 00:30:00;NORTE;2;0;2;1
2018-01-22 01:00:00;NORTE;1;0;1;1
2018-01-22 02:00:00;NORTE;1;0;1;1
2018-01-22 02:30:00;NORTE;2;0;2;1
2018-01-22 03:00:00;NORTE;1;0;1;1
2018-01-22 03:30:00;NORTE;5;0;5;1
2018-01-22 04:30:00;NORTE;2;0;2;1
2018-01-22 05:00:00;NORTE;8;0;8;1
2018-01-22 05:30:00;NORTE;10;0;10;1
2018-01-22 06:00:00;NORTE;14;0;14;1
2018-01-22 06:30:00;NORTE;43;0;43;1
2018-01-22 07:00:00;NORTE;15;0;15;1
2018-01-22 07:30:00;NORTE;27;0;27;1
2018-01-22 08:00:00;NORTE;26;0;26;1
2018-01-22 08:30:00;NORTE;22;0;22;1
2018-01-22 09:00:00;NORTE;35;0;35;1
2018-01-22 09:30:00;NORTE;30;0;30;1
2018-01-22 10:00:00;NORTE;13;0;13;1
2018-01-22 10:30:00;NORTE;36;0;36;1
2018-01-22 11:00:00;NORTE;29;0;29;1
2018-01-22 11:30:00;NORTE;29;0;29;1
2018-01-22 12:00:00;NORTE;25;0;25;1
2018-01-22 12:30:00;NORTE;27;0;27;1
2018-01-22 13:00:00;NORTE;28;0;28;1
2018-01-22 13:30:00;NORTE;34;0;34;1
2018-01-22 14:00:00;NORTE;24;0;24;1
2018-01-22 14:30:00;NORTE;28;0;28;1
2018-01-22 15:00:00;NORTE;32;0;32;1
2018-01-22 15:30:00;NORTE;25;0;25;1
2018-01-22 16:00:00;NORTE;18;0;18;1
2018-01-22 16:30:00;NORTE;21;0;21;1
2018-01-22 17:00:00;NORTE;21;0;21;1
2018-01-22 17:30:00;NORTE;29;0;29;1
2018-01-22 18:00:00;NORTE;23;0;23;1
2018-01-22 18:30:00;NORTE;23;0;23;1
2018-01-22 19:00:00;NORTE;33;0;33;1
2018-01-22 19:30:00;NORTE;36;0;36;1
2018-01-22 20:00:00;NORTE;18;0;18;1
2018-01-22 20:30:00;NORTE;30;0;30;1
2018-01-22 21:00:00;NORTE;26;0;26;1
2018-01-22 21:30:00;NORTE;15;0;15;1
2018-01-22 22:00:00;NORTE;11;0;11;1
2018-01-22 22:30:00;NORTE;7;0;7;1
2018-01-22 23:00:00;NORTE;10;0;10;1
2018-01-22 23:30:00;NORTE;3;0;3;1
2018-01-23 00:30:00;NORTE;1;0;1;1
2018-01-23 01:00:00;NORTE;1;0;1;1
2018-01-23 02:30:00;NORTE;1;0;1;1
2018-01-23 03:00:00;NORTE;2;0;2;1
2018-01-23 03:30:00;NORTE;4;0;4;1
2018-01-23 04:00:00;NORTE;2;0;2;1
2018-01-23 04:30:00;NORTE;6;0;6;1
2018-01-23 05:00:00;NORTE;10;0;10;1
2018-01-23 05:30:00;NORTE;10;0;10;1
2018-01-23 06:00:00;NORTE;17;0;17;1
2018-01-23 06:30:00;NORTE;36;0;36;1
2018-01-23 07:00:00;NORTE;14;0;14;1
2018-01-23 07:30:00;NORTE;20;0;20;1
2018-01-23 08:00:00;NORTE;30;0;30;1
2018-01-23 08:30:00;NORTE;25;0;25;1
2018-01-23 09:01:27;NORTE;1;0;1;1
2018-01-23 09:03:09;NORTE;1;0;1;1
2018-01-23 09:04:19;NORTE;1;0;1;1
2018-01-23 09:04:47;NORTE;1;0;1;1
2018-01-23 09:06:14;NORTE;1;0;1;1
2018-01-23 09:06:27;NORTE;1;0;1;1
2018-01-23 09:07:02;NORTE;1;0;1;1
2018-01-23 09:07:54;NORTE;1;0;1;1
2018-01-23 09:09:07;NORTE;1;0;1;1
2018-01-23 09:10:06;NORTE;1;0;1;1
2018-01-23 09:12:58;NORTE;1;0;1;1
2018-01-23 09:13:53;NORTE;1;0;1;1
2018-01-23 09:14:36;NORTE;1;0;1;1
2018-01-23 09:15:28;NORTE;1;0;1;1
2018-01-23 09:17:34;NORTE;1;0;1;1
2018-01-23 09:18:12;NORTE;1;0;1;1
2018-01-23 09:18:41;NORTE;1;0;1;1
2018-01-23 09:20:04;NORTE;1;0;1;1
2018-01-23 09:20:14;NORTE;1;0;1;1
2018-01-23 09:21:42;NORTE;1;0;1;1
2018-01-23 09:22:29;NORTE;1;0;1;1
2018-01-23 09:23:16;NORTE;1;0;1;1
2018-01-23 09:23:52;NORTE;1;0;1;1
2018-01-23 09:24:29;NORTE;1;0;1;1
2018-01-23 09:25:13;NORTE;1;0;1;1
2018-01-23 09:25:58;NORTE;1;0;1;1
2018-01-23 09:26:54;NORTE;1;0;1;1
2018-01-23 09:28:12;NORTE;1;0;1;1
2018-01-23 09:28:13;NORTE;1;0;1;1
2018-01-23 09:29:39;NORTE;1;0;1;1
2018-01-23 09:29:57;NORTE;1;0;1;1
2018-01-23 09:30:00;NORTE;28;0;28;1
2018-01-23 10:00:00;NORTE;14;0;14;1
2018-01-23 10:30:00;NORTE;29;0;29;1
2018-01-23 11:00:00;NORTE;28;0;28;1
2018-01-23 11:30:00;NORTE;23;0;23;1
2018-01-23 12:00:00;NORTE;28;0;28;1
2018-01-23 12:30:00;NORTE;24;0;24;1
2018-01-23 13:00:00;NORTE;20;0;20;1
2018-01-23 13:30:00;NORTE;20;0;20;1
2018-01-23 14:00:00;NORTE;20;0;20;1
2018-01-23 14:30:00;NORTE;26;0;26;1
2018-01-23 15:00:00;NORTE;34;0;34;1
2018-01-23 15:30:00;NORTE;19;0;19;1
2018-01-23 16:00:00;NORTE;16;0;16;1
2018-01-23 16:30:00;NORTE;16;0;16;1
2018-01-23 17:00:00;NORTE;19;0;19;1
2018-01-23 17:30:00;NORTE;30;0;30;1
2018-01-23 18:00:00;NORTE;18;0;18;1
2018-01-23 18:30:00;NORTE;29;0;29;1
2018-01-23 19:00:00;NORTE;31;0;31;1
2018-01-23 19:30:00;NORTE;19;0;19;1
2018-01-23 20:00:00;NORTE;16;0;16;1
2018-01-23 20:30:00;NORTE;25;0;25;1
2018-01-23 21:00:00;NORTE;28;0;28;1
2018-01-23 21:30:00;NORTE;10;0;10;1
2018-01-23 22:00:00;NORTE;14;0;14;1
2018-01-23 22:30:00;NORTE;2;0;2;1
2018-01-23 23:00:00;NORTE;7;0;7;1
2018-01-23 23:30:00;NORTE;4;0;4;1
2018-01-24 00:30:00;NORTE;2;0;2;1
2018-01-24 01:30:00;NORTE;1;0;1;1
2018-01-24 02:00:00;NORTE;1;0;1;1
2018-01-24 03:00:00;NORTE;4;0;4;1
2018-01-24 03:30:00;NORTE;3;0;3;1
2018-01-24 04:00:00;NORTE;1;0;1;1
2018-01-24 04:30:00;NORTE;4;0;4;1
2018-01-24 05:00:00;NORTE;11;0;11;1
2018-01-24 05:30:00;NORTE;13;0;13;1
2018-01-24 06:00:00;NORTE;13;0;13;1
2018-01-24 06:30:00;NORTE;30;0;30;1
2018-01-24 07:00:00;NORTE;18;0;18;1
2018-01-24 07:30:00;NORTE;14;0;14;1
2018-01-24 08:00:00;NORTE;22;0;22;1
2018-01-24 21:30:00;NORTE;1;0;1;1
2018-01-24 22:00:00;NORTE;8;0;8;1
2018-01-24 22:30:00;NORTE;10;0;10;1
2018-01-24 23:00:00;NORTE;10;0;10;1
2018-01-24 23:30:00;NORTE;1;0;1;1
2018-01-25 00:30:00;NORTE;2;0;2;1
2018-01-25 01:30:00;NORTE;1;0;1;1
2018-01-25 02:30:00;NORTE;1;0;1;1
2018-01-25 03:00:00;NORTE;4;0;4;1
2018-01-25 03:30:00;NORTE;2;0;2;1
2018-01-25 04:00:00;NORTE;2;0;2;1
2018-01-25 04:30:00;NORTE;4;0;4;1
2018-01-25 05:00:00;NORTE;8;0;8;1
2018-01-25 05:30:00;NORTE;13;0;13;1
2018-01-25 06:00:00;NORTE;14;0;14;1
2018-01-25 06:30:00;NORTE;39;0;39;1
2018-01-25 07:00:00;NORTE;13;0;13;1
2018-01-25 07:30:00;NORTE;17;0;17;1
2018-01-25 08:00:00;NORTE;30;0;30;1
2018-01-25 08:30:00;NORTE;22;0;22;1
2018-01-25 09:00:00;NORTE;27;0;27;1
2018-01-25 09:30:00;NORTE;26;0;26;1
2018-01-25 10:00:00;NORTE;18;0;18;1
2018-01-25 10:30:00;NORTE;27;0;27;1
2018-01-25 11:00:00;NORTE;34;0;34;1
2018-01-25 11:30:00;NORTE;22;0;22;1
2018-01-25 12:00:00;CONFLICTIVA;3;16;19;2
2018-01-25 12:30:00;SUR;0;21;21;1
2018-01-25 13:00:00;SUR;0;17;17;1
2018-01-25 13:30:00;SUR;0;27;27;1
2018-01-25 14:00:00;SUR;0;31;31;1
2018-01-25 14:30:00;SUR;0;22;22;1
2018-01-25 15:00:00;SUR;0;31;31;1
2018-01-25 15:30:00;SUR;0;24;24;1
2018-01-25 16:00:00;SUR;0;14;14;1
2018-01-25 16:30:00;SUR;0;19;19;1
2018-01-25 17:00:00;SUR;0;20;20;1
2018-01-25 17:30:00;SUR;0;20;20;1
2018-01-25 18:00:00;SUR;0;30;30;1
2018-01-25 18:30:00;SUR;0;27;27;1
2018-01-25 19:00:00;SUR;0;29;29;1
2018-01-25 19:30:00;SUR;0;20;20;1
2018-01-25 20:00:00;NORTE;26;0;26;1
2018-01-25 20:30:00;NORTE;23;0;23;1
2018-01-25 21:00:00;NORTE;34;0;34;1
2018-01-25 21:30:00;NORTE;16;0;16;1
2018-01-25 22:00:00;NORTE;10;0;10;1
2018-01-25 22:30:00;NORTE;14;0;14;1
2018-01-25 23:00:00;NORTE;10;0;10;1
2018-01-25 23:30:00;NORTE;4;0;4;1
2018-01-26 00:00:00;NORTE;1;0;1;1
2018-01-26 01:30:00;NORTE;2;0;2;1
2018-01-26 02:00:00;NORTE;1;0;1;1
2018-01-26 02:30:00;NORTE;2;0;2;1
2018-01-26 03:00:00;NORTE;4;0;4;1
2018-01-26 04:00:00;NORTE;2;0;2;1
2018-01-26 04:30:00;NORTE;6;0;6;1
2018-01-26 05:00:00;NORTE;8;0;8;1
2018-01-26 05:30:00;NORTE;11;0;11;1
2018-01-26 06:00:00;NORTE;13;0;13;1
2018-01-26 06:30:00;NORTE;31;0;31;1
2018-01-26 07:00:00;NORTE;18;0;18;1
2018-01-26 07:30:00;NORTE;21;0;21;1
2018-01-26 08:00:00;NORTE;36;0;36;1
2018-01-26 08:30:00;NORTE;22;0;22;1
2018-01-26 09:00:00;NORTE;33;0;33;1
2018-01-26 09:30:00;NORTE;30;0;30;1
2018-01-26 10:00:00;NORTE;21;0;21;1
2018-01-26 10:30:00;NORTE;32;0;32;1
2018-01-26 11:00:00;NORTE;32;0;32;1
2018-01-26 11:30:00;NORTE;33;0;33;1
2018-01-26 12:00:00;NORTE;17;0;17;1
2018-01-26 12:30:00;NORTE;21;0;21;1
2018-01-26 13:00:00;NORTE;24;0;24;1
2018-01-26 13:30:00;NORTE;29;0;29;1
2018-01-26 14:00:00;NORTE;32;0;32;1
2018-01-26 14:30:00;NORTE;24;0;24;1
2018-01-26 15:00:00;NORTE;32;0;32;1
2018-01-26 15:30:00;NORTE;24;0;24;1
2018-01-26 16:00:00;NORTE;21;0;21;1
2018-01-26 16:30:00;NORTE;18;0;18;1
2018-01-26 17:00:00;NORTE;21;0;21;1
2018-01-26 17:30:00;NORTE;29;0;29;1
2018-01-26 18:00:00;NORTE;30;0;30;1
2018-01-26 18:30:00;NORTE;26;0;26;1
2018-01-26 19:00:00;NORTE;37;0;37;1
2018-01-26 19:30:00;NORTE;26;0;26;1
2018-01-26 20:00:00;NORTE;26;0;26;1
2018-01-26 20:30:00;NORTE;21;0;21;1
2018-01-26 21:00:00;NORTE;22;0;22;1
2018-01-26 21:30:00;NORTE;22;0;22;1
2018-01-26 22:00:00;NORTE;11;0;11;1
2018-01-26 22:30:00;NORTE;9;0;9;1
2018-01-26 23:00:00;NORTE;12;0;12;1
2018-01-26 23:30:00;NORTE;3;0;3;1
2018-01-27 00:30:00;NORTE;1;0;1;1
2018-01-27 01:30:00;NORTE;1;0;1;1
2018-01-27 03:00:00;NORTE;2;0;2;1
2018-01-27 03:30:00;NORTE;3;0;3;1
2018-01-27 04:00:00;NORTE;1;0;1;1
2018-01-27 04:30:00;NORTE;2;0;2;1
2018-01-27 05:00:00;NORTE;7;0;7;1
2018-01-27 05:30:00;NORTE;15;0;15;1
2018-01-27 06:00:00;NORTE;16;0;16;1
2018-01-27 06:30:00;NORTE;25;0;25;1
2018-01-27 07:00:00;NORTE;13;0;13;1
2018-01-27 07:30:00;NORTE;19;0;19;1
2018-01-27 08:00:00;NORTE;28;0;28;1
2018-01-27 08:30:00;NORTE;23;0;23;1
2018-01-27 09:00:00;NORTE;31;0;31;1
2018-01-27 09:30:00;NORTE;18;0;18;1
2018-01-27 10:00:00;NORTE;20;0;20;1
2018-01-27 10:30:00;NORTE;32;0;32;1
2018-01-27 11:00:00;NORTE;26;0;26;1
2018-01-27 11:30:00;NORTE;16;0;16;1
2018-01-27 12:00:00;NORTE;20;0;20;1
2018-01-27 12:30:00;NORTE;17;0;17;1
2018-01-27 13:00:00;NORTE;27;0;27;1
2018-01-27 13:30:00;NORTE;12;0;12;1
2018-01-27 14:00:00;NORTE;24;0;24;1
2018-01-27 14:30:00;NORTE;25;0;25;1
2018-01-27 15:00:00;NORTE;29;0;29;1
2018-01-27 15:30:00;NORTE;16;0;16;1
2018-01-27 16:00:00;NORTE;16;0;16;1
2018-01-27 16:30:00;NORTE;11;0;11;1
2018-01-27 17:00:00;NORTE;19;0;19;1
2018-01-27 17:30:00;NORTE;22;0;22;1
2018-01-27 18:00:00;NORTE;19;0;19;1
2018-01-27 18:30:00;NORTE;20;0;20;1
2018-01-27 19:00:00;NORTE;30;0;30;1
2018-01-27 19:30:00;NORTE;14;0;14;1
2018-01-27 20:00:00;NORTE;17;0;17;1
2018-01-27 20:30:00;NORTE;15;0;15;1
2018-01-27 21:00:00;NORTE;19;0;19;1
2018-01-27 21:30:00;NORTE;10;0;10;1
2018-01-27 22:00:00;NORTE;7;0;7;1
2018-01-27 22:30:00;NORTE;3;0;3;1
2018-01-27 23:00:00;NORTE;8;0;8;1
2018-01-27 23:30:00;NORTE;3;0;3;1
2018-01-28 00:00:00;NORTE;1;0;1;1
2018-01-28 01:00:00;NORTE;1;0;1;1
2018-01-28 01:30:00;NORTE;1;0;1;1
2018-01-28 02:00:00;NORTE;2;0;2;1
2018-01-28 02:30:00;NORTE;1;0;1;1
2018-01-28 03:30:00;NORTE;4;0;4;1
2018-01-28 04:30:00;NORTE;1;0;1;1
2018-01-28 05:00:00;NORTE;9;0;9;1
2018-01-28 05:30:00;NORTE;11;0;11;1
2018-01-28 06:00:00;NORTE;14;0;14;1
2018-01-28 06:30:00;NORTE;21;0;21;1
2018-01-28 07:00:00;NORTE;19;0;19;1
2018-01-28 07:30:00;NORTE;18;0;18;1
2018-01-28 08:00:00;NORTE;22;0;22;1
2018-01-28 08:30:00;NORTE;26;0;26;1
2018-01-28 09:00:00;NORTE;21;0;21;1
2018-01-28 09:30:00;NORTE;22;0;22;1
2018-01-28 10:00:00;NORTE;23;0;23;1
2018-01-28 10:30:00;NORTE;26;0;26;1
2018-01-28 11:00:00;NORTE;33;0;33;1
2018-01-28 11:30:00;NORTE;23;0;23;1
2018-01-28 12:00:00;NORTE;25;0;25;1
2018-01-28 12:30:00;NORTE;18;0;18;1
2018-01-28 13:00:00;NORTE;33;0;33;1
2018-01-28 13:30:00;NORTE;22;0;22;1
2018-01-28 14:00:00;NORTE;26;0;26;1
2018-01-28 14:30:00;NORTE;29;0;29;1
2018-01-28 15:00:00;NORTE;29;0;29;1
2018-01-28 15:30:00;NORTE;27;0;27;1
2018-01-28 16:00:00;NORTE;19;0;19;1
2018-01-28 16:30:00;NORTE;18;0;18;1
2018-01-28 17:00:00;NORTE;22;0;22;1
2018-01-28 17:30:00;NORTE;37;0;37;1
2018-01-28 18:00:00;NORTE;20;0;20;1
2018-01-28 18:30:00;NORTE;24;0;24;1
2018-01-28 19:00:00;NORTE;33;0;33;1
2018-01-28 19:30:00;NORTE;32;0;32;1
2018-01-28 20:00:00;NORTE;26;0;26;1
2018-01-28 20:30:00;NORTE;23;0;23;1
2018-01-28 21:00:00;NORTE;30;0;30;1
2018-01-28 21:30:00;NORTE;14;0;14;1
2018-01-28 22:00:00;NORTE;13;0;13;1
2018-01-28 22:30:00;NORTE;8;0;8;1
2018-01-28 23:00:00;NORTE;13;0;13;1
2018-01-28 23:30:00;NORTE;6;0;6;1
2018-01-29 00:00:00;NORTE;2;0;2;1
2018-01-29 00:30:00;NORTE;1;0;1;1
2018-01-29 01:00:00;NORTE;1;0;1;1
2018-01-29 01:30:00;NORTE;1;0;1;1
2018-01-29 02:30:00;NORTE;1;0;1;1
2018-01-29 03:00:00;NORTE;2;0;2;1
2018-01-29 03:30:00;NORTE;5;0;5;1
2018-01-29 04:30:00;NORTE;4;0;4;1
2018-01-29 05:00:00;NORTE;9;0;9;1
2018-01-29 05:30:00;NORTE;10;0;10;1
2018-01-29 06:00:00;NORTE;14;0;14;1
2018-01-29 06:30:00;NORTE;35;0;35;1
2018-01-29 07:00:00;NORTE;15;0;15;1
2018-01-29 07:30:00;NORTE;22;0;22;1
2018-01-29 08:00:00;NORTE;31;0;31;1
2018-01-29 08:30:00;NORTE;20;0;20;1
2018-01-29 09:00:00;NORTE;34;0;34;1
2018-01-29 09:30:00;NORTE;31;0;31;1
2018-01-29 10:00:00;NORTE;15;0;15;1
2018-01-29 10:30:00;NORTE;33;0;33;1
2018-01-29 11:00:00;NORTE;26;0;26;1
2018-01-29 11:30:00;NORTE;29;0;29;1
2018-01-29 12:00:00;NORTE;26;0;26;1
2018-01-29 12:30:00;NORTE;21;0;21;1
2018-01-29 13:00:00;NORTE;27;0;27;1
2018-01-29 13:30:00;NORTE;24;0;24;1
2018-01-29 14:00:00;NORTE;26;0;26;1
2018-01-29 14:30:00;NORTE;29;0;29;1
2018-01-29 15:00:00;NORTE;33;0;33;1
2018-01-29 15:30:00;NORTE;20;0;20;1
2018-01-29 16:00:00;NORTE;16;0;16;1
2018-01-29 16:30:00;NORTE;19;0;19;1
2018-01-29 17:00:00;NORTE;20;0;20;1
2018-01-29 17:30:00;NORTE;37;0;37;1
2018-01-29 18:00:00;NORTE;28;0;28;1
2018-01-29 18:30:00;NORTE;26;0;26;1
2018-01-29 19:00:00;NORTE;31;0;31;1
2018-01-29 19:30:00;NORTE;26;0;26;1
2018-01-29 20:00:00;NORTE;20;0;20;1
2018-01-29 20:30:00;NORTE;25;0;25;1
2018-01-29 21:00:00;NORTE;27;0;27;1
2018-01-29 21:30:00;NORTE;17;0;17;1
2018-01-29 22:00:00;NORTE;11;0;11;1
2018-01-29 22:30:00;NORTE;5;0;5;1
2018-01-29 23:00:00;NORTE;11;0;11;1
2018-01-29 23:30:00;NORTE;5;0;5;1
2018-01-30 00:00:00;NORTE;1;0;1;1
2018-01-30 01:30:00;NORTE;1;0;1;1
2018-01-30 02:30:00;NORTE;1;0;1;1
2018-01-30 03:00:00;NORTE;3;0;3;1
2018-01-30 03:30:00;NORTE;5;0;5;1
2018-01-30 04:00:00;NORTE;1;0;1;1
2018-01-30 04:30:00;NORTE;6;0;6;1
2018-01-30 05:00:00;NORTE;9;0;9;1
2018-01-30 05:30:00;NORTE;12;0;12;1
2018-01-30 06:00:00;NORTE;16;0;16;1
2018-01-30 06:30:00;NORTE;34;0;34;1
2018-01-30 07:00:00;NORTE;17;0;17;1
2018-01-30 07:30:00;NORTE;19;0;19;1
2018-01-30 08:00:00;NORTE;26;0;26;1
2018-01-30 08:30:00;NORTE;23;0;23;1
2018-01-30 09:00:00;NORTE;31;0;31;1
2018-01-30 09:30:00;NORTE;27;0;27;1
2018-01-30 10:00:00;NORTE;19;0;19;1
2018-01-30 10:30:00;NORTE;29;0;29;1
2018-01-30 11:00:00;NORTE;28;0;28;1
2018-01-30 11:30:00;NORTE;21;0;21;1
2018-01-30 12:00:00;NORTE;10;0;10;1
2018-01-30 12:30:00;NORTE;22;0;22;1
2018-01-30 13:00:00;NORTE;22;0;22;1
2018-01-30 13:30:00;NORTE;22;0;22;1
2018-01-30 14:00:00;NORTE;18;0;18;1
2018-01-30 14:30:00;NORTE;22;0;22;1
2018-01-30 15:00:00;NORTE;31;0;31;1
2018-01-30 15:30:00;NORTE;19;0;19;1
2018-01-30 16:00:00;NORTE;18;0;18;1
2018-01-30 16:30:00;NORTE;13;0;13;1
2018-01-30 17:00:00;NORTE;19;0;19;1
2018-01-30 17:30:00;NORTE;32;0;32;1
2018-01-30 18:00:00;NORTE;19;0;19;1
2018-01-30 18:30:00;NORTE;27;0;27;1
2018-01-30 19:00:00;NORTE;27;0;27;1
2018-01-30 19:30:00;NORTE;23;1;24;1
2018-01-30 20:00:00;NORTE;12;0;12;1
2018-01-30 20:30:00;NORTE;23;0;23;1
2018-01-30 21:00:00;NORTE;24;0;24;1
2018-01-30 21:30:00;NORTE;15;0;15;1
2018-01-30 22:00:00;NORTE;9;0;9;1
2018-01-30 22:30:00;NORTE;8;0;8;1
2018-01-30 23:00:00;NORTE;5;0;5;1
2018-01-30 23:30:00;NORTE;4;0;4;1
2018-01-31 00:00:00;NORTE;1;0;1;1
2018-01-31 00:30:00;NORTE;1;0;1;1
2018-01-31 01:30:00;NORTE;1;0;1;1
2018-01-31 02:30:00;NORTE;1;0;1;1
2018-01-31 03:00:00;NORTE;2;0;2;1
2018-01-31 03:30:00;NORTE;3;0;3;1
2018-01-31 04:00:00;NORTE;4;0;4;1
2018-01-31 04:30:00;NORTE;4;0;4;1
2018-01-31 05:00:00;NORTE;9;0;9;1
2018-01-31 05:30:00;NORTE;10;0;10;1
2018-01-31 06:00:00;NORTE;18;0;18;1
2018-01-31 06:30:00;NORTE;34;0;34;1
2018-01-31 07:00:00;NORTE;19;0;19;1
2018-01-31 07:30:00;NORTE;17;0;17;1
2018-01-31 08:00:00;NORTE;30;0;30;1
2018-01-31 08:30:00;NORTE;20;0;20;1
2018-01-31 09:00:00;NORTE;34;0;34;1
2018-01-31 09:30:00;NORTE;26;0;26;1
2018-01-31 10:00:00;NORTE;23;0;23;1
2018-01-31 10:30:00;NORTE;32;0;32;1
2018-01-31 11:00:00;NORTE;31;0;31;1
2018-01-31 11:30:00;NORTE;28;0;28;1
2018-01-31 12:00:00;NORTE;25;0;25;1
2018-01-31 12:30:00;NORTE;23;0;23;1
2018-01-31 13:00:00;NORTE;23;0;23;1
2018-01-31 13:30:00;NORTE;28;0;28;1
2018-01-31 14:00:00;NORTE;26;0;26;1
2018-01-31 14:30:00;NORTE;25;0;25;1
2018-01-31 15:00:00;NORTE;36;0;36;1
2018-01-31 15:30:00;NORTE;24;0;24;1
2018-01-31 16:00:00;NORTE;24;0;24;1
2018-01-31 16:30:00;NORTE;16;0;16;1
2018-01-31 17:00:00;NORTE;20;0;20;1
2018-01-31 17:30:00;NORTE;27;0;27;1
2018-01-31 18:00:00;NORTE;30;0;30;1
2018-01-31 18:30:00;NORTE;22;0;22;1
2018-01-31 19:00:00;NORTE;26;0;26;1
2018-01-31 19:30:00;NORTE;22;0;22;1
2018-01-31 20:00:00;NORTE;25;0;25;1
2018-01-31 20:30:00;NORTE;28;0;28;1
2018-01-31 21:00:00;NORTE;30;0;30;1
2018-01-31 21:30:00;NORTE;13;0;13;1
2018-01-31 22:00:00;NORTE;14;0;14;1
2018-01-31 22:30:00;NORTE;8;0;8;1
2018-01-31 23:00:00;NORTE;12;0;12;1
2018-01-31 23:30:00;NORTE;1;0;1;1
2018-02-01 00:00:00;NORTE;2;0;2;1
2018-02-01 01:00:00;NORTE;1;0;1;1
2018-02-01 01:30:00;NORTE;1;0;1;1
2018-02-01 02:00:00;NORTE;1;0;1;1
2018-02-01 02:30:00;NORTE;1;0;1;1
2018-02-01 03:00:00;NORTE;4;0;4;1
2018-02-01 03:30:00;NORTE;3;0;3;1
2018-02-01 04:00:00;NORTE;4;0;4;1
2018-02-01 04:30:00;NORTE;2;0;2;1
2018-02-01 05:00:00;NORTE;11;0;11;1
2018-02-01 05:30:00;NORTE;13;0;13;1
2018-02-01 06:00:00;NORTE;19;0;19;1
2018-02-01 06:30:00;NORTE;36;0;36;1
2018-02-01 07:00:00;NORTE;20;0;20;1
2018-02-01 07:30:00;NORTE;18;0;18;1
2018-02-01 08:00:00;NORTE;34;0;34;1
2018-02-01 08:30:00;NORTE;18;0;18;1
2018-02-01 09:00:00;NORTE;32;0;32;1
2018-02-01 09:30:00;NORTE;28;0;28;1
2018-02-01 10:00:00;NORTE;19;0;19;1
2018-02-01 10:30:00;NORTE;32;0;32;1
2018-02-01 11:00:00;NORTE;32;0;32;1
2018-02-01 11:30:00;NORTE;20;0;20;1
2018-02-01 12:00:00;NORTE;28;0;28;1
2018-02-01 12:30:00;NORTE;21;0;21;1
2018-02-01 13:00:00;NORTE;20;0;20;1
2018-02-01 13:30:00;NORTE;33;0;33;1
2018-02-01 14:00:00;NORTE;29;0;29;1
2018-02-01 14:30:00;NORTE;25;0;25;1
2018-02-01 15:00:00;NORTE;31;0;31;1
2018-02-01 15:30:00;NORTE;11;0;11;1
2018-02-01 16:00:00;NORTE;19;0;19;1
2018-02-01 16:30:00;NORTE;12;0;12;1
2018-02-01 17:00:00;NORTE;23;0;23;1
2018-02-01 17:30:00;NORTE;12;0;12;1
2018-02-01 18:00:00;NORTE;31;0;31;1
2018-02-01 18:30:00;NORTE;27;0;27;1
2018-02-01 19:00:00;NORTE;37;0;37;1
2018-02-01 19:30:00;NORTE;28;0;28;1
2018-02-01 20:00:00;NORTE;20;0;20;1
2018-02-01 20:30:00;NORTE;26;0;26;1
2018-02-01 21:00:00;NORTE;29;0;29;1
2018-02-01 21:30:00;NORTE;16;0;16;1
2018-02-01 22:00:00;NORTE;19;0;19;1
2018-02-01 22:30:00;NORTE;9;0;9;1
2018-02-01 23:00:00;NORTE;9;0;9;1
2018-02-01 23:30:00;NORTE;5;0;5;1
2018-02-02 01:00:00;NORTE;1;0;1;1
2018-02-02 01:30:00;NORTE;2;0;2;1
2018-02-02 02:00:00;NORTE;1;0;1;1
2018-02-02 02:30:00;NORTE;1;0;1;1
2018-02-02 03:00:00;NORTE;2;0;2;1
2018-02-02 03:30:00;NORTE;4;0;4;1
2018-02-02 04:00:00;NORTE;2;0;2;1
2018-02-02 04:30:00;NORTE;4;0;4;1
2018-02-02 05:00:00;NORTE;7;0;7;1
2018-02-02 05:30:00;NORTE;9;0;9;1
2018-02-02 06:00:00;NORTE;15;0;15;1
2018-02-02 06:30:00;NORTE;34;0;34;1
2018-02-02 07:00:00;NORTE;21;0;21;1
2018-02-02 07:30:00;NORTE;24;0;24;1
2018-02-02 08:00:00;NORTE;32;0;32;1
2018-02-02 08:30:00;NORTE;26;0;26;1
2018-02-02 09:00:00;NORTE;29;0;29;1
2018-02-02 09:30:00;NORTE;30;0;30;1
2018-02-02 10:00:00;NORTE;26;0;26;1
2018-02-02 10:30:00;NORTE;34;0;34;1
2018-02-02 11:00:00;NORTE;29;0;29;1
2018-02-02 11:30:00;NORTE;31;0;31;1
2018-02-02 12:00:00;NORTE;23;0;23;1
2018-02-02 12:30:00;NORTE;26;0;26;1
2018-02-02 13:00:00;NORTE;30;0;30;1
2018-02-02 13:30:00;NORTE;29;0;29;1
2018-02-02 14:00:00;NORTE;26;0;26;1
2018-02-02 14:30:00;NORTE;36;0;36;1
2018-02-02 15:00:00;NORTE;36;0;36;1
2018-02-02 15:30:00;NORTE;32;0;32;1
2018-02-02 16:00:00;NORTE;20;0;20;1
2018-02-02 16:30:00;NORTE;16;0;16;1
2018-02-02 17:00:00;NORTE;28;0;28;1
2018-02-02 17:30:00;NORTE;32;0;32;1
2018-02-02 18:00:00;NORTE;36;0;36;1
2018-02-02 18:30:00;NORTE;28;0;28;1
2018-02-02 19:00:00;NORTE;37;0;37;1
2018-02-02 19:30:00;NORTE;30;0;30;1
2018-02-02 20:00:00;NORTE;28;0;28;1
2018-02-02 20:30:00;NORTE;26;0;26;1
2018-02-02 21:00:00;NORTE;30;0;30;1
2018-02-02 21:30:00;NORTE;22;0;22;1
2018-02-02 22:00:00;NORTE;9;0;9;1
2018-02-02 22:30:00;NORTE;11;0;11;1
2018-02-02 23:00:00;NORTE;12;0;12;1
2018-02-02 23:30:00;NORTE;2;0;2;1
2018-02-03 00:00:00;NORTE;1;0;1;1
2018-02-03 01:30:00;NORTE;1;0;1;1
2018-02-03 03:00:00;NORTE;4;0;4;1
2018-02-03 03:30:00;NORTE;4;0;4;1
2018-02-03 04:00:00;NORTE;2;0;2;1
2018-02-03 04:30:00;NORTE;3;0;3;1
2018-02-03 05:00:00;NORTE;9;0;9;1
2018-02-03 05:30:00;NORTE;11;0;11;1
2018-02-03 06:00:00;NORTE;21;0;21;1
2018-02-03 06:30:00;NORTE;25;0;25;1
2018-02-03 07:00:00;NORTE;14;0;14;1
2018-02-03 07:30:00;NORTE;20;0;20;1
2018-02-03 08:00:00;NORTE;30;0;30;1
2018-02-03 08:30:00;NORTE;23;0;23;1
2018-02-03 09:00:00;NORTE;33;0;33;1
2018-02-03 09:30:00;NORTE;25;0;25;1
2018-02-03 10:00:00;NORTE;16;0;16;1
2018-02-03 10:30:00;NORTE;34;0;34;1
2018-02-03 11:00:00;NORTE;32;0;32;1
2018-02-03 11:30:00;NORTE;19;0;19;1
2018-02-03 12:00:00;NORTE;25;0;25;1
2018-02-03 12:30:00;NORTE;22;0;22;1
2018-02-03 13:00:00;NORTE;23;0;23;1
2018-02-03 13:30:00;NORTE;24;0;24;1
2018-02-03 14:00:00;NORTE;25;0;25;1
2018-02-03 14:30:00;NORTE;15;0;15;1
2018-02-03 15:00:00;NORTE;34;0;34;1
2018-02-03 15:30:00;NORTE;22;0;22;1
2018-02-03 16:00:00;NORTE;19;0;19;1
2018-02-03 16:30:00;NORTE;15;0;15;1
2018-02-03 17:00:00;NORTE;15;0;15;1
2018-02-03 17:30:00;NORTE;25;0;25;1
2018-02-03 18:00:00;NORTE;22;0;22;1
2018-02-03 18:30:00;NORTE;23;0;23;1
2018-02-03 19:00:00;NORTE;26;0;26;1
2018-02-03 19:30:00;NORTE;17;0;17;1
2018-02-03 20:00:00;NORTE;12;0;12;1
2018-02-03 20:30:00;NORTE;22;0;22;1
2018-02-03 21:00:00;NORTE;18;0;18;1
2018-02-03 21:30:00;NORTE;13;0;13;1
2018-02-03 22:00:00;NORTE;5;0;5;1
2018-02-03 22:30:00;NORTE;4;0;4;1
2018-02-03 23:00:00;NORTE;11;0;11;1
2018-02-03 23:30:00;NORTE;1;0;1;1
2018-02-04 00:00:00;NORTE;3;0;3;1
2018-02-04 01:30:00;NORTE;2;0;2;1
2018-02-04 02:00:00;NORTE;3;0;3;1
2018-02-04 03:00:00;NORTE;3;0;3;1
2018-02-04 03:30:00;NORTE;3;0;3;1
2018-02-04 04:00:00;NORTE;1;0;1;1
2018-02-04 04:30:00;NORTE;4;0;4;1
2018-02-04 05:00:00;NORTE;7;0;7;1
2018-02-04 05:30:00;NORTE;10;0;10;1
2018-02-04 06:00:00;NORTE;11;0;11;1
2018-02-04 06:30:00;NORTE;26;0;26;1
2018-02-04 07:00:00;NORTE;14;0;14;1
2018-02-04 07:30:00;NORTE;15;0;15;1
2018-02-04 08:00:00;NORTE;20;0;20;1
2018-02-04 08:30:00;NORTE;22;0;22;1
2018-02-04 09:00:00;NORTE;28;0;28;1
2018-02-04 09:30:00;NORTE;26;0;26;1
2018-02-04 10:00:00;NORTE;20;0;20;1
2018-02-04 10:30:00;NORTE;31;0;31;1
2018-02-04 11:00:00;NORTE;30;0;30;1
2018-02-04 11:30:00;NORTE;20;0;20;1
2018-02-04 12:00:00;NORTE;28;0;28;1
2018-02-04 12:30:00;NORTE;20;0;20;1
2018-02-04 13:00:00;NORTE;26;0;26;1
2018-02-04 13:30:00;NORTE;29;0;29;1
2018-02-04 14:00:00;NORTE;23;0;23;1
2018-02-04 14:30:00;NORTE;27;0;27;1
2018-02-04 15:00:00;NORTE;31;0;31;1
2018-02-04 15:30:00;NORTE;29;0;29;1
2018-02-04 16:00:00;NORTE;20;0;20;1
2018-02-04 16:30:00;NORTE;22;0;22;1
2018-02-04 17:00:00;NORTE;13;0;13;1
2018-02-04 17:30:00;NORTE;32;0;32;1
2018-02-04 18:00:00;NORTE;18;0;18;1
2018-02-04 18:30:00;NORTE;30;0;30;1
2018-02-04 19:00:00;NORTE;30;0;30;1
2018-02-04 19:30:00;NORTE;33;0;33;1
2018-02-04 20:00:00;NORTE;32;0;32;1
2018-02-04 20:30:00;NORTE;20;0;20;1
2018-02-04 21:00:00;NORTE;33;0;33;1
2018-02-04 21:30:00;NORTE;11;0;11;1
2018-02-04 22:00:00;NORTE;14;0;14;1
2018-02-04 22:30:00;NORTE;13;0;13;1
2018-02-04 23:00:00;NORTE;9;0;9;1
2018-02-04 23:30:00;NORTE;9;0;9;1
2018-02-05 00:00:00;NORTE;4;0;4;1
2018-02-05 00:30:00;NORTE;3;0;3;1
2018-02-05 01:30:00;NORTE;3;0;3;1
2018-02-05 02:30:00;NORTE;1;0;1;1
2018-02-05 03:00:00;NORTE;3;0;3;1
2018-02-05 03:30:00;NORTE;2;0;2;1
2018-02-05 04:00:00;NORTE;1;0;1;1
2018-02-05 04:30:00;NORTE;5;0;5;1
2018-02-05 05:00:00;NORTE;6;0;6;1
2018-02-05 05:30:00;NORTE;14;0;14;1
2018-02-05 06:00:00;NORTE;15;0;15;1
2018-02-05 06:30:00;NORTE;33;0;33;1
2018-02-05 07:00:00;NORTE;17;0;17;1
2018-02-05 07:30:00;NORTE;19;0;19;1
2018-02-05 08:00:00;NORTE;27;0;27;1
2018-02-05 08:30:00;NORTE;19;0;19;1
2018-02-05 09:00:00;NORTE;33;0;33;1
2018-02-05 09:30:00;NORTE;36;0;36;1
2018-02-05 10:00:46;NORTE;1;0;1;1
2018-02-05 10:03:26;NORTE;1;0;1;1
2018-02-05 10:04:46;NORTE;1;0;1;1
2018-02-05 10:05:00;NORTE;6;0;6;1
2018-02-05 10:13:00;NORTE;7;0;7;1
2018-02-05 10:30:00;NORTE;10;0;10;1
2018-02-05 10:52:00;NORTE;3;0;3;1
2018-02-05 11:00:00;NORTE;6;0;6;1
2018-02-05 11:30:00;NORTE;11;0;11;1
2018-02-05 12:00:00;NORTE;6;0;6;1
2018-02-05 12:30:00;NORTE;5;0;5;1
2018-02-05 12:48:00;NORTE;4;0;4;1
2018-02-05 13:00:00;NORTE;16;0;16;1
2018-02-05 13:30:00;NORTE;28;0;28;1
2018-02-05 14:00:00;NORTE;17;0;17;1
2018-02-05 14:30:00;NORTE;13;0;13;1
2018-02-05 15:00:00;NORTE;27;0;27;1
2018-02-05 15:30:00;NORTE;24;0;24;1
2018-02-05 16:00:00;NORTE;32;0;32;1
2018-02-05 16:30:00;NORTE;35;0;35;1
2018-02-05 17:00:00;NORTE;32;0;32;1
2018-02-05 17:30:00;NORTE;17;0;17;1
2018-02-05 18:00:00;NORTE;19;0;19;1
2018-02-05 18:20:00;NORTE;5;0;5;1
2018-02-05 18:30:00;NORTE;27;0;27;1
2018-02-05 19:00:00;NORTE;26;0;26;1
2018-02-05 19:30:00;NORTE;28;0;28;1
2018-02-05 20:00:00;NORTE;24;0;24;1
2018-02-05 20:30:00;NORTE;23;0;23;1
2018-02-05 21:00:00;NORTE;24;0;24;1
2018-02-05 21:30:00;NORTE;22;0;22;1
2018-02-05 22:00:00;NORTE;20;0;20;1
2018-02-05 22:30:00;NORTE;17;0;17;1
2018-02-05 23:00:00;NORTE;19;0;19;1
2018-02-05 23:30:00;NORTE;14;0;14;1
2018-02-06 00:00:00;NORTE;4;0;4;1
2018-02-06 00:30:00;NORTE;2;0;2;1
2018-02-06 01:00:00;NORTE;2;0;2;1
2018-02-06 01:30:00;NORTE;1;0;1;1
2018-02-06 03:00:00;NORTE;5;0;5;1
2018-02-06 03:30:00;NORTE;4;0;4;1
2018-02-06 04:00:00;NORTE;1;0;1;1
2018-02-06 04:30:00;NORTE;4;0;4;1
2018-02-06 05:00:00;NORTE;9;0;9;1
2018-02-06 05:30:00;NORTE;10;0;10;1
2018-02-06 06:00:00;NORTE;14;0;14;1
2018-02-06 06:30:00;NORTE;28;0;28;1
2018-02-06 07:00:00;NORTE;15;0;15;1
2018-02-06 07:30:00;NORTE;19;0;19;1
2018-02-06 08:00:00;NORTE;33;0;33;1
2018-02-06 08:30:00;NORTE;20;0;20;1
2018-02-06 09:00:00;NORTE;33;0;33;1
2018-02-06 09:30:00;NORTE;25;0;25;1
2018-02-06 10:00:00;NORTE;19;0;19;1
2018-02-06 10:30:00;NORTE;29;0;29;1
2018-02-06 11:00:00;NORTE;31;0;31;1
2018-02-06 11:30:00;NORTE;26;0;26;1
2018-02-06 12:00:00;NORTE;28;0;28;1
2018-02-06 12:30:00;NORTE;22;0;22;1
2018-02-06 13:00:00;NORTE;26;0;26;1
2018-02-06 13:30:00;NORTE;20;0;20;1
2018-02-06 14:00:00;NORTE;22;0;22;1
2018-02-06 14:30:00;NORTE;24;0;24;1
2018-02-06 15:00:00;NORTE;29;0;29;1
2018-02-06 15:30:00;NORTE;25;0;25;1
2018-02-06 16:00:00;NORTE;20;0;20;1
2018-02-06 16:30:00;NORTE;13;0;13;1
2018-02-06 17:00:00;NORTE;23;0;23;1
2018-02-06 17:30:00;NORTE;28;0;28;1
2018-02-06 18:00:00;NORTE;23;0;23;1
2018-02-06 18:30:00;NORTE;24;0;24;1
2018-02-06 19:00:00;NORTE;26;0;26;1
2018-02-06 19:30:00;NORTE;25;0;25;1
2018-02-06 20:00:00;NORTE;18;0;18;1
2018-02-06 20:30:00;NORTE;27;0;27;1
2018-02-06 21:00:00;NORTE;28;0;28;1
2018-02-06 21:30:00;NORTE;11;0;11;1
2018-02-06 22:00:00;NORTE;9;0;9;1
2018-02-06 22:30:00;NORTE;3;0;3;1
2018-02-06 23:00:00;NORTE;11;0;11;1
2018-02-06 23:30:00;NORTE;2;0;2;1
2018-02-07 00:00:00;NORTE;1;0;1;1
2018-02-07 01:00:00;NORTE;4;0;4;1
2018-02-07 01:30:00;NORTE;1;0;1;1
2018-02-07 03:00:00;NORTE;3;0;3;1
2018-02-07 03:30:00;NORTE;3;0;3;1
2018-02-07 04:00:00;NORTE;1;0;1;1
2018-02-07 04:30:00;NORTE;7;0;7;1
2018-02-07 05:00:00;NORTE;8;0;8;1
2018-02-07 05:30:00;NORTE;10;0;10;1
2018-02-07 06:00:00;NORTE;16;0;16;1
2018-02-07 06:30:00;NORTE;30;0;30;1
2018-02-07 07:00:00;NORTE;23;0;23;1
2018-02-07 07:30:00;NORTE;23;0;23;1
2018-02-07 08:00:00;NORTE;28;0;28;1
2018-02-07 08:30:00;NORTE;17;0;17;1
2018-02-07 09:00:00;NORTE;37;0;37;1
2018-02-07 09:30:00;NORTE;26;0;26;1
2018-02-07 10:00:00;NORTE;25;0;25;1
2018-02-07 10:30:00;NORTE;30;0;30;1
2018-02-07 11:00:00;NORTE;31;0;31;1
2018-02-07 11:30:00;NORTE;30;0;30;1
2018-02-07 12:00:00;NORTE;13;0;13;1
2018-02-07 12:30:00;NORTE;22;0;22;1
2018-02-07 13:00:00;NORTE;23;0;23;1
2018-02-07 13:30:00;NORTE;28;0;28;1
2018-02-07 14:00:00;NORTE;28;0;28;1
2018-02-07 14:30:00;NORTE;24;0;24;1
2018-02-07 15:00:00;NORTE;34;0;34;1
2018-02-07 15:30:00;NORTE;36;0;36;1
2018-02-07 16:00:00;NORTE;17;0;17;1
2018-02-07 16:30:00;NORTE;16;0;16;1
2018-02-07 17:00:00;NORTE;23;0;23;1
2018-02-07 17:30:00;NORTE;25;0;25;1
2018-02-07 18:00:00;NORTE;26;0;26;1
2018-02-07 18:30:00;NORTE;19;0;19;1
2018-02-07 19:00:00;NORTE;32;0;32;1
2018-02-07 19:30:00;NORTE;20;0;20;1
2018-02-07 20:00:00;NORTE;18;0;18;1
2018-02-07 20:30:00;NORTE;30;0;30;1
2018-02-07 21:00:00;NORTE;33;0;33;1
2018-02-07 21:30:00;NORTE;16;0;16;1
2018-02-07 22:00:00;NORTE;12;0;12;1
2018-02-07 22:30:00;NORTE;11;0;11;1
2018-02-07 23:00:00;NORTE;5;0;5;1
2018-02-07 23:30:00;NORTE;5;0;5;1
2018-02-08 00:00:00;NORTE;3;0;3;1
2018-02-08 00:30:00;NORTE;3;0;3;1
2018-02-08 01:00:00;NORTE;1;0;1;1
2018-02-08 02:00:00;NORTE;2;0;2;1
2018-02-08 03:00:00;NORTE;2;0;2;1
2018-02-08 03:30:00;NORTE;4;0;4;1
2018-02-08 04:00:00;NORTE;3;0;3;1
2018-02-08 04:30:00;NORTE;5;0;5;1
2018-02-08 05:00:00;NORTE;7;0;7;1
2018-02-08 05:30:00;NORTE;9;0;9;1
2018-02-08 06:00:00;NORTE;21;0;21;1
2018-02-08 06:30:00;NORTE;40;0;40;1
2018-02-08 07:00:00;NORTE;16;0;16;1
2018-02-08 07:30:00;NORTE;25;0;25;1
2018-02-08 08:00:00;NORTE;26;0;26;1
2018-02-08 08:30:00;NORTE;22;0;22;1
2018-02-08 09:00:00;NORTE;28;0;28;1
2018-02-08 09:30:00;NORTE;30;0;30;1
2018-02-08 10:00:00;NORTE;17;0;17;1
2018-02-08 10:30:00;NORTE;36;0;36;1
2018-02-08 11:00:00;NORTE;26;0;26;1
2018-02-08 11:30:00;NORTE;24;0;24;1
2018-02-08 12:00:00;NORTE;26;0;26;1
2018-02-08 12:30:00;NORTE;18;0;18;1
2018-02-08 13:00:00;NORTE;17;0;17;1
2018-02-08 13:30:00;NORTE;30;0;30;1
2018-02-08 14:00:00;NORTE;18;0;18;1
2018-02-08 14:30:00;NORTE;25;0;25;1
2018-02-08 15:00:00;NORTE;20;0;20;1
2018-02-08 15:30:00;NORTE;22;0;22;1
2018-02-08 16:00:00;NORTE;19;0;19;1
2018-02-08 16:30:00;NORTE;12;0;12;1
2018-02-08 17:00:00;NORTE;17;0;17;1
2018-02-08 17:30:00;NORTE;35;0;35;1
2018-02-08 18:00:00;NORTE;30;0;30;1
2018-02-08 18:30:00;NORTE;26;0;26;1
2018-02-08 19:00:00;NORTE;34;0;34;1
2018-02-08 19:30:00;NORTE;30;0;30;1
2018-02-08 20:00:00;NORTE;22;0;22;1
2018-02-08 20:30:00;NORTE;27;0;27;1
2018-02-08 21:00:00;NORTE;30;0;30;1
2018-02-08 21:30:00;NORTE;17;0;17;1
2018-02-08 22:00:00;NORTE;13;0;13;1
2018-02-08 22:30:00;NORTE;9;0;9;1
2018-02-08 23:00:00;NORTE;11;0;11;1
2018-02-08 23:30:00;NORTE;3;0;3;1
2018-02-09 00:00:00;NORTE;1;0;1;1
2018-02-09 00:30:00;NORTE;1;0;1;1
2018-02-09 01:00:00;NORTE;1;0;1;1
2018-02-09 02:00:00;NORTE;1;0;1;1
2018-02-09 03:00:00;NORTE;3;0;3;1
2018-02-09 03:30:00;NORTE;4;0;4;1
2018-02-09 04:00:00;NORTE;2;0;2;1
2018-02-09 04:30:00;NORTE;5;0;5;1
2018-02-09 05:00:00;NORTE;11;0;11;1
2018-02-09 05:30:00;NORTE;8;0;8;1
2018-02-09 06:00:00;NORTE;14;0;14;1
2018-02-09 06:30:00;NORTE;29;0;29;1
2018-02-09 07:00:00;NORTE;28;0;28;1
2018-02-09 07:30:00;NORTE;13;0;13;1
2018-02-09 08:00:00;NORTE;30;0;30;1
2018-02-09 10:00:00;NORTE;15;0;15;1
2018-02-09 10:30:00;NORTE;37;0;37;1
2018-02-09 11:00:00;NORTE;36;0;36;1
2018-02-09 11:30:00;NORTE;24;0;24;1
2018-02-09 12:00:00;NORTE;19;0;19;1
2018-02-09 12:30:00;NORTE;27;0;27;1
2018-02-09 13:00:00;NORTE;25;0;25;1
2018-02-09 13:30:00;NORTE;26;0;26;1
2018-02-09 14:00:00;NORTE;29;0;29;1
2018-02-09 14:30:00;NORTE;27;0;27;1
2018-02-09 15:00:00;NORTE;21;0;21;1
2018-02-09 15:30:00;NORTE;31;0;31;1
2018-02-09 16:00:00;NORTE;9;0;9;1
2018-02-09 16:30:00;NORTE;18;0;18;1
2018-02-09 17:00:00;NORTE;19;0;19;1
2018-02-09 17:30:00;NORTE;31;0;31;1
2018-02-09 18:00:00;NORTE;28;0;28;1
2018-02-09 18:30:00;NORTE;32;0;32;1
2018-02-09 19:00:00;NORTE;37;0;37;1
2018-02-09 19:30:00;NORTE;30;0;30;1
2018-02-09 20:00:00;NORTE;28;0;28;1
2018-02-09 20:30:00;NORTE;29;0;29;1
2018-02-09 21:00:00;NORTE;28;0;28;1
2018-02-09 21:30:00;NORTE;17;0;17;1
2018-02-09 22:00:00;NORTE;18;0;18;1
2018-02-09 22:30:00;NORTE;6;0;6;1
2018-02-09 23:00:00;NORTE;12;0;12;1
2018-02-09 23:30:00;NORTE;5;0;5;1
2018-02-10 00:00:00;NORTE;1;0;1;1
2018-02-10 00:30:00;NORTE;1;0;1;1
2018-02-10 03:00:00;NORTE;3;0;3;1
2018-02-10 03:30:00;NORTE;3;0;3;1
2018-02-10 04:00:00;NORTE;2;0;2;1
2018-02-10 04:30:00;NORTE;3;0;3;1
2018-02-10 05:00:00;NORTE;13;0;13;1
2018-02-10 05:30:00;NORTE;8;0;8;1
2018-02-10 06:00:00;NORTE;11;0;11;1
2018-02-10 06:30:00;NORTE;27;0;27;1
2018-02-10 07:00:00;NORTE;10;0;10;1
2018-02-10 07:30:00;NORTE;18;0;18;1
2018-02-10 08:00:00;NORTE;17;0;17;1
2018-02-10 08:30:00;NORTE;11;0;11;1
2018-02-10 09:00:00;NORTE;26;0;26;1
2018-02-10 09:30:00;NORTE;15;0;15;1
2018-02-10 10:00:00;NORTE;21;0;21;1
2018-02-10 10:30:00;NORTE;29;0;29;1
2018-02-10 11:00:00;NORTE;29;0;29;1
2018-02-10 11:30:00;NORTE;25;0;25;1
2018-02-10 12:00:00;NORTE;25;0;25;1
2018-02-10 12:30:00;NORTE;24;0;24;1
2018-02-10 13:00:00;NORTE;25;0;25;1
2018-02-10 13:30:00;NORTE;25;0;25;1
2018-02-10 14:00:00;NORTE;22;0;22;1
2018-02-10 14:30:00;NORTE;21;0;21;1
2018-02-10 15:00:00;NORTE;34;0;34;1
2018-02-10 15:30:00;NORTE;19;0;19;1
2018-02-10 16:00:00;NORTE;18;0;18;1
2018-02-10 16:30:00;NORTE;10;0;10;1
2018-02-10 17:00:00;NORTE;19;0;19;1
2018-02-10 17:30:00;NORTE;26;0;26;1
2018-02-10 18:00:00;NORTE;19;0;19;1
2018-02-10 18:30:00;NORTE;22;0;22;1
2018-02-10 19:00:00;NORTE;25;0;25;1
2018-02-10 19:30:00;NORTE;12;0;12;1
2018-02-10 20:00:00;NORTE;22;0;22;1
2018-02-10 20:30:00;NORTE;14;0;14;1
2018-02-10 21:00:00;NORTE;22;0;22;1
2018-02-10 21:30:00;NORTE;11;0;11;1
2018-02-10 22:00:00;NORTE;6;0;6;1
2018-02-10 22:30:00;NORTE;5;0;5;1
2018-02-10 23:00:00;NORTE;8;0;8;1
2018-02-10 23:30:00;NORTE;2;0;2;1
2018-02-11 01:30:00;NORTE;2;0;2;1
2018-02-11 02:00:00;NORTE;2;0;2;1
2018-02-11 02:30:00;NORTE;2;0;2;1
2018-02-11 03:00:00;NORTE;2;0;2;1
2018-02-11 03:30:00;NORTE;1;0;1;1
2018-02-11 04:00:00;NORTE;3;0;3;1
2018-02-11 04:30:00;NORTE;3;0;3;1
2018-02-11 05:00:00;NORTE;8;0;8;1
2018-02-11 05:30:00;NORTE;9;0;9;1
2018-02-11 06:00:00;NORTE;12;0;12;1
2018-02-11 06:30:00;NORTE;23;0;23;1
2018-02-11 07:00:00;NORTE;16;0;16;1
2018-02-11 07:30:00;NORTE;15;0;15;1
2018-02-11 08:00:00;NORTE;19;0;19;1
2018-02-11 08:30:00;NORTE;22;0;22;1
2018-02-11 09:00:00;NORTE;28;0;28;1
2018-02-11 09:30:00;NORTE;27;0;27;1
2018-02-11 10:00:00;NORTE;17;0;17;1
2018-02-11 10:30:00;NORTE;30;0;30;1
2018-02-11 11:00:00;NORTE;34;1;35;1
2018-02-11 11:30:00;NORTE;24;0;24;1
2018-02-11 12:00:00;NORTE;24;0;24;1
2018-02-11 12:30:00;NORTE;25;0;25;1
2018-02-11 13:00:00;NORTE;27;0;27;1
2018-02-11 13:30:00;NORTE;24;0;24;1
2018-02-11 14:00:00;NORTE;19;0;19;1
2018-02-11 14:30:00;NORTE;24;0;24;1
2018-02-11 15:00:00;NORTE;35;0;35;1
2018-02-11 15:30:00;NORTE;30;0;30;1
2018-02-11 16:00:00;NORTE;18;0;18;1
2018-02-11 16:30:00;NORTE;25;0;25;1
2018-02-11 17:00:00;NORTE;11;0;11;1
2018-02-11 17:30:00;NORTE;31;0;31;1
2018-02-11 18:00:00;NORTE;26;0;26;1
2018-02-11 18:30:00;NORTE;20;0;20;1
2018-02-11 19:00:00;NORTE;34;0;34;1
2018-02-11 19:30:00;NORTE;36;0;36;1
2018-02-11 20:00:00;NORTE;27;0;27;1
2018-02-11 20:30:00;NORTE;28;0;28;1
2018-02-11 21:00:00;NORTE;27;0;27;1
2018-02-11 21:30:00;NORTE;17;0;17;1
2018-02-11 22:00:00;NORTE;15;0;15;1
2018-02-11 22:30:00;NORTE;11;0;11;1
2018-02-11 23:00:00;NORTE;12;0;12;1
2018-02-11 23:30:00;NORTE;5;0;5;1
2018-02-12 00:00:00;NORTE;2;0;2;1
2018-02-12 00:30:00;NORTE;2;0;2;1
2018-02-12 01:00:00;NORTE;2;0;2;1
2018-02-12 01:30:00;NORTE;1;0;1;1
2018-02-12 03:00:00;NORTE;3;0;3;1
2018-02-12 03:30:00;NORTE;5;0;5;1
2018-02-12 04:00:00;NORTE;2;0;2;1
2018-02-12 04:30:00;NORTE;3;0;3;1
2018-02-12 05:00:00;NORTE;6;0;6;1
2018-02-12 05:30:00;NORTE;13;0;13;1
2018-02-12 06:00:00;NORTE;17;0;17;1
2018-02-12 06:30:00;NORTE;33;0;33;1
2018-02-12 07:00:00;NORTE;12;0;12;1
2018-02-12 07:30:00;NORTE;16;0;16;1
2018-02-12 08:00:00;NORTE;31;0;31;1
2018-02-12 08:30:00;NORTE;24;0;24;1
2018-02-12 09:00:00;NORTE;30;0;30;1
2018-02-12 09:30:00;NORTE;41;0;41;1
2018-02-12 10:00:00;NORTE;22;0;22;1
2018-02-12 10:30:00;NORTE;29;0;29;1
2018-02-12 11:00:00;NORTE;31;1;32;1
2018-02-12 11:30:00;NORTE;29;0;29;1
2018-02-12 12:00:00;NORTE;28;0;28;1
2018-02-12 12:30:00;NORTE;24;0;24;1
2018-02-12 13:00:00;NORTE;27;0;27;1
2018-02-12 13:30:00;NORTE;20;0;20;1
2018-02-12 14:00:00;NORTE;27;0;27;1
2018-02-12 14:30:00;NORTE;31;0;31;1
2018-02-12 15:00:00;NORTE;33;0;33;1
2018-02-12 15:30:00;NORTE;24;0;24;1
2018-02-12 16:00:00;NORTE;22;0;22;1
2018-02-12 16:30:00;NORTE;17;0;17;1
2018-02-12 17:00:00;NORTE;24;0;24;1
2018-02-12 17:30:00;NORTE;23;0;23;1
2018-02-12 18:00:00;NORTE;26;0;26;1
2018-02-12 18:30:00;NORTE;25;0;25;1
2018-02-12 19:00:00;NORTE;30;0;30;1
2018-02-12 19:30:00;NORTE;34;0;34;1
2018-02-12 20:00:00;NORTE;24;0;24;1
2018-02-12 20:30:00;NORTE;22;0;22;1
2018-02-12 21:00:00;NORTE;21;0;21;1
2018-02-12 21:30:00;NORTE;18;0;18;1
2018-02-12 22:00:00;NORTE;11;0;11;1
2018-02-12 22:30:00;NORTE;10;0;10;1
2018-02-12 23:00:00;NORTE;10;0;10;1
2018-02-12 23:30:00;NORTE;4;0;4;1
2018-02-13 01:30:00;NORTE;1;0;1;1
2018-02-13 02:00:00;NORTE;1;0;1;1
2018-02-13 02:30:00;NORTE;1;0;1;1
2018-02-13 03:00:00;NORTE;5;0;5;1
2018-02-13 03:30:00;NORTE;2;0;2;1
2018-02-13 04:00:00;NORTE;1;0;1;1
2018-02-13 04:30:00;NORTE;7;0;7;1
2018-02-13 05:00:00;NORTE;7;0;7;1
2018-02-13 05:30:00;NORTE;12;0;12;1
2018-02-13 06:00:00;NORTE;16;0;16;1
2018-02-13 06:30:00;NORTE;34;0;34;1
2018-02-13 07:00:00;NORTE;20;0;20;1
2018-02-13 07:30:00;NORTE;20;0;20;1
2018-02-13 08:00:00;NORTE;31;0;31;1
2018-02-13 08:30:00;NORTE;23;0;23;1
2018-02-13 09:00:00;NORTE;35;0;35;1
2018-02-13 09:30:00;NORTE;32;0;32;1
2018-02-13 10:00:00;NORTE;18;0;18;1
2018-02-13 10:30:00;SUR;2;24;26;1
2018-02-13 11:00:00;SUR;0;29;29;1
2018-02-13 11:30:00;SUR;0;26;26;1
2018-02-13 12:00:00;SUR;0;25;25;1
2018-02-13 12:30:00;SUR;0;21;21;1
2018-02-13 13:00:00;SUR;0;26;26;1
2018-02-13 13:30:00;SUR;0;27;27;1
2018-02-13 14:00:00;SUR;0;8;8;1
2018-02-13 22:00:00;SUR;0;2;2;1
2018-02-13 22:30:00;SUR;0;5;5;1
2018-02-13 23:00:00;SUR;0;4;4;1
2018-02-13 23:30:00;SUR;0;3;3;1
2018-02-14 00:00:00;SUR;0;2;2;1
2018-02-14 00:30:00;SUR;0;1;1;1
2018-02-14 01:00:00;SUR;0;1;1;1
2018-02-14 03:00:00;SUR;0;2;2;1
2018-02-14 03:30:00;SUR;0;5;5;1
2018-02-14 04:30:00;SUR;0;5;5;1
2018-02-14 05:00:00;SUR;0;10;10;1
2018-02-14 22:00:00;NORTE;10;1;11;1
2018-02-14 22:30:00;NORTE;15;0;15;1
2018-02-14 23:00:00;NORTE;7;0;7;1
2018-02-14 23:30:00;NORTE;7;0;7;1
2018-02-15 00:00:00;NORTE;3;0;3;1
2018-02-15 00:30:00;NORTE;1;0;1;1
2018-02-15 01:00:00;NORTE;2;0;2;1
2018-02-15 01:30:00;NORTE;1;0;1;1
2018-02-15 02:00:00;NORTE;1;0;1;1
2018-02-15 02:30:00;NORTE;2;0;2;1
2018-02-15 03:00:00;NORTE;4;0;4;1
2018-02-15 03:30:00;NORTE;3;0;3;1
2018-02-15 04:00:00;NORTE;2;0;2;1
2018-02-15 04:30:00;NORTE;4;0;4;1
2018-02-15 05:00:00;NORTE;7;0;7;1
2018-02-15 05:30:00;NORTE;15;0;15;1
2018-02-15 06:00:00;NORTE;16;0;16;1
2018-02-15 06:30:44;NORTE;1;0;1;1
2018-02-15 06:30:51;NORTE;1;0;1;1
2018-02-15 06:32:13;NORTE;1;0;1;1
2018-02-15 06:32:35;NORTE;1;0;1;1
2018-02-15 06:32:50;NORTE;1;0;1;1
2018-02-15 06:33:00;NORTE;30;0;30;1
2018-02-15 07:00:00;NORTE;19;0;19;1
2018-02-15 07:30:00;NORTE;18;0;18;1
2018-02-15 08:00:00;NORTE;32;0;32;1
2018-02-15 08:30:00;NORTE;23;0;23;1
2018-02-15 09:00:00;NORTE;28;0;28;1
2018-02-15 09:30:00;NORTE;32;0;32;1
2018-02-15 10:00:00;NORTE;19;0;19;1
2018-02-15 10:30:00;NORTE;31;0;31;1
2018-02-15 11:00:00;NORTE;37;0;37;1
2018-02-15 11:30:00;NORTE;20;0;20;1
2018-02-15 12:00:00;NORTE;22;0;22;1
2018-02-15 12:30:00;NORTE;29;0;29;1
2018-02-15 13:00:00;NORTE;24;0;24;1
2018-02-15 13:30:00;NORTE;27;0;27;1
2018-02-15 14:00:00;NORTE;29;0;29;1
2018-02-15 14:30:00;NORTE;23;0;23;1
2018-02-15 15:00:00;NORTE;30;0;30;1
2018-02-15 15:23:00;NORTE;5;0;5;1
2018-02-15 15:30:00;NORTE;20;0;20;1
2018-02-15 16:00:00;NORTE;20;0;20;1
2018-02-15 16:30:00;NORTE;15;0;15;1
2018-02-15 17:00:00;NORTE;19;0;19;1
2018-02-15 17:30:00;NORTE;31;0;31;1
2018-02-15 18:00:00;NORTE;31;0;31;1
2018-02-15 18:30:00;NORTE;27;0;27;1
2018-02-15 19:00:00;NORTE;31;0;31;1
2018-02-15 19:30:00;NORTE;39;0;39;1
2018-02-15 20:01:20;NORTE;1;0;1;1
2018-02-15 20:01:39;NORTE;1;0;1;1
2018-02-15 20:04:36;NORTE;1;0;1;1
2018-02-15 20:04:48;NORTE;1;0;1;1
2018-02-15 20:05:49;NORTE;1;0;1;1
2018-02-15 20:07:24;NORTE;1;0;1;1
2018-02-15 20:08:35;NORTE;1;0;1;1
2018-02-15 20:09:57;NORTE;1;0;1;1
2018-02-15 20:10:10;NORTE;1;0;1;1
2018-02-15 20:12:31;NORTE;1;0;1;1
2018-02-15 20:13:43;NORTE;1;0;1;1
2018-02-15 20:14:01;NORTE;1;0;1;1
2018-02-15 20:18:35;NORTE;1;0;1;1
2018-02-15 20:19:22;NORTE;1;0;1;1
2018-02-15 20:20:03;NORTE;1;0;1;1
2018-02-15 20:21:20;NORTE;1;0;1;1
2018-02-15 20:21:24;NORTE;1;0;1;1
2018-02-15 20:22:50;NORTE;1;0;1;1
2018-02-15 20:23:42;NORTE;1;0;1;1
2018-02-15 20:25:30;NORTE;1;0;1;1
2018-02-15 20:27:58;NORTE;1;0;1;1
2018-02-15 20:28:10;NORTE;1;0;1;1
2018-02-15 20:28:23;NORTE;1;0;1;1
2018-02-15 20:30:27;NORTE;1;0;1;1
2018-02-15 20:31:58;NORTE;1;0;1;1
2018-02-15 20:32:06;NORTE;1;0;1;1
2018-02-15 20:33:41;NORTE;1;0;1;1
2018-02-15 20:35:07;NORTE;1;0;1;1
2018-02-15 20:36:10;NORTE;1;0;1;1
2018-02-15 20:37:39;NORTE;1;0;1;1
2018-02-15 20:41:49;NORTE;1;0;1;1
2018-02-15 20:42:59;NORTE;1;0;1;1
2018-02-15 20:44:25;NORTE;1;0;1;1
2018-02-15 20:47:01;NORTE;1;0;1;1
2018-02-15 20:48:09;NORTE;1;0;1;1
2018-02-15 20:48:44;NORTE;1;0;1;1
2018-02-15 20:49:50;NORTE;1;0;1;1
2018-02-15 20:50:37;NORTE;1;0;1;1
2018-02-15 20:51:12;NORTE;1;0;1;1
2018-02-15 20:51:37;NORTE;1;0;1;1
2018-02-15 20:52:19;NORTE;1;0;1;1
2018-02-15 20:53:18;NORTE;1;0;1;1
2018-02-15 20:53:41;NORTE;1;0;1;1
2018-02-15 20:54:50;NORTE;1;0;1;1
2018-02-15 20:58:06;NORTE;1;0;1;1
2018-02-15 20:59:05;NORTE;1;0;1;1
2018-02-15 21:00:00;NORTE;31;0;31;1
2018-02-15 21:30:00;NORTE;12;0;12;1
2018-02-15 22:00:00;NORTE;16;0;16;1
2018-02-15 22:30:00;NORTE;10;0;10;1
2018-02-15 23:00:00;NORTE;10;0;10;1
2018-02-15 23:30:00;NORTE;6;0;6;1
2018-02-16 00:00:00;NORTE;2;0;2;1
2018-02-16 00:30:00;NORTE;2;0;2;1
2018-02-16 01:30:00;NORTE;2;0;2;1
2018-02-16 02:30:00;NORTE;3;0;3;1
2018-02-16 03:00:00;NORTE;3;0;3;1
2018-02-16 03:30:00;NORTE;4;0;4;1
2018-02-16 04:00:00;NORTE;1;0;1;1
2018-02-16 04:30:00;NORTE;6;0;6;1
2018-02-16 05:00:00;NORTE;11;0;11;1
2018-02-16 05:30:00;NORTE;11;0;11;1
2018-02-16 06:00:00;NORTE;17;0;17;1
2018-02-16 06:30:00;NORTE;10;0;10;1
2018-02-16 06:37:00;NORTE;21;0;21;1
2018-02-16 07:00:00;NORTE;19;0;19;1
2018-02-16 07:30:00;NORTE;19;0;19;1
2018-02-16 08:00:00;NORTE;35;1;36;1
2018-02-16 08:30:00;NORTE;24;0;24;1
2018-02-16 09:00:00;NORTE;35;0;35;1
2018-02-16 09:30:00;NORTE;10;0;10;1
2018-02-16 13:00:00;NORTE;4;0;4;1
2018-02-16 13:30:00;NORTE;35;0;35;1
2018-02-16 14:00:00;NORTE;27;0;27;1
2018-02-16 14:30:00;NORTE;26;0;26;1
2018-02-16 15:00:00;NORTE;30;1;31;1
2018-02-16 15:30:00;NORTE;27;0;27;1
2018-02-16 16:00:00;NORTE;22;0;22;1
2018-02-16 16:30:00;NORTE;16;0;16;1
2018-02-16 17:00:00;NORTE;22;0;22;1
2018-02-16 17:30:00;NORTE;33;0;33;1
2018-02-16 18:00:00;NORTE;21;0;21;1
2018-02-16 18:30:00;NORTE;35;0;35;1
2018-02-16 19:00:00;NORTE;34;0;34;1
2018-02-16 19:30:00;NORTE;23;0;23;1
2018-02-16 20:00:00;NORTE;29;0;29;1
2018-02-16 20:30:00;NORTE;25;0;25;1
2018-02-16 21:00:00;NORTE;31;0;31;1
2018-02-16 21:30:00;NORTE;10;0;10;1
2018-02-16 22:00:00;NORTE;13;0;13;1
2018-02-16 22:30:00;NORTE;11;0;11;1
2018-02-16 23:00:00;NORTE;13;0;13;1
2018-02-16 23:30:00;NORTE;2;0;2;1
2018-02-17 01:00:00;NORTE;1;0;1;1
2018-02-17 02:00:00;NORTE;1;0;1;1
2018-02-17 02:30:00;NORTE;1;0;1;1
2018-02-17 03:00:00;NORTE;4;0;4;1
2018-02-17 03:30:00;NORTE;3;0;3;1
2018-02-17 04:30:00;NORTE;6;0;6;1
2018-02-17 05:00:00;NORTE;7;0;7;1
2018-02-17 05:30:00;NORTE;16;0;16;1
2018-02-17 06:00:00;NORTE;18;0;18;1
2018-02-17 06:30:00;NORTE;20;0;20;1
2018-02-17 07:00:00;NORTE;17;0;17;1
2018-02-17 07:30:00;NORTE;18;0;18;1
2018-02-17 08:00:00;NORTE;29;0;29;1
2018-02-17 08:30:00;NORTE;22;0;22;1
2018-02-17 09:00:00;NORTE;39;0;39;1
2018-02-17 09:30:00;NORTE;27;0;27;1
2018-02-17 10:00:00;NORTE;15;0;15;1
2018-02-17 10:30:00;NORTE;32;0;32;1
2018-02-17 11:00:00;NORTE;35;0;35;1
2018-02-17 11:30:00;NORTE;20;0;20;1
2018-02-17 12:00:00;NORTE;30;0;30;1
2018-02-17 12:30:00;NORTE;20;0;20;1
2018-02-17 13:00:00;NORTE;23;0;23;1
2018-02-17 13:30:00;NORTE;24;0;24;1
2018-02-17 14:00:00;NORTE;26;0;26;1
2018-02-17 14:30:00;NORTE;28;0;28;1
2018-02-17 15:00:00;NORTE;33;0;33;1
2018-02-17 15:30:00;NORTE;23;0;23;1
2018-02-17 16:00:00;NORTE;19;0;19;1
2018-02-17 16:30:00;NORTE;16;0;16;1
2018-02-17 17:00:00;NORTE;21;0;21;1
2018-02-17 17:30:00;NORTE;18;0;18;1
2018-02-17 18:00:00;NORTE;20;0;20;1
2018-02-17 18:30:00;NORTE;19;0;19;1
2018-02-17 19:00:00;NORTE;26;0;26;1
2018-02-17 19:30:00;NORTE;21;0;21;1
2018-02-17 20:00:00;NORTE;16;0;16;1
2018-02-17 20:30:00;NORTE;14;0;14;1
2018-02-17 21:00:00;NORTE;21;0;21;1
2018-02-17 21:30:00;NORTE;14;0;14;1
2018-02-17 22:00:00;NORTE;4;0;4;1
2018-02-17 22:30:00;NORTE;5;0;5;1
2018-02-17 23:00:00;NORTE;13;0;13;1
2018-02-17 23:30:00;NORTE;1;0;1;1
2018-02-18 00:00:00;NORTE;2;0;2;1
2018-02-18 00:30:00;NORTE;1;0;1;1
2018-02-18 01:00:00;NORTE;1;0;1;1
2018-02-18 01:30:00;NORTE;2;0;2;1
2018-02-18 02:00:00;NORTE;3;0;3;1
2018-02-18 03:00:00;NORTE;1;0;1;1
2018-02-18 03:30:00;NORTE;3;0;3;1
2018-02-18 04:30:00;NORTE;2;0;2;1
2018-02-18 05:00:00;NORTE;9;0;9;1
2018-02-18 05:30:00;NORTE;10;0;10;1
2018-02-18 06:00:00;NORTE;11;0;11;1
2018-02-18 06:30:00;NORTE;21;0;21;1
2018-02-18 07:00:00;NORTE;23;0;23;1
2018-02-18 07:30:00;NORTE;12;0;12;1
2018-02-18 08:00:00;NORTE;25;0;25;1
2018-02-18 08:30:00;NORTE;19;0;19;1
2018-02-18 09:00:00;NORTE;37;0;37;1
2018-02-18 09:30:00;NORTE;28;0;28;1
2018-02-18 10:00:00;NORTE;21;0;21;1
2018-02-18 10:30:00;NORTE;33;0;33;1
2018-02-18 11:00:00;NORTE;36;0;36;1
2018-02-18 11:30:00;NORTE;25;0;25;1
2018-02-18 12:00:00;NORTE;30;0;30;1
2018-02-18 12:30:00;NORTE;24;0;24;1
2018-02-18 13:00:00;NORTE;28;0;28;1
2018-02-18 13:30:00;NORTE;24;0;24;1
2018-02-18 14:00:00;NORTE;26;0;26;1
2018-02-18 14:30:00;NORTE;29;0;29;1
2018-02-18 15:00:00;NORTE;36;0;36;1
2018-02-18 15:30:00;NORTE;23;0;23;1
2018-02-18 16:00:00;NORTE;20;0;20;1
2018-02-18 16:30:00;NORTE;19;0;19;1
2018-02-18 17:00:00;NORTE;18;0;18;1
2018-02-18 17:30:00;NORTE;34;0;34;1
2018-02-18 18:00:00;NORTE;27;0;27;1
2018-02-18 18:30:00;NORTE;29;0;29;1
2018-02-18 19:00:00;NORTE;35;0;35;1
2018-02-18 19:30:00;NORTE;37;0;37;1
2018-02-18 20:00:00;NORTE;19;0;19;1
2018-02-18 20:30:00;NORTE;29;0;29;1
2018-02-18 21:00:00;NORTE;35;0;35;1
2018-02-18 21:30:00;NORTE;14;0;14;1
2018-02-18 22:00:00;NORTE;15;0;15;1
2018-02-18 22:30:00;NORTE;9;0;9;1
2018-02-18 23:00:00;NORTE;12;0;12;1
2018-02-18 23:30:00;NORTE;4;0;4;1
2018-02-19 00:00:00;NORTE;2;0;2;1
2018-02-19 00:30:00;NORTE;4;0;4;1
2018-02-19 01:00:00;NORTE;1;0;1;1
2018-02-19 01:30:00;NORTE;1;0;1;1
2018-02-19 02:30:00;NORTE;1;0;1;1
2018-02-19 03:00:00;NORTE;4;0;4;1
2018-02-19 03:30:00;NORTE;2;0;2;1
2018-02-19 04:30:00;NORTE;4;0;4;1
2018-02-19 05:00:00;NORTE;8;0;8;1
2018-02-19 05:30:00;NORTE;11;0;11;1
2018-02-19 06:00:00;NORTE;21;0;21;1
2018-02-19 06:30:00;NORTE;27;0;27;1
2018-02-19 07:00:00;NORTE;15;0;15;1
2018-02-19 07:30:00;NORTE;19;0;19;1
2018-02-19 08:00:00;NORTE;28;0;28;1
2018-02-19 08:30:00;NORTE;28;0;28;1
2018-02-19 09:00:00;NORTE;27;0;27;1
2018-02-19 09:30:00;NORTE;31;0;31;1
2018-02-19 10:00:00;NORTE;22;0;22;1
2018-02-19 10:30:00;NORTE;26;0;26;1
2018-02-19 11:00:00;NORTE;33;0;33;1
2018-02-19 11:30:00;NORTE;25;0;25;1
2018-02-19 12:00:00;NORTE;26;0;26;1
2018-02-19 12:30:00;NORTE;22;0;22;1
2018-02-19 13:00:00;NORTE;28;0;28;1
2018-02-19 13:30:00;NORTE;29;0;29;1
2018-02-19 14:00:00;NORTE;29;0;29;1
2018-02-19 14:30:00;NORTE;27;0;27;1
2018-02-19 15:00:00;NORTE;36;0;36;1
2018-02-19 15:30:00;NORTE;24;0;24;1
2018-02-19 16:00:00;NORTE;16;0;16;1
2018-02-19 16:30:00;NORTE;20;0;20;1
2018-02-19 17:00:00;NORTE;25;0;25;1
2018-02-19 17:30:00;NORTE;31;0;31;1
2018-02-19 18:00:00;NORTE;27;0;27;1
2018-02-19 18:30:00;NORTE;35;0;35;1
2018-02-19 19:00:00;NORTE;28;0;28;1
2018-02-19 19:30:00;NORTE;34;1;35;1
2018-02-19 20:00:00;NORTE;24;0;24;1
2018-02-19 20:30:00;NORTE;21;0;21;1
2018-02-19 21:00:00;NORTE;30;0;30;1
2018-02-19 21:30:00;NORTE;16;0;16;1
2018-02-19 22:00:00;NORTE;13;0;13;1
2018-02-19 22:30:00;NORTE;10;0;10;1
2018-02-19 23:00:00;NORTE;10;0;10;1
2018-02-19 23:30:00;NORTE;2;0;2;1
2018-02-20 01:30:00;NORTE;1;0;1;1
2018-02-20 02:30:00;NORTE;1;0;1;1
2018-02-20 03:00:00;NORTE;4;0;4;1
2018-02-20 03:30:00;NORTE;2;0;2;1
2018-02-20 04:00:00;NORTE;4;0;4;1
2018-02-20 04:30:00;NORTE;5;0;5;1
2018-02-20 05:00:00;NORTE;8;0;8;1
2018-02-20 05:30:00;NORTE;12;0;12;1
2018-02-20 06:00:00;NORTE;15;0;15;1
2018-02-20 06:30:00;NORTE;33;0;33;1
2018-02-20 07:00:00;NORTE;22;0;22;1
2018-02-20 07:30:00;NORTE;22;0;22;1
2018-02-20 08:00:00;NORTE;27;0;27;1
2018-02-20 08:30:00;NORTE;29;0;29;1
2018-02-20 09:00:00;NORTE;33;0;33;1
2018-02-20 09:30:00;NORTE;28;0;28;1
2018-02-20 10:00:00;NORTE;17;0;17;1
2018-02-20 10:30:00;NORTE;32;0;32;1
2018-02-20 11:00:00;NORTE;28;0;28;1
2018-02-20 11:30:00;NORTE;25;0;25;1
2018-02-20 12:00:00;NORTE;26;0;26;1
2018-02-20 12:30:00;NORTE;23;0;23;1
2018-02-20 13:00:00;NORTE;28;0;28;1
2018-02-20 13:30:00;NORTE;23;0;23;1
2018-02-20 14:00:00;NORTE;27;0;27;1
2018-02-20 14:30:00;NORTE;32;0;32;1
2018-02-20 15:00:00;NORTE;29;0;29;1
2018-02-20 15:30:00;NORTE;26;0;26;1
2018-02-20 16:00:00;NORTE;24;0;24;1
2018-02-20 16:30:00;NORTE;18;0;18;1
2018-02-20 17:00:00;NORTE;16;0;16;1
2018-02-20 17:30:00;NORTE;35;0;35;1
2018-02-20 18:00:00;NORTE;18;0;18;1
2018-02-20 18:30:00;NORTE;24;0;24;1
2018-02-20 19:00:00;NORTE;33;0;33;1
2018-02-20 19:30:00;NORTE;25;0;25;1
2018-02-20 20:00:00;NORTE;18;0;18;1
2018-02-20 20:30:00;NORTE;18;0;18;1
2018-02-20 21:00:00;NORTE;29;0;29;1
2018-02-20 21:30:00;NORTE;16;0;16;1
2018-02-20 22:00:00;NORTE;15;0;15;1
2018-02-20 22:30:00;NORTE;5;0;5;1
2018-02-20 23:00:00;NORTE;9;0;9;1
2018-02-20 23:30:00;NORTE;3;0;3;1
2018-02-21 00:00:00;NORTE;1;0;1;1
2018-02-21 00:30:00;NORTE;1;0;1;1
2018-02-21 01:00:00;NORTE;1;0;1;1
2018-02-21 02:00:00;NORTE;1;0;1;1
2018-02-21 02:30:00;NORTE;1;0;1;1
2018-02-21 03:00:00;NORTE;3;0;3;1
2018-02-21 03:30:00;NORTE;3;0;3;1
2018-02-21 04:00:00;NORTE;2;0;2;1
2018-02-21 04:30:00;NORTE;8;0;8;1
2018-02-21 05:00:00;NORTE;11;0;11;1
2018-02-21 05:30:00;NORTE;12;0;12;1
2018-02-21 06:00:00;NORTE;14;0;14;1
2018-02-21 06:30:00;NORTE;38;0;38;1
2018-02-21 07:00:00;NORTE;17;0;17;1
2018-02-21 07:30:00;NORTE;24;0;24;1
2018-02-21 08:00:00;NORTE;29;0;29;1
2018-02-21 08:30:00;NORTE;20;0;20;1
2018-02-21 09:00:00;NORTE;35;0;35;1
2018-02-21 09:30:00;NORTE;33;0;33;1
2018-02-21 10:00:00;NORTE;22;0;22;1
2018-02-21 10:30:00;NORTE;25;0;25;1
2018-02-21 11:00:00;NORTE;35;0;35;1
2018-02-21 11:30:00;NORTE;29;0;29;1
2018-02-21 12:00:00;NORTE;27;0;27;1
2018-02-21 12:30:00;NORTE;21;0;21;1
2018-02-21 13:00:00;NORTE;29;0;29;1
2018-02-21 13:30:00;NORTE;25;0;25;1
2018-02-21 14:00:00;NORTE;28;0;28;1
2018-02-21 14:30:00;NORTE;21;0;21;1
2018-02-21 15:00:00;NORTE;29;0;29;1
2018-02-21 15:30:00;NORTE;26;0;26;1
2018-02-21 16:00:00;NORTE;24;0;24;1
2018-02-21 16:30:00;NORTE;16;0;16;1
2018-02-21 17:00:00;NORTE;19;0;19;1
2018-02-21 17:30:00;NORTE;30;0;30;1
2018-02-21 18:00:00;NORTE;24;0;24;1
2018-02-21 18:30:00;NORTE;28;0;28;1
2018-02-21 19:00:00;NORTE;36;0;36;1
2018-02-21 19:30:00;NORTE;26;1;27;1
2018-02-21 20:00:00;NORTE;19;0;19;1
2018-02-21 20:30:00;NORTE;28;0;28;1
2018-02-21 21:00:00;NORTE;28;0;28;1
2018-02-21 21:30:00;NORTE;16;0;16;1
2018-02-21 22:00:00;NORTE;17;0;17;1
2018-02-21 22:30:00;NORTE;5;0;5;1
2018-02-21 23:00:00;NORTE;13;0;13;1
2018-02-21 23:30:00;NORTE;3;0;3;1
2018-02-22 00:00:00;NORTE;1;0;1;1
2018-02-22 00:30:00;NORTE;1;0;1;1
2018-02-22 01:00:00;NORTE;1;0;1;1
2018-02-22 02:30:00;NORTE;1;0;1;1
2018-02-22 03:00:00;NORTE;5;0;5;1
2018-02-22 03:30:00;NORTE;4;0;4;1
2018-02-22 04:00:00;NORTE;1;0;1;1
2018-02-22 04:30:00;NORTE;4;0;4;1
2018-02-22 05:00:00;NORTE;12;0;12;1
2018-02-22 05:30:00;NORTE;15;0;15;1
2018-02-22 06:00:00;NORTE;15;0;15;1
2018-02-22 06:30:00;NORTE;39;0;39;1
2018-02-22 07:00:00;NORTE;14;0;14;1
2018-02-22 07:30:00;NORTE;19;0;19;1
2018-02-22 08:00:00;NORTE;29;0;29;1
2018-02-22 08:30:00;NORTE;20;0;20;1
2018-02-22 09:00:00;NORTE;30;0;30;1
2018-02-22 09:30:00;NORTE;36;0;36;1
2018-02-22 10:00:00;NORTE;18;0;18;1
2018-02-22 10:30:00;NORTE;27;0;27;1
2018-02-22 11:00:00;NORTE;33;0;33;1
2018-02-22 11:30:00;NORTE;19;0;19;1
2018-02-22 12:00:00;NORTE;29;0;29;1
2018-02-22 12:30:00;NORTE;24;0;24;1
2018-02-22 13:00:00;NORTE;27;0;27;1
2018-02-22 13:30:00;NORTE;24;0;24;1
2018-02-22 14:00:00;NORTE;26;0;26;1
2018-02-22 14:30:00;NORTE;30;0;30;1
2018-02-22 15:00:00;NORTE;34;0;34;1
2018-02-22 15:30:00;NORTE;15;0;15;1
2018-02-22 16:00:00;NORTE;24;0;24;1
2018-02-22 16:30:00;NORTE;18;0;18;1
2018-02-22 17:00:00;NORTE;17;0;17;1
2018-02-22 17:30:00;NORTE;30;0;30;1
2018-02-22 18:00:00;NORTE;28;0;28;1
2018-02-22 18:30:00;NORTE;30;0;30;1
2018-02-22 19:00:00;NORTE;31;0;31;1
2018-02-22 19:30:00;NORTE;28;0;28;1
2018-02-22 20:00:00;NORTE;21;1;22;1
2018-02-22 20:30:00;NORTE;25;0;25;1
2018-02-22 21:00:00;NORTE;35;0;35;1
2018-02-22 21:30:00;NORTE;14;0;14;1
2018-02-22 22:00:00;NORTE;12;0;12;1
2018-02-22 22:30:00;NORTE;16;0;16;1
2018-02-22 23:00:00;NORTE;8;0;8;1
2018-02-22 23:30:00;NORTE;7;0;7;1
2018-02-23 00:30:00;NORTE;2;0;2;1
2018-02-23 02:00:00;NORTE;2;0;2;1
2018-02-23 03:00:00;NORTE;5;0;5;1
2018-02-23 03:30:00;NORTE;3;0;3;1
2018-02-23 04:00:00;NORTE;2;0;2;1
2018-02-23 04:30:00;NORTE;7;0;7;1
2018-02-23 05:00:00;NORTE;6;0;6;1
2018-02-23 05:30:00;NORTE;11;0;11;1
2018-02-23 06:00:00;NORTE;19;0;19;1
2018-02-23 06:30:00;NORTE;30;0;30;1
2018-02-23 07:00:00;NORTE;19;0;19;1
2018-02-23 07:30:00;NORTE;22;0;22;1
2018-02-23 08:00:00;NORTE;28;0;28;1
2018-02-23 08:30:00;NORTE;30;0;30;1
2018-02-23 09:00:00;NORTE;34;0;34;1
2018-02-23 09:30:00;NORTE;26;0;26;1
2018-02-23 10:00:00;NORTE;23;0;23;1
2018-02-23 10:30:00;NORTE;36;0;36;1
2018-02-23 11:00:00;NORTE;36;0;36;1
2018-02-23 11:30:00;NORTE;27;0;27;1
2018-02-23 12:00:00;NORTE;25;0;25;1
2018-02-23 12:30:00;NORTE;16;0;16;1
2018-02-23 13:00:00;NORTE;26;0;26;1
2018-02-23 13:30:00;NORTE;22;0;22;1
2018-02-23 14:00:00;NORTE;33;0;33;1
2018-02-23 14:30:00;NORTE;31;0;31;1
2018-02-23 15:00:00;NORTE;32;0;32;1
2018-02-23 15:30:00;NORTE;28;0;28;1
2018-02-23 16:00:00;NORTE;19;0;19;1
2018-02-23 16:30:00;NORTE;15;0;15;1
2018-02-23 17:00:00;NORTE;19;0;19;1
2018-02-23 17:30:00;NORTE;36;0;36;1
2018-02-23 18:00:00;NORTE;24;0;24;1
2018-02-23 18:30:00;NORTE;27;0;27;1
2018-02-23 19:00:00;NORTE;33;0;33;1
2018-02-23 19:30:00;NORTE;35;0;35;1
2018-02-23 20:00:00;NORTE;28;0;28;1
2018-02-23 20:30:00;NORTE;24;0;24;1
2018-02-23 21:00:00;NORTE;31;0;31;1
2018-02-23 21:30:00;NORTE;17;0;17;1
2018-02-23 22:00:00;NORTE;6;0;6;1
2018-02-23 22:30:00;NORTE;11;0;11;1
2018-02-23 23:00:00;NORTE;12;0;12;1
2018-02-23 23:30:00;NORTE;2;0;2;1
2018-02-24 00:30:00;NORTE;2;0;2;1
2018-02-24 01:30:00;NORTE;1;0;1;1
2018-02-24 02:00:00;NORTE;1;0;1;1
2018-02-24 03:00:00;NORTE;4;0;4;1
2018-02-24 03:30:00;NORTE;3;0;3;1
2018-02-24 04:00:00;NORTE;2;0;2;1
2018-02-24 04:30:00;NORTE;3;0;3;1
2018-02-24 05:00:00;NORTE;10;0;10;1
2018-02-24 05:30:00;NORTE;11;0;11;1
2018-02-24 06:00:00;NORTE;13;0;13;1
2018-02-24 06:30:00;NORTE;29;0;29;1
2018-02-24 07:00:00;NORTE;13;0;13;1
2018-02-24 07:30:00;NORTE;19;0;19;1
2018-02-24 08:00:00;NORTE;30;0;30;1
2018-02-24 08:30:00;NORTE;22;0;22;1
2018-02-24 09:00:00;NORTE;39;0;39;1
2018-02-24 09:30:00;NORTE;29;0;29;1
2018-02-24 10:00:00;NORTE;13;0;13;1
2018-02-24 10:30:00;NORTE;30;0;30;1
2018-02-24 11:00:00;NORTE;33;0;33;1
2018-02-24 11:30:00;NORTE;25;0;25;1
2018-02-24 12:00:00;NORTE;25;0;25;1
2018-02-24 12:30:00;NORTE;22;0;22;1
2018-02-24 13:00:00;NORTE;29;0;29;1
2018-02-24 13:30:00;NORTE;22;0;22;1
2018-02-24 14:00:00;NORTE;23;0;23;1
2018-02-24 14:30:00;NORTE;27;0;27;1
2018-02-24 15:00:00;NORTE;31;0;31;1
2018-02-24 15:30:00;NORTE;25;0;25;1
2018-02-24 16:00:00;NORTE;14;0;14;1
2018-02-24 16:30:00;NORTE;17;0;17;1
2018-02-24 17:00:00;NORTE;18;0;18;1
2018-02-24 17:30:00;NORTE;24;0;24;1
2018-02-24 18:00:00;NORTE;16;0;16;1
2018-02-24 18:30:00;NORTE;23;0;23;1
2018-02-24 19:00:00;NORTE;26;0;26;1
2018-02-24 19:30:00;NORTE;14;0;14;1
2018-02-24 20:00:00;NORTE;19;0;19;1
2018-02-24 20:30:00;NORTE;17;0;17;1
2018-02-24 21:00:00;NORTE;20;0;20;1
2018-02-24 21:30:00;NORTE;12;0;12;1
2018-02-24 22:00:00;NORTE;5;0;5;1
2018-02-24 22:30:00;NORTE;4;0;4;1
2018-02-24 23:00:00;NORTE;9;0;9;1
2018-02-24 23:30:00;NORTE;1;0;1;1
2018-02-25 00:00:00;NORTE;1;0;1;1
2018-02-25 00:30:00;NORTE;1;0;1;1
2018-02-25 01:00:00;NORTE;1;0;1;1
2018-02-25 02:00:00;NORTE;3;0;3;1
2018-02-25 02:30:00;NORTE;1;0;1;1
2018-02-25 03:00:00;NORTE;1;0;1;1
2018-02-25 03:30:00;NORTE;3;0;3;1
2018-02-25 04:00:00;NORTE;1;0;1;1
2018-02-25 04:30:00;NORTE;6;0;6;1
2018-02-25 05:00:00;NORTE;8;0;8;1
2018-02-25 05:30:00;NORTE;5;0;5;1
2018-02-25 06:00:00;NORTE;14;0;14;1
2018-02-25 06:30:00;NORTE;20;0;20;1
2018-02-25 07:00:00;NORTE;16;0;16;1
2018-02-25 07:30:00;NORTE;17;0;17;1
2018-02-25 08:00:00;NORTE;28;0;28;1
2018-02-25 08:30:00;NORTE;29;0;29;1
2018-02-25 09:00:00;NORTE;32;0;32;1
2018-02-25 09:30:00;NORTE;24;0;24;1
2018-02-25 10:00:00;NORTE;20;0;20;1
2018-02-25 10:30:00;NORTE;28;0;28;1
2018-02-25 11:00:00;NORTE;34;0;34;1
2018-02-25 11:30:00;NORTE;24;0;24;1
2018-02-25 12:00:00;NORTE;29;0;29;1
2018-02-25 12:30:00;NORTE;23;0;23;1
2018-02-25 13:00:00;NORTE;27;0;27;1
2018-02-25 13:30:00;NORTE;25;0;25;1
2018-02-25 14:00:00;NORTE;22;0;22;1
2018-02-25 14:30:00;NORTE;28;0;28;1
2018-02-25 15:00:00;NORTE;25;0;25;1
2018-02-25 15:30:00;NORTE;27;0;27;1
2018-02-25 16:00:00;NORTE;17;0;17;1
2018-02-25 16:30:00;NORTE;19;0;19;1
2018-02-25 17:00:00;NORTE;15;0;15;1
2018-02-25 17:30:00;NORTE;33;0;33;1
2018-02-25 18:00:00;NORTE;25;0;25;1
2018-02-25 18:30:00;NORTE;28;0;28;1
2018-02-25 19:00:00;NORTE;42;0;42;1
2018-02-25 19:30:00;NORTE;37;0;37;1
2018-02-25 20:00:00;NORTE;31;0;31;1
2018-02-25 20:30:00;NORTE;21;0;21;1
2018-02-25 21:00:00;NORTE;30;0;30;1
2018-02-25 21:30:00;NORTE;18;0;18;1
2018-02-25 22:00:00;NORTE;10;0;10;1
2018-02-25 22:30:00;NORTE;13;0;13;1
2018-02-25 23:00:00;NORTE;12;0;12;1
2018-02-25 23:30:00;NORTE;7;0;7;1
2018-02-26 00:00:00;NORTE;3;0;3;1
2018-02-26 00:30:00;NORTE;2;0;2;1
2018-02-26 01:00:00;NORTE;2;0;2;1
2018-02-26 01:30:00;NORTE;1;0;1;1
2018-02-26 02:00:00;NORTE;1;0;1;1
2018-02-26 02:30:00;NORTE;1;0;1;1
2018-02-26 03:00:00;NORTE;3;0;3;1
2018-02-26 03:30:00;NORTE;4;0;4;1
2018-02-26 04:30:00;NORTE;8;0;8;1
2018-02-26 05:00:00;NORTE;3;0;3;1
2018-02-26 05:30:00;NORTE;10;0;10;1
2018-02-26 06:00:00;NORTE;14;0;14;1
2018-02-26 06:30:00;NORTE;35;0;35;1
2018-02-26 07:00:00;NORTE;18;0;18;1
2018-02-26 07:30:00;NORTE;22;0;22;1
2018-02-26 08:00:00;NORTE;8;0;8;1
2018-02-26 09:30:00;NORTE;17;0;17;1
2018-02-26 10:00:00;NORTE;10;0;10;1
2018-02-26 10:30:00;NORTE;1;0;1;1
2018-02-26 16:30:00;NORTE;13;0;13;1
2018-02-26 17:00:00;NORTE;19;0;19;1
2018-02-26 17:30:00;NORTE;30;0;30;1
2018-02-26 18:00:00;NORTE;26;0;26;1
2018-02-26 18:30:00;NORTE;26;0;26;1
2018-02-26 19:00:00;NORTE;29;0;29;1
2018-02-26 19:30:00;NORTE;26;0;26;1
2018-02-26 20:00:00;NORTE;22;0;22;1
2018-02-26 20:30:00;NORTE;26;0;26;1
2018-02-26 21:00:00;NORTE;27;0;27;1
2018-02-26 21:30:00;NORTE;18;0;18;1
2018-02-26 22:00:00;NORTE;14;0;14;1
2018-02-26 22:30:00;NORTE;6;0;6;1
2018-02-26 23:00:00;NORTE;12;0;12;1
2018-02-26 23:30:00;NORTE;7;0;7;1
2018-02-27 00:00:00;NORTE;1;0;1;1
2018-02-27 00:30:00;NORTE;2;0;2;1
2018-02-27 02:30:00;NORTE;1;0;1;1
2018-02-27 03:00:00;NORTE;3;0;3;1
2018-02-27 03:30:00;NORTE;4;0;4;1
2018-02-27 04:00:00;NORTE;2;0;2;1
2018-02-27 04:30:00;NORTE;5;0;5;1
2018-02-27 05:00:00;NORTE;8;0;8;1
2018-02-27 05:30:00;NORTE;14;0;14;1
2018-02-27 06:00:00;NORTE;15;0;15;1
2018-02-27 06:30:00;NORTE;37;0;37;1
2018-02-27 07:00:00;NORTE;15;0;15;1
2018-02-27 07:30:00;NORTE;16;0;16;1
2018-02-27 08:00:00;NORTE;36;0;36;1
2018-02-27 08:30:00;NORTE;19;0;19;1
2018-02-27 09:00:00;NORTE;29;0;29;1
2018-02-27 09:30:00;NORTE;32;0;32;1
2018-02-27 10:00:00;NORTE;14;0;14;1
2018-02-27 10:30:00;NORTE;26;1;27;1
2018-02-27 11:00:00;NORTE;27;0;27;1
2018-02-27 11:30:00;NORTE;12;0;12;1
2018-02-27 12:00:00;SUR;0;24;24;1
2018-02-27 12:30:00;SUR;0;21;21;1
2018-02-27 13:00:00;SUR;0;27;27;1
2018-02-27 13:30:00;SUR;0;18;18;1
2018-02-27 14:00:00;SUR;0;31;31;1
2018-02-27 14:30:00;SUR;0;22;22;1
2018-02-27 15:00:00;SUR;0;39;39;1
2018-02-27 15:30:00;SUR;0;19;19;1
2018-02-27 16:00:00;SUR;0;19;19;1
2018-02-27 16:30:00;SUR;0;21;21;1
2018-02-27 17:00:00;SUR;0;19;19;1
2018-02-27 17:30:00;NORTE;29;0;29;1
2018-02-27 18:00:00;NORTE;4;0;4;1
2018-02-27 18:07:00;NORTE;20;0;20;1
2018-02-27 18:30:00;NORTE;25;0;25;1
2018-02-27 19:00:00;NORTE;32;0;32;1
2018-02-27 19:30:00;NORTE;27;0;27;1
2018-02-27 20:00:00;NORTE;18;0;18;1
2018-02-27 20:30:00;NORTE;22;0;22;1
2018-02-27 21:00:00;NORTE;25;0;25;1
2018-02-27 21:30:00;NORTE;18;0;18;1
2018-02-27 22:00:00;NORTE;11;0;11;1
2018-02-27 22:30:00;NORTE;3;0;3;1
2018-02-27 22:43:00;NORTE;2;0;2;1
2018-02-27 23:00:00;NORTE;10;0;10;1
2018-02-27 23:30:00;NORTE;2;0;2;1
2018-02-28 00:00:00;NORTE;2;0;2;1
2018-02-28 01:00:00;NORTE;3;0;3;1
2018-02-28 01:30:00;NORTE;2;0;2;1
2018-02-28 02:30:00;NORTE;1;0;1;1
2018-02-28 03:00:00;NORTE;3;0;3;1
2018-02-28 03:30:00;NORTE;2;0;2;1
2018-02-28 04:30:00;NORTE;6;0;6;1
2018-02-28 05:00:00;NORTE;8;0;8;1
2018-02-28 05:30:00;NORTE;11;0;11;1
2018-02-28 06:00:00;NORTE;16;0;16;1
2018-02-28 06:30:00;NORTE;33;0;33;1
2018-02-28 07:00:00;NORTE;14;0;14;1
2018-02-28 07:30:00;NORTE;19;0;19;1
2018-02-28 08:00:00;NORTE;13;0;13;1
2018-02-28 08:13:00;NORTE;13;0;13;1
2018-02-28 08:30:00;NORTE;15;0;15;1
2018-02-28 10:00:00;SUR;0;22;22;1
2018-02-28 10:30:00;SUR;0;11;11;1
2018-02-28 11:00:00;SUR;0;5;5;1
2018-02-28 11:30:00;SUR;0;29;29;1
2018-02-28 12:00:00;SUR;0;21;21;1
2018-02-28 12:30:00;SUR;0;15;15;1
2018-02-28 12:46:00;SUR;0;12;12;1
2018-02-28 13:00:00;SUR;0;19;19;1
2018-02-28 13:30:00;SUR;0;24;24;1
2018-02-28 14:00:00;SUR;0;29;29;1
2018-02-28 14:30:00;SUR;0;36;36;1
2018-02-28 15:00:00;SUR;0;20;20;1
2018-02-28 15:30:00;SUR;0;33;33;1
2018-02-28 16:00:00;SUR;0;23;23;1
2018-02-28 16:30:00;SUR;0;16;16;1
2018-02-28 17:00:00;SUR;0;19;19;1
2018-02-28 17:30:00;SUR;0;21;21;1
2018-02-28 18:00:20;SUR;0;1;1;1
2018-02-28 18:02:00;SUR;0;25;25;1
2018-02-28 18:24:00;SUR;0;5;5;1
2018-02-28 18:30:00;SUR;0;16;16;1
2018-02-28 18:47:00;SUR;0;6;6;1
2018-02-28 19:00:00;SUR;0;15;15;1
2018-02-28 19:20:00;SUR;0;12;12;1
2018-02-28 19:30:00;SUR;0;6;6;1
2018-02-28 19:39:00;SUR;0;21;21;1
2018-02-28 20:00:00;SUR;0;20;20;1
2018-02-28 20:30:00;SUR;0;25;25;1
2018-02-28 21:00:00;SUR;0;28;28;1
2018-02-28 21:30:00;SUR;0;23;23;1
2018-02-28 22:00:00;SUR;0;21;21;1
2018-02-28 22:30:00;SUR;0;13;13;1
2018-02-28 23:00:00;SUR;0;11;11;1
2018-02-28 23:30:00;SUR;0;9;9;1
2018-03-01 00:00:00;SUR;0;1;1;1
2018-03-01 00:30:00;SUR;0;3;3;1
2018-03-01 01:00:00;SUR;0;1;1;1
2018-03-01 01:30:00;SUR;0;2;2;1
2018-03-01 02:00:00;SUR;0;1;1;1
2018-03-01 03:00:00;SUR;0;3;3;1
2018-03-01 03:30:00;SUR;0;4;4;1
2018-03-01 04:00:00;SUR;0;2;2;1
2018-03-01 04:30:00;SUR;0;2;2;1
2018-03-01 05:00:00;SUR;0;7;7;1
2018-03-01 05:30:00;SUR;0;11;11;1
2018-03-01 06:00:00;SUR;0;20;20;1
2018-03-01 06:30:00;SUR;0;30;30;1
2018-03-01 07:00:00;SUR;0;16;16;1
2018-03-01 07:30:00;SUR;0;16;16;1
2018-03-01 08:00:00;SUR;0;23;23;1
2018-03-01 08:30:00;SUR;0;17;17;1
2018-03-01 09:00:00;SUR;0;25;25;1
2018-03-01 09:30:00;SUR;0;27;27;1
2018-03-01 10:00:00;SUR;0;17;17;1
2018-03-01 10:30:00;SUR;0;21;21;1
2018-03-01 11:00:00;SUR;0;29;29;1
2018-03-01 11:30:00;SUR;0;26;26;1
2018-03-01 12:00:00;SUR;0;31;31;1
2018-03-01 12:30:00;SUR;0;24;24;1
2018-03-01 13:00:00;SUR;0;24;24;1
2018-03-01 13:30:00;SUR;0;27;27;1
2018-03-01 14:00:00;SUR;0;31;31;1
2018-03-01 14:30:00;SUR;0;26;26;1
2018-03-01 15:00:00;SUR;0;31;31;1
2018-03-01 15:30:00;SUR;0;29;29;1
2018-03-01 16:00:00;SUR;0;10;10;1
2018-03-01 16:09:00;SUR;0;18;18;1
2018-03-01 16:30:00;SUR;0;13;13;1
2018-03-01 16:45:00;SUR;0;9;9;1
2018-03-01 17:00:00;SUR;0;11;11;1
2018-03-01 17:30:00;SUR;0;19;19;1
2018-03-01 18:00:00;SUR;0;32;32;1
2018-03-01 18:30:00;SUR;0;7;7;1
2018-03-01 18:39:00;SUR;0;16;16;1
2018-03-01 19:00:00;SUR;0;29;29;1
2018-03-01 19:30:00;SUR;0;19;19;1
2018-03-01 20:00:00;SUR;0;30;30;1
2018-03-01 20:30:00;SUR;0;28;28;1
2018-03-01 21:00:00;SUR;0;28;28;1
2018-03-01 21:30:00;SUR;0;29;29;1
2018-03-01 22:00:00;SUR;0;15;15;1
2018-03-01 22:30:00;SUR;0;7;7;1
2018-03-01 23:00:00;SUR;0;16;16;1
2018-03-01 23:30:00;SUR;0;7;7;1
2018-03-02 00:00:00;SUR;0;3;3;1
2018-03-02 00:30:00;SUR;0;3;3;1
2018-03-02 01:30:00;SUR;0;2;2;1
2018-03-02 02:00:00;SUR;0;1;1;1
2018-03-02 02:30:00;SUR;0;2;2;1
2018-03-02 03:00:00;SUR;0;3;3;1
2018-03-02 03:30:00;SUR;0;2;2;1
2018-03-02 04:00:00;SUR;0;4;4;1
2018-03-02 04:30:00;SUR;0;7;7;1
2018-03-02 05:00:00;SUR;0;6;6;1
2018-03-02 05:30:00;SUR;0;10;10;1
2018-03-02 06:00:00;SUR;0;18;18;1
2018-03-02 06:30:00;SUR;0;28;28;1
2018-03-02 07:00:00;SUR;0;22;22;1
2018-03-02 07:30:00;SUR;0;15;15;1
2018-03-02 08:00:00;SUR;0;34;34;1
2018-03-02 08:30:00;SUR;0;22;22;1
2018-03-02 09:00:00;SUR;0;28;28;1
2018-03-02 09:30:00;SUR;0;31;31;1
2018-03-02 10:00:00;SUR;0;25;25;1
2018-03-02 10:30:00;SUR;0;33;33;1
2018-03-02 11:00:00;SUR;0;30;30;1
2018-03-02 11:30:00;SUR;0;27;27;1
2018-03-02 12:00:00;SUR;0;26;26;1
2018-03-02 12:30:00;SUR;0;19;19;1
2018-03-02 13:00:00;SUR;0;30;30;1
2018-03-02 13:30:00;SUR;0;24;24;1
2018-03-02 14:00:00;SUR;0;26;26;1
2018-03-02 14:30:00;SUR;0;29;29;1
2018-03-02 15:00:00;SUR;0;28;28;1
2018-03-02 15:30:00;NORTE;27;2;29;1
2018-03-02 16:00:00;NORTE;32;0;32;1
2018-03-02 16:30:00;NORTE;21;0;21;1
2018-03-02 17:00:00;NORTE;16;0;16;1
2018-03-02 17:30:00;NORTE;21;0;21;1
2018-03-02 18:00:00;CONFLICTIVA;6;22;28;2
2018-03-02 18:30:00;SUR;0;25;25;1
2018-03-02 19:00:00;SUR;0;15;15;1
2018-03-02 19:17:00;SUR;0;16;16;1
2018-03-02 19:30:00;SUR;0;15;15;1
2018-03-02 19:48:00;SUR;0;9;9;1
2018-03-02 20:00:00;SUR;0;23;23;1
2018-03-02 20:30:00;SUR;0;30;30;1
2018-03-02 21:00:00;SUR;0;26;26;1
2018-03-02 21:30:00;SUR;0;16;16;1
2018-03-02 22:00:00;SUR;0;21;21;1
2018-03-02 22:30:00;SUR;0;13;13;1
2018-03-02 23:00:00;SUR;0;13;13;1
2018-03-02 23:30:00;SUR;0;11;11;1
2018-03-03 00:00:00;SUR;0;4;4;1
2018-03-03 01:00:00;SUR;0;1;1;1
2018-03-03 01:30:00;SUR;0;2;2;1
2018-03-03 03:00:00;SUR;0;1;1;1
2018-03-03 03:07:00;SUR;0;2;2;1
2018-03-03 03:20:00;SUR;0;1;1;1
2018-03-03 03:30:00;SUR;0;2;2;1
2018-03-03 04:00:00;SUR;0;1;1;1
2018-03-03 04:30:00;SUR;0;3;3;1
2018-03-03 05:00:00;SUR;0;9;9;1
2018-03-03 05:30:00;SUR;0;9;9;1
2018-03-03 06:00:00;SUR;0;19;19;1
2018-03-03 06:30:00;SUR;0;27;27;1
2018-03-03 07:00:00;SUR;0;11;11;1
2018-03-03 07:30:00;SUR;0;17;17;1
2018-03-03 08:00:00;SUR;0;34;34;1
2018-03-03 08:30:00;SUR;0;19;19;1
2018-03-03 09:00:00;SUR;0;24;24;1
2018-03-03 09:30:00;SUR;0;28;28;1
2018-03-03 10:00:00;SUR;0;17;17;1
2018-03-03 10:30:00;SUR;0;32;32;1
2018-03-03 11:00:00;SUR;0;35;35;1
2018-03-03 11:30:00;SUR;0;23;23;1
2018-03-03 12:00:00;SUR;0;22;22;1
2018-03-03 12:30:00;SUR;0;20;20;1
2018-03-03 13:00:00;SUR;0;22;22;1
2018-03-03 13:30:00;SUR;0;19;19;1
2018-03-03 14:00:00;SUR;0;28;28;1
2018-03-03 14:30:00;SUR;0;27;27;1
2018-03-03 15:00:00;SUR;0;31;31;1
2018-03-03 15:30:00;SUR;0;24;24;1
2018-03-03 16:00:00;SUR;0;20;20;1
2018-03-03 16:30:00;SUR;0;14;14;1
2018-03-03 17:00:00;SUR;0;19;19;1
2018-03-03 17:30:00;SUR;0;22;22;1
2018-03-03 18:00:00;SUR;0;14;14;1
2018-03-03 18:30:00;SUR;0;19;19;1
2018-03-03 19:00:00;CONFLICTIVA;16;7;23;2
2018-03-03 19:30:00;NORTE;19;0;19;1
2018-03-03 20:00:00;SUR;0;21;21;1
2018-03-03 20:30:00;SUR;0;19;19;1
2018-03-03 21:00:00;SUR;0;20;20;1
2018-03-03 21:30:00;SUR;0;12;12;1
2018-03-03 22:00:00;SUR;0;8;8;1
2018-03-03 22:30:00;SUR;0;10;10;1
2018-03-03 23:00:00;SUR;0;7;7;1
2018-03-03 23:30:00;SUR;0;3;3;1
2018-03-04 00:00:00;SUR;0;3;3;1
2018-03-04 01:00:00;SUR;0;1;1;1
2018-03-04 01:30:00;SUR;0;1;1;1
2018-03-04 02:00:00;SUR;0;2;2;1
2018-03-04 03:00:00;SUR;0;2;2;1
2018-03-04 03:30:00;SUR;0;5;5;1
2018-03-04 04:00:00;SUR;0;3;3;1
2018-03-04 04:30:00;SUR;0;3;3;1
2018-03-04 05:00:00;SUR;0;7;7;1
2018-03-04 05:30:00;SUR;0;11;11;1
2018-03-04 06:00:00;CONFLICTIVA;6;2;8;2
2018-03-04 06:30:00;NORTE;24;0;24;1
2018-03-04 07:00:00;NORTE;18;0;18;1
2018-03-04 07:30:00;CONFLICTIVA;6;5;11;2
2018-03-04 08:00:00;SUR;0;32;32;1
2018-03-04 08:30:00;SUR;0;21;21;1
2018-03-04 09:00:00;SUR;0;29;29;1
2018-03-04 09:30:00;SUR;0;30;30;1
2018-03-04 10:00:00;SUR;0;23;23;1
2018-03-04 10:30:00;SUR;0;24;24;1
2018-03-04 11:00:00;SUR;0;33;33;1
2018-03-04 11:30:00;SUR;0;25;25;1
2018-03-04 12:00:00;SUR;0;22;22;1
2018-03-04 12:30:00;SUR;0;28;28;1
2018-03-04 13:00:00;SUR;0;30;30;1
2018-03-04 13:30:00;SUR;0;31;31;1
2018-03-04 14:00:00;SUR;0;23;23;1
2018-03-04 14:30:00;SUR;0;27;27;1
2018-03-04 15:00:00;SUR;0;35;35;1
2018-03-04 15:30:00;SUR;0;29;29;1
2018-03-04 16:00:00;SUR;0;16;16;1
2018-03-04 16:30:00;SUR;0;25;25;1
2018-03-04 17:00:01;SUR;0;1;1;1
2018-03-04 17:02:01;SUR;0;1;1;1
2018-03-04 17:04:09;SUR;0;1;1;1
2018-03-04 17:05:40;SUR;0;1;1;1
2018-03-04 17:05:53;SUR;0;1;1;1
2018-03-04 17:07:45;SUR;0;1;1;1
2018-03-04 17:07:56;SUR;0;1;1;1
2018-03-04 17:09:23;SUR;0;1;1;1
2018-03-04 17:10:09;SUR;0;1;1;1
2018-03-04 17:13:06;SUR;0;1;1;1
2018-03-04 17:15:47;SUR;0;1;1;1
2018-03-04 17:17:44;SUR;0;1;1;1
2018-03-04 17:18:10;SUR;0;1;1;1
2018-03-04 17:20:27;SUR;0;1;1;1
2018-03-04 17:22:23;SUR;0;1;1;1
2018-03-04 17:24:00;SUR;0;1;1;1
2018-03-04 17:24:35;SUR;0;1;1;1
2018-03-04 17:26:00;SUR;0;1;1;1
2018-03-04 17:26:07;SUR;0;1;1;1
2018-03-04 17:26:15;SUR;0;1;1;1
2018-03-04 17:28:37;SUR;0;1;1;1
2018-03-04 17:29:55;SUR;0;1;1;1
2018-03-04 17:30:00;SUR;0;31;31;1
2018-03-04 18:00:00;SUR;0;28;28;1
2018-03-04 18:30:00;SUR;0;31;31;1
2018-03-04 19:00:00;SUR;0;35;35;1
2018-03-04 19:30:00;SUR;0;33;33;1
2018-03-04 20:00:00;SUR;0;25;25;1
2018-03-04 20:30:00;SUR;0;30;30;1
2018-03-04 21:00:00;SUR;0;29;29;1
2018-03-04 21:30:00;SUR;0;16;16;1
2018-03-04 22:00:00;SUR;0;14;14;1
2018-03-04 22:30:00;SUR;0;15;15;1
2018-03-04 23:00:00;SUR;0;14;14;1
2018-03-04 23:30:00;SUR;0;7;7;1
2018-03-05 00:00:00;SUR;0;3;3;1
2018-03-05 00:30:00;SUR;0;1;1;1
2018-03-05 01:00:00;SUR;0;2;2;1
2018-03-05 01:30:00;SUR;0;2;2;1
2018-03-05 02:00:00;SUR;0;1;1;1
2018-03-05 02:30:00;SUR;0;2;2;1
2018-03-05 03:00:00;SUR;0;4;4;1
2018-03-05 03:30:00;SUR;0;3;3;1
2018-03-05 04:00:00;SUR;0;1;1;1
2018-03-05 04:30:00;SUR;0;2;2;1
2018-03-05 05:00:00;SUR;0;9;9;1
2018-03-05 05:30:00;SUR;0;14;14;1
2018-03-05 06:00:00;SUR;0;19;19;1
2018-03-05 06:30:00;SUR;0;34;34;1
2018-03-05 07:00:00;SUR;0;22;22;1
2018-03-05 07:30:00;SUR;0;18;18;1
2018-03-05 08:00:00;SUR;0;31;31;1
2018-03-05 08:30:00;SUR;0;26;26;1
2018-03-05 09:00:00;SUR;0;32;32;1
2018-03-05 09:30:00;SUR;0;32;32;1
2018-03-05 10:00:00;SUR;0;30;30;1
2018-03-05 10:30:00;SUR;0;27;27;1
2018-03-05 11:00:00;SUR;0;37;37;1
2018-03-05 11:30:00;SUR;0;1;1;1
2018-03-05 12:00:00;SUR;0;17;17;1
2018-03-05 12:30:00;SUR;0;23;23;1
2018-03-05 13:00:00;SUR;0;26;26;1
2018-03-05 13:30:00;SUR;0;26;26;1
2018-03-05 14:00:00;SUR;0;37;37;1
2018-03-05 14:30:00;SUR;0;26;26;1
2018-03-05 15:00:00;SUR;0;35;35;1
2018-03-05 15:30:00;SUR;0;12;12;1
2018-03-05 15:45:00;SUR;0;9;9;1
2018-03-05 16:00:00;SUR;0;23;23;1
2018-03-05 16:30:00;SUR;0;20;20;1
2018-03-05 17:00:00;SUR;0;17;17;1
2018-03-05 17:30:00;SUR;0;26;26;1
2018-03-05 18:00:00;SUR;0;27;27;1
2018-03-05 18:30:00;SUR;0;29;29;1
2018-03-05 19:00:00;SUR;0;32;32;1
2018-03-05 19:30:00;SUR;0;32;32;1
2018-03-05 20:00:00;SUR;0;21;21;1
2018-03-05 20:30:00;CONFLICTIVA;5;13;18;2
2018-03-05 21:00:00;NORTE;41;0;41;1
2018-03-05 21:30:00;NORTE;20;0;20;1
2018-03-05 22:00:00;NORTE;17;0;17;1
2018-03-05 22:30:00;NORTE;10;0;10;1
2018-03-05 23:00:00;NORTE;9;0;9;1
2018-03-05 23:30:00;NORTE;3;0;3;1
2018-03-06 00:00:00;NORTE;1;0;1;1
2018-03-06 00:30:00;NORTE;1;0;1;1
2018-03-06 01:00:00;NORTE;1;0;1;1
2018-03-06 02:00:00;NORTE;1;0;1;1
2018-03-06 02:30:00;NORTE;2;0;2;1
2018-03-06 03:00:00;NORTE;4;0;4;1
2018-03-06 03:30:00;NORTE;1;0;1;1
2018-03-06 04:00:00;NORTE;4;0;4;1
2018-03-06 04:30:00;NORTE;5;0;5;1
2018-03-06 05:00:00;NORTE;10;0;10;1
2018-03-06 05:30:00;CONFLICTIVA;10;3;13;2
2018-03-06 06:00:00;SUR;0;23;23;1
2018-03-06 06:30:00;SUR;0;31;31;1
2018-03-06 07:00:00;SUR;0;18;18;1
2018-03-06 07:30:00;SUR;0;16;16;1
2018-03-06 08:00:00;SUR;0;39;39;1
2018-03-06 08:30:00;SUR;0;18;18;1
2018-03-06 09:00:00;SUR;0;31;31;1
2018-03-06 09:30:00;SUR;0;29;29;1
2018-03-06 10:00:00;SUR;0;29;29;1
2018-03-06 10:30:00;SUR;0;25;25;1
2018-03-06 11:00:00;SUR;0;34;34;1
2018-03-06 11:30:00;SUR;0;26;26;1
2018-03-06 12:00:00;SUR;0;4;4;1
2018-03-06 12:06:00;SUR;0;25;25;1
2018-03-06 12:30:00;SUR;0;21;21;1
2018-03-06 13:00:00;SUR;0;22;22;1
2018-03-06 13:30:00;SUR;0;29;29;1
2018-03-06 14:00:00;SUR;0;29;29;1
2018-03-06 14:30:00;SUR;0;26;26;1
2018-03-06 15:00:00;SUR;0;28;28;1
2018-03-06 15:30:00;SUR;0;29;29;1
2018-03-06 16:00:00;SUR;0;28;28;1
2018-03-06 16:30:00;SUR;0;16;16;1
2018-03-06 17:00:00;SUR;0;17;17;1
2018-03-06 17:30:00;SUR;0;36;36;1
2018-03-06 18:00:00;SUR;0;26;26;1
2018-03-06 18:30:00;CONFLICTIVA;7;9;16;2
2018-03-06 19:00:00;NORTE;37;0;37;1
2018-03-06 19:30:00;NORTE;29;0;29;1
2018-03-06 20:00:00;NORTE;21;0;21;1
2018-03-06 20:30:00;NORTE;20;0;20;1
2018-03-06 21:00:00;NORTE;29;0;29;1
2018-03-06 21:30:00;NORTE;17;0;17;1
2018-03-06 22:00:00;NORTE;15;0;15;1
2018-03-06 22:30:00;NORTE;6;0;6;1
2018-03-06 23:00:00;NORTE;7;0;7;1
2018-03-06 23:30:00;NORTE;3;0;3;1
2018-03-07 00:00:00;NORTE;2;0;2;1
2018-03-07 00:30:00;NORTE;2;0;2;1
2018-03-07 01:00:00;NORTE;3;0;3;1
2018-03-07 01:30:00;NORTE;3;0;3;1
2018-03-07 02:00:00;NORTE;2;0;2;1
2018-03-07 03:00:00;NORTE;5;0;5;1
2018-03-07 03:30:00;NORTE;3;0;3;1
2018-03-07 04:00:00;NORTE;1;0;1;1
2018-03-07 04:30:00;NORTE;9;0;9;1
2018-03-07 05:00:00;NORTE;9;0;9;1
2018-03-07 05:30:00;NORTE;15;0;15;1
2018-03-07 06:00:00;NORTE;18;0;18;1
2018-03-07 06:30:00;NORTE;38;0;38;1
2018-03-07 07:00:00;NORTE;18;0;18;1
2018-03-07 07:30:00;NORTE;20;0;20;1
2018-03-07 08:00:00;NORTE;31;0;31;1
2018-03-07 08:30:00;NORTE;26;0;26;1
2018-03-07 09:00:00;NORTE;38;0;38;1
2018-03-07 09:30:00;NORTE;34;0;34;1
2018-03-07 10:00:00;NORTE;27;0;27;1
2018-03-07 10:30:00;NORTE;30;0;30;1
2018-03-07 11:00:00;NORTE;35;0;35;1
2018-03-07 11:30:00;CONFLICTIVA;9;11;20;2
2018-03-07 12:00:00;SUR;0;26;26;1
2018-03-07 12:30:00;SUR;0;23;23;1
2018-03-07 13:00:00;SUR;0;18;18;1
2018-03-07 13:30:00;SUR;0;29;29;1
2018-03-07 14:00:00;SUR;0;29;29;1
2018-03-07 14:30:00;SUR;0;29;29;1
2018-03-07 15:00:00;SUR;0;30;30;1
2018-03-07 15:30:00;SUR;0;31;31;1
2018-03-07 16:00:00;SUR;0;26;26;1
2018-03-07 16:30:00;SUR;0;17;17;1
2018-03-07 17:00:00;SUR;0;21;21;1
2018-03-07 17:30:00;SUR;0;31;31;1
2018-03-07 18:00:00;SUR;0;28;28;1
2018-03-07 18:30:00;SUR;0;24;24;1
2018-03-07 19:00:00;NORTE;40;0;40;1
2018-03-07 19:30:00;NORTE;27;0;27;1
2018-03-07 20:00:00;NORTE;23;0;23;1
2018-03-07 20:30:00;NORTE;27;0;27;1
2018-03-07 21:00:00;NORTE;31;0;31;1
2018-03-07 21:30:00;NORTE;19;0;19;1
2018-03-07 22:00:00;NORTE;12;0;12;1
2018-03-07 22:30:00;NORTE;12;0;12;1
2018-03-07 23:00:00;NORTE;8;0;8;1
2018-03-07 23:30:00;NORTE;4;0;4;1
2018-03-08 00:00:00;NORTE;3;0;3;1
2018-03-08 00:30:00;NORTE;1;0;1;1
2018-03-08 01:00:00;NORTE;1;0;1;1
2018-03-08 01:30:00;NORTE;1;0;1;1
2018-03-08 02:30:00;NORTE;1;0;1;1
2018-03-08 03:00:00;NORTE;3;0;3;1
2018-03-08 03:30:00;NORTE;3;0;3;1
2018-03-08 04:00:00;NORTE;1;0;1;1
2018-03-08 04:30:00;NORTE;5;0;5;1
2018-03-08 05:00:00;NORTE;9;0;9;1
2018-03-08 05:30:00;NORTE;12;0;12;1
2018-03-08 06:00:00;NORTE;13;0;13;1
2018-03-08 06:30:00;NORTE;37;0;37;1
2018-03-08 07:00:00;NORTE;18;0;18;1
2018-03-08 07:30:00;NORTE;13;0;13;1
2018-03-08 08:00:00;NORTE;29;0;29;1
2018-03-08 08:30:00;NORTE;22;0;22;1
2018-03-08 09:00:00;NORTE;39;0;39;1
2018-03-08 09:30:00;NORTE;27;0;27;1
2018-03-08 10:00:00;NORTE;18;0;18;1
2018-03-08 10:30:00;NORTE;29;0;29;1
2018-03-08 11:00:00;NORTE;29;0;29;1
2018-03-08 11:30:00;NORTE;27;0;27;1
2018-03-08 12:00:00;NORTE;27;0;27;1
2018-03-08 12:30:00;NORTE;20;0;20;1
2018-03-08 13:00:00;NORTE;25;0;25;1
2018-03-08 13:30:00;NORTE;27;0;27;1
2018-03-08 14:00:00;NORTE;28;0;28;1
2018-03-08 14:30:00;NORTE;28;0;28;1
2018-03-08 15:00:00;NORTE;38;0;38;1
2018-03-08 15:30:00;NORTE;28;0;28;1
2018-03-08 16:00:00;NORTE;18;0;18;1
2018-03-08 16:30:00;NORTE;16;0;16;1
2018-03-08 17:00:00;NORTE;22;0;22;1
2018-03-08 17:30:00;NORTE;24;0;24;1
2018-03-08 18:00:00;NORTE;35;0;35;1
2018-03-08 18:30:00;NORTE;25;0;25;1
2018-03-08 19:00:00;NORTE;33;0;33;1
2018-03-08 19:30:00;NORTE;34;0;34;1
2018-03-08 20:00:00;NORTE;25;0;25;1
2018-03-08 20:30:00;NORTE;28;0;28;1
2018-03-08 21:00:00;NORTE;33;0;33;1
2018-03-08 21:30:00;NORTE;10;0;10;1
2018-03-08 22:00:00;NORTE;14;0;14;1
2018-03-08 22:30:00;NORTE;14;0;14;1
2018-03-08 23:00:00;NORTE;8;0;8;1
2018-03-08 23:30:00;NORTE;2;0;2;1
2018-03-09 00:00:00;NORTE;1;0;1;1
2018-03-09 00:30:00;NORTE;1;0;1;1
2018-03-09 01:00:00;NORTE;1;0;1;1
2018-03-09 02:00:00;NORTE;3;0;3;1
2018-03-09 02:30:00;NORTE;2;0;2;1
2018-03-09 03:00:00;NORTE;2;0;2;1
2018-03-09 03:30:00;NORTE;3;0;3;1
2018-03-09 04:00:00;NORTE;3;0;3;1
2018-03-09 04:30:00;NORTE;6;0;6;1
2018-03-09 04:49:00;NORTE;3;0;3;1
2018-03-09 05:00:00;NORTE;6;0;6;1
2018-03-09 05:30:00;NORTE;8;0;8;1
2018-03-09 05:47:00;NORTE;5;0;5;1
2018-03-09 06:00:00;NORTE;15;0;15;1
2018-03-09 06:30:00;NORTE;35;0;35;1
2018-03-09 07:00:00;CONFLICTIVA;14;5;19;2
2018-03-09 07:30:00;SUR;0;18;18;1
2018-03-09 08:00:00;SUR;0;34;34;1
2018-03-09 08:30:00;SUR;0;26;26;1
2018-03-09 09:00:00;SUR;0;30;30;1
2018-03-09 09:30:00;SUR;0;35;35;1
2018-03-09 10:00:00;SUR;0;24;24;1
2018-03-09 10:30:00;SUR;0;32;32;1
2018-03-09 11:00:00;SUR;0;34;34;1
2018-03-09 11:30:00;SUR;0;33;33;1
2018-03-09 12:00:00;SUR;0;23;23;1
2018-03-09 12:30:00;SUR;0;25;25;1
2018-03-09 13:00:00;SUR;0;25;25;1
2018-03-09 13:30:00;SUR;0;26;26;1
2018-03-09 14:00:00;SUR;0;33;33;1
2018-03-09 14:30:00;SUR;0;32;32;1
2018-03-09 15:00:44;SUR;0;1;1;1
2018-03-09 15:01:24;SUR;0;1;1;1
2018-03-09 15:02:45;SUR;0;1;1;1
2018-03-09 15:03:13;SUR;0;1;1;1
2018-03-09 15:03:52;SUR;0;1;1;1
2018-03-09 15:04:24;SUR;0;1;1;1
2018-03-09 15:04:38;SUR;0;1;1;1
2018-03-09 15:05:25;SUR;0;1;1;1
2018-03-09 15:05:50;SUR;0;1;1;1
2018-03-09 15:06:45;SUR;0;1;1;1
2018-03-09 15:09:05;SUR;0;1;1;1
2018-03-09 15:09:26;SUR;0;1;1;1
2018-03-09 15:10:48;SUR;0;1;1;1
2018-03-09 15:11:05;SUR;0;1;1;1
2018-03-09 15:12:15;SUR;0;1;1;1
2018-03-09 15:12:23;SUR;0;1;1;1
2018-03-09 15:13:44;SUR;0;1;1;1
2018-03-09 15:14:28;SUR;0;1;1;1
2018-03-09 15:14:44;SUR;0;1;1;1
2018-03-09 15:15:39;SUR;0;1;1;1
2018-03-09 15:17:11;SUR;0;1;1;1
2018-03-09 15:18:13;SUR;0;1;1;1
2018-03-09 15:19:22;SUR;0;1;1;1
2018-03-09 15:21:18;SUR;0;1;1;1
2018-03-09 15:22:58;SUR;0;1;1;1
2018-03-09 15:23:19;SUR;0;1;1;1
2018-03-09 15:24:32;SUR;0;1;1;1
2018-03-09 15:26:53;SUR;0;1;1;1
2018-03-09 15:27:41;SUR;0;1;1;1
2018-03-09 15:27:42;SUR;0;1;1;1
2018-03-09 15:28:37;SUR;0;1;1;1
2018-03-09 15:28:55;SUR;0;1;1;1
2018-03-09 15:29:41;SUR;0;1;1;1
2018-03-09 15:30:00;SUR;0;30;30;1
2018-03-09 16:00:00;SUR;0;26;26;1
2018-03-09 16:30:00;SUR;0;19;19;1
2018-03-09 17:00:00;SUR;0;25;25;1
2018-03-09 17:30:00;SUR;0;27;27;1
2018-03-09 18:00:00;SUR;0;28;28;1
2018-03-09 18:30:00;SUR;0;29;29;1
2018-03-09 19:00:00;SUR;0;35;35;1
2018-03-09 19:30:00;SUR;0;35;35;1
2018-03-09 20:00:00;SUR;0;25;25;1
2018-03-09 20:30:00;SUR;0;30;30;1
2018-03-09 21:00:00;SUR;0;26;26;1
2018-03-09 21:30:00;SUR;0;20;20;1
2018-03-09 22:00:00;SUR;0;14;14;1
2018-03-09 22:30:00;SUR;0;14;14;1
2018-03-09 23:00:00;SUR;0;11;11;1
2018-03-09 23:30:00;SUR;0;5;5;1
2018-03-10 00:00:00;SUR;0;3;3;1
2018-03-10 01:30:00;SUR;0;1;1;1
2018-03-10 02:00:00;SUR;0;1;1;1
2018-03-10 03:00:00;SUR;0;2;2;1
2018-03-10 03:30:00;SUR;0;5;5;1
2018-03-10 04:00:00;SUR;0;2;2;1
2018-03-10 04:30:00;SUR;0;5;5;1
2018-03-10 05:00:00;SUR;0;9;9;1
2018-03-10 05:30:00;SUR;0;11;11;1
2018-03-10 06:00:00;SUR;0;16;16;1
2018-03-10 06:30:00;SUR;0;24;24;1
2018-03-10 07:00:00;SUR;0;17;17;1
2018-03-10 07:30:00;SUR;0;11;11;1
2018-03-10 08:00:00;SUR;0;19;19;1
2018-03-10 08:13:00;SUR;0;23;23;1
2018-03-10 08:30:00;SUR;0;16;16;1
2018-03-10 09:00:00;SUR;0;33;33;1
2018-03-10 09:30:00;SUR;0;32;32;1
2018-03-10 10:00:00;SUR;0;16;16;1
2018-03-10 10:30:00;SUR;0;30;30;1
2018-03-10 11:00:00;SUR;0;29;29;1
2018-03-10 11:30:00;SUR;0;30;30;1
2018-03-10 12:00:00;SUR;0;31;31;1
2018-03-10 12:30:00;SUR;0;22;22;1
2018-03-10 13:00:00;SUR;0;18;18;1
2018-03-10 13:30:00;SUR;0;25;25;1
2018-03-10 14:00:00;SUR;0;32;32;1
2018-03-10 14:30:00;SUR;0;19;19;1
2018-03-10 15:00:00;SUR;0;34;34;1
2018-03-10 15:30:00;SUR;0;18;18;1
2018-03-10 16:00:00;SUR;0;16;16;1
2018-03-10 16:30:00;SUR;0;18;18;1
2018-03-10 17:00:00;SUR;0;12;12;1
2018-03-10 17:19:00;SUR;0;8;8;1
2018-03-10 17:30:00;SUR;0;3;3;1
2018-03-10 17:35:00;SUR;0;16;16;1
2018-03-10 18:00:00;SUR;0;21;21;1
2018-03-10 18:30:00;SUR;0;18;18;1
2018-03-10 19:00:00;SUR;0;26;26;1
2018-03-10 19:30:00;SUR;0;19;19;1
2018-03-10 20:00:00;SUR;0;18;18;1
2018-03-10 20:30:00;SUR;0;17;17;1
2018-03-10 21:00:00;SUR;0;16;16;1
2018-03-10 21:30:00;SUR;0;16;16;1
2018-03-10 22:00:00;SUR;0;10;10;1
2018-03-10 22:30:00;SUR;0;5;5;1
2018-03-10 23:00:00;SUR;0;7;7;1
2018-03-10 23:30:00;SUR;0;5;5;1
2018-03-11 00:00:00;SUR;0;2;2;1
2018-03-11 01:30:00;SUR;0;3;3;1
2018-03-11 02:00:00;SUR;0;1;1;1
2018-03-11 02:30:00;SUR;0;1;1;1
2018-03-11 03:00:00;SUR;0;1;1;1
2018-03-11 03:30:00;SUR;0;1;1;1
2018-03-11 04:00:00;SUR;0;3;3;1
2018-03-11 04:30:00;SUR;0;4;4;1
2018-03-11 05:00:00;SUR;0;6;6;1
2018-03-11 05:30:00;SUR;0;8;8;1
2018-03-11 06:00:00;SUR;0;15;15;1
2018-03-11 06:30:00;SUR;0;20;20;1
2018-03-11 07:00:00;SUR;0;13;13;1
2018-03-11 07:21:00;SUR;0;4;4;1
2018-03-11 07:30:00;SUR;0;17;17;1
2018-03-11 08:00:00;SUR;0;21;21;1
2018-03-11 08:30:00;SUR;0;20;20;1
2018-03-11 09:00:00;SUR;0;29;29;1
2018-03-11 09:30:00;SUR;0;26;26;1
2018-03-11 10:00:00;SUR;0;24;24;1
2018-03-11 10:30:00;SUR;0;30;30;1
2018-03-11 11:00:00;SUR;0;32;32;1
2018-03-11 11:30:00;SUR;0;24;24;1
2018-03-11 12:00:00;SUR;0;31;31;1
2018-03-11 12:30:00;SUR;0;20;20;1
2018-03-11 13:00:00;SUR;0;26;26;1
2018-03-11 13:30:00;SUR;0;20;20;1
2018-03-11 14:00:00;SUR;0;12;12;1
2018-03-11 14:14:00;SUR;0;18;18;1
2018-03-11 14:33:00;SUR;0;19;19;1
2018-03-11 15:00:00;SUR;0;24;24;1
2018-03-11 15:30:00;SUR;0;28;28;1
2018-03-11 16:00:00;SUR;0;22;22;1
2018-03-11 16:30:00;SUR;0;22;22;1
2018-03-11 17:00:00;SUR;0;16;16;1
2018-03-11 17:30:00;SUR;0;22;22;1
2018-03-11 18:00:00;SUR;0;36;36;1
2018-03-11 18:30:00;SUR;0;23;23;1
2018-03-11 19:00:00;SUR;0;33;33;1
2018-03-11 19:30:00;SUR;0;39;39;1
2018-03-11 20:00:00;SUR;0;29;29;1
2018-03-11 20:30:00;SUR;0;23;23;1
2018-03-11 21:00:00;SUR;0;36;36;1
2018-03-11 21:30:00;SUR;0;20;20;1
2018-03-11 22:00:00;SUR;0;8;8;1
2018-03-11 22:30:00;SUR;0;16;16;1
2018-03-11 23:00:00;SUR;0;7;7;1
2018-03-11 23:30:00;SUR;0;9;9;1
2018-03-12 00:00:00;SUR;0;3;3;1
2018-03-12 00:30:00;SUR;0;2;2;1
2018-03-12 01:00:00;SUR;0;2;2;1
2018-03-12 02:30:00;SUR;0;1;1;1
2018-03-12 03:00:00;SUR;0;2;2;1
2018-03-12 03:30:00;SUR;0;5;5;1
2018-03-12 04:00:00;SUR;0;1;1;1
2018-03-12 04:30:00;SUR;0;7;7;1
2018-03-12 05:00:00;SUR;0;5;5;1
2018-03-12 05:30:00;SUR;0;15;15;1
2018-03-12 06:00:00;SUR;0;16;16;1
2018-03-12 06:30:00;SUR;0;36;36;1
2018-03-12 07:00:00;SUR;0;17;17;1
2018-03-12 07:30:00;SUR;0;18;18;1
2018-03-12 08:00:00;SUR;0;30;30;1
2018-03-12 08:30:00;SUR;0;28;28;1
2018-03-12 09:00:00;SUR;0;35;35;1
2018-03-12 09:30:00;SUR;0;32;32;1
2018-03-12 10:00:00;SUR;0;30;30;1
2018-03-12 10:30:00;SUR;0;22;22;1
2018-03-12 11:00:00;SUR;0;25;25;1
2018-03-12 11:30:00;SUR;0;34;34;1
2018-03-12 12:00:00;SUR;0;28;28;1
2018-03-12 12:30:00;SUR;0;22;22;1
2018-03-12 13:00:00;SUR;0;25;25;1
2018-03-12 13:30:00;SUR;0;30;30;1
2018-03-12 14:00:00;SUR;0;26;26;1
2018-03-12 14:30:00;SUR;0;25;25;1
2018-03-12 15:00:00;SUR;0;36;36;1
2018-03-12 15:30:00;SUR;0;24;24;1
2018-03-12 16:00:00;SUR;0;16;16;1
2018-03-12 16:30:00;SUR;0;24;24;1
2018-03-12 17:00:00;SUR;0;27;27;1
2018-03-12 17:30:00;SUR;0;31;31;1
2018-03-12 18:00:00;SUR;0;29;29;1
2018-03-12 18:30:00;SUR;0;26;26;1
2018-03-12 19:00:00;SUR;0;32;32;1
2018-03-12 19:30:00;SUR;0;28;28;1
2018-03-12 20:00:00;SUR;0;26;26;1
2018-03-12 20:30:00;SUR;0;23;23;1
2018-03-12 21:00:00;SUR;0;31;31;1
2018-03-12 21:30:00;SUR;0;14;14;1
2018-03-12 22:00:00;SUR;0;20;20;1
2018-03-12 22:30:00;SUR;0;7;7;1
2018-03-12 23:00:00;SUR;0;11;11;1
2018-03-12 23:30:00;SUR;0;1;1;1
2018-03-13 00:00:00;SUR;0;1;1;1
2018-03-13 01:00:00;SUR;0;2;2;1
2018-03-13 01:30:00;SUR;0;1;1;1
2018-03-13 02:30:00;SUR;0;1;1;1
2018-03-13 03:00:00;SUR;0;2;2;1
2018-03-13 03:30:00;SUR;0;3;3;1
2018-03-13 04:00:00;SUR;0;3;3;1
2018-03-13 04:30:00;SUR;0;3;3;1
2018-03-13 04:41:00;SUR;0;6;6;1
2018-03-13 04:52:00;SUR;0;3;3;1
2018-03-13 05:00:00;SUR;0;5;5;1
2018-03-13 05:30:00;SUR;0;15;15;1
2018-03-13 06:00:00;SUR;0;22;22;1
2018-03-13 06:30:00;SUR;0;33;33;1
2018-03-13 07:00:00;SUR;0;16;16;1
2018-03-13 07:30:00;SUR;0;18;18;1
2018-03-13 08:00:00;SUR;0;30;30;1
2018-03-13 08:30:00;SUR;0;24;24;1
2018-03-13 09:00:00;SUR;0;33;33;1
2018-03-13 09:30:00;SUR;0;26;26;1
2018-03-13 10:00:00;SUR;0;28;28;1
2018-03-13 10:30:00;SUR;0;30;30;1
2018-03-13 11:00:00;SUR;0;31;31;1
2018-03-13 11:30:00;SUR;0;28;28;1
2018-03-13 12:00:00;SUR;0;29;29;1
2018-03-13 12:30:00;SUR;0;21;21;1
2018-03-13 13:00:00;SUR;0;28;28;1
2018-03-13 13:30:00;SUR;0;24;24;1
2018-03-13 14:00:00;SUR;0;29;29;1
2018-03-13 14:30:00;SUR;0;33;33;1
2018-03-13 15:00:00;SUR;0;28;28;1
2018-03-13 15:30:00;SUR;0;26;26;1
2018-03-13 16:00:00;SUR;0;17;17;1
2018-03-13 16:30:00;SUR;0;19;19;1
2018-03-13 17:00:00;SUR;0;23;23;1
2018-03-13 17:30:00;SUR;0;29;29;1
2018-03-13 18:00:00;SUR;0;25;25;1
2018-03-13 18:30:00;SUR;0;20;20;1
2018-03-13 19:00:00;SUR;0;36;36;1
2018-03-13 19:30:00;SUR;0;29;29;1
2018-03-13 20:00:00;SUR;0;17;17;1
2018-03-13 20:30:00;SUR;0;27;27;1
2018-03-13 21:00:00;SUR;0;21;21;1
2018-03-13 21:30:00;SUR;0;18;18;1
2018-03-13 22:00:00;SUR;0;11;11;1
2018-03-13 22:30:00;SUR;0;6;6;1
2018-03-13 23:00:00;SUR;0;8;8;1
2018-03-13 23:30:00;SUR;0;2;2;1
2018-03-14 00:00:00;SUR;0;3;3;1
2018-03-14 01:30:00;SUR;0;3;3;1
2018-03-14 02:30:00;SUR;0;2;2;1
2018-03-14 03:30:00;SUR;0;4;4;1
2018-03-14 04:00:00;SUR;0;3;3;1
2018-03-14 04:30:00;SUR;0;5;5;1
2018-03-14 05:00:00;CONFLICTIVA;8;2;10;2
2018-03-14 05:30:00;NORTE;14;0;14;1
2018-03-14 06:00:00;NORTE;19;0;19;1
2018-03-14 06:30:00;NORTE;32;0;32;1
2018-03-14 07:00:00;NORTE;12;0;12;1
2018-03-14 07:17:00;NORTE;5;0;5;1
2018-03-14 07:30:00;NORTE;19;0;19;1
2018-03-14 08:00:00;SUR;0;31;31;1
2018-03-14 08:30:00;SUR;0;16;16;1
2018-03-14 09:00:00;SUR;0;30;30;1
2018-03-14 09:30:00;SUR;0;29;29;1
2018-03-14 10:00:00;SUR;0;25;25;1
2018-03-14 10:30:00;SUR;0;31;31;1
2018-03-14 11:00:00;SUR;0;28;28;1
2018-03-14 11:30:00;SUR;0;32;32;1
2018-03-14 12:00:00;SUR;0;23;23;1
2018-03-14 12:30:00;SUR;0;21;21;1
2018-03-14 13:00:00;SUR;0;25;25;1
2018-03-14 13:30:00;SUR;0;19;19;1
2018-03-14 14:00:00;SUR;0;19;19;1
2018-03-14 14:18:00;SUR;0;10;10;1
2018-03-14 14:30:00;SUR;0;27;27;1
2018-03-14 15:00:00;SUR;0;19;19;1
2018-03-14 15:30:00;SUR;0;30;30;1
2018-03-14 16:00:00;SUR;0;18;18;1
2018-03-14 16:30:00;SUR;0;16;16;1
2018-03-14 17:00:00;SUR;0;13;13;1
2018-03-14 17:30:00;SUR;0;27;27;1
2018-03-14 18:00:00;SUR;0;23;23;1
2018-03-14 18:30:00;SUR;0;26;26;1
2018-03-14 19:00:00;SUR;0;28;28;1
2018-03-14 19:30:00;SUR;0;30;30;1
2018-03-14 20:00:00;SUR;0;11;11;1
2018-03-14 20:18:00;SUR;0;6;6;1
2018-03-14 20:30:00;SUR;0;22;22;1
2018-03-14 21:00:00;SUR;0;31;31;1
2018-03-14 21:30:00;SUR;0;19;19;1
2018-03-14 22:00:00;SUR;0;16;16;1
2018-03-14 22:30:00;SUR;0;15;15;1
2018-03-14 23:00:00;SUR;0;9;9;1
2018-03-14 23:30:00;SUR;0;5;5;1
2018-03-15 00:00:00;SUR;0;2;2;1
2018-03-15 00:30:00;SUR;0;1;1;1
2018-03-15 01:00:00;SUR;0;1;1;1
2018-03-15 01:30:00;SUR;0;1;1;1
2018-03-15 02:30:00;SUR;0;1;1;1
2018-03-15 03:00:00;SUR;0;2;2;1
2018-03-15 03:30:00;SUR;0;5;5;1
2018-03-15 04:00:00;SUR;0;4;4;1
2018-03-15 04:30:00;SUR;0;6;6;1
2018-03-15 05:00:00;SUR;0;12;12;1
2018-03-15 05:30:00;SUR;0;12;12;1
2018-03-15 06:00:00;SUR;0;19;19;1
2018-03-15 06:30:00;SUR;0;33;33;1
2018-03-15 07:00:00;SUR;0;16;16;1
2018-03-15 07:30:00;SUR;0;15;15;1
2018-03-15 08:00:00;SUR;0;32;32;1
2018-03-15 08:30:00;SUR;0;23;23;1
2018-03-15 09:00:00;SUR;0;29;29;1
2018-03-15 09:30:00;SUR;0;28;28;1
2018-03-15 10:00:00;SUR;0;26;26;1
2018-03-15 10:30:00;SUR;0;29;29;1
2018-03-15 11:00:00;SUR;0;34;34;1
2018-03-15 11:30:00;SUR;0;21;21;1
2018-03-15 12:00:00;SUR;0;24;24;1
2018-03-15 12:30:00;SUR;0;22;22;1
2018-03-15 13:00:00;SUR;0;24;24;1
2018-03-15 13:30:00;SUR;0;25;25;1
2018-03-15 14:00:00;SUR;0;31;31;1
2018-03-15 14:30:00;SUR;0;26;26;1
2018-03-15 15:00:00;SUR;0;20;20;1
2018-03-15 15:30:00;SUR;0;23;23;1
2018-03-15 16:00:00;SUR;0;22;22;1
2018-03-15 16:30:00;SUR;0;24;24;1
2018-03-15 17:00:00;SUR;0;19;19;1
2018-03-15 17:30:00;SUR;0;20;20;1
2018-03-15 22:00:00;SUR;0;16;16;1
2018-03-15 22:30:00;SUR;0;13;13;1
2018-03-15 23:00:00;SUR;0;11;11;1
2018-03-15 23:30:00;SUR;0;6;6;1
2018-03-16 00:00:00;SUR;0;2;2;1
2018-03-16 00:30:00;SUR;0;1;1;1
2018-03-16 01:00:00;SUR;0;1;1;1
2018-03-16 02:00:00;SUR;0;2;2;1
2018-03-16 02:30:00;SUR;0;1;1;1
2018-03-16 03:00:00;SUR;0;5;5;1
2018-03-16 03:30:00;SUR;0;1;1;1
2018-03-16 04:00:00;SUR;0;2;2;1
2018-03-16 04:30:00;SUR;0;9;9;1
2018-03-16 05:00:00;SUR;0;6;6;1
2018-03-16 05:30:00;SUR;0;12;12;1
2018-03-16 06:00:00;SUR;0;15;15;1
2018-03-16 06:30:00;SUR;0;31;31;1
2018-03-16 07:00:00;SUR;0;22;22;1
2018-03-16 07:30:00;SUR;0;13;13;1
2018-03-16 08:00:00;SUR;0;35;35;1
2018-03-16 08:30:00;SUR;0;26;26;1
2018-03-16 09:00:00;SUR;0;29;29;1
2018-03-16 09:30:00;SUR;0;28;28;1
2018-03-16 10:00:00;SUR;0;23;23;1
2018-03-16 10:30:00;SUR;0;30;30;1
2018-03-16 11:00:00;SUR;0;28;28;1
2018-03-16 11:30:00;SUR;0;27;27;1
2018-03-16 12:00:00;SUR;0;29;29;1
2018-03-16 12:30:00;SUR;0;15;15;1
2018-03-16 13:00:00;SUR;0;26;26;1
2018-03-16 13:30:44;SUR;0;1;1;1
2018-03-16 13:31:00;SUR;0;1;1;1
2018-03-16 13:32:05;SUR;0;1;1;1
2018-03-16 13:32:39;SUR;0;1;1;1
2018-03-16 13:34:00;SUR;0;17;17;1
2018-03-16 14:00:00;SUR;0;32;32;1
2018-03-16 14:30:00;SUR;0;17;17;1
2018-03-16 15:00:00;SUR;0;24;24;1
2018-03-16 15:30:00;SUR;0;27;27;1
2018-03-16 16:00:00;SUR;0;28;28;1
2018-03-16 16:30:00;SUR;0;35;35;1
2018-03-16 17:00:00;SUR;0;19;19;1
2018-03-16 17:19:00;SUR;0;9;9;1
2018-03-16 17:30:00;SUR;0;22;22;1
2018-03-16 18:00:00;SUR;0;31;31;1
2018-03-16 18:30:00;SUR;0;23;23;1
2018-03-16 19:00:00;SUR;0;33;33;1
2018-03-16 19:30:00;SUR;0;32;32;1
2018-03-16 20:00:00;SUR;0;30;30;1
2018-03-16 20:30:00;SUR;0;21;21;1
2018-03-16 21:00:00;SUR;0;33;33;1
2018-03-16 21:30:00;SUR;0;19;19;1
2018-03-16 22:00:00;SUR;0;16;16;1
2018-03-16 22:30:00;SUR;0;12;12;1
2018-03-16 23:00:00;NORTE;15;0;15;1
2018-03-16 23:30:00;NORTE;6;0;6;1
2018-03-17 01:30:00;NORTE;2;0;2;1
2018-03-17 03:00:00;NORTE;4;0;4;1
2018-03-17 03:30:00;NORTE;4;0;4;1
2018-03-17 04:00:00;NORTE;2;0;2;1
2018-03-17 04:30:00;NORTE;2;0;2;1
2018-03-17 05:00:00;NORTE;10;0;10;1
2018-03-17 05:30:00;SUR;0;13;13;1
2018-03-17 06:00:00;SUR;0;17;17;1
2018-03-17 06:30:00;SUR;0;21;21;1
2018-03-17 07:00:00;SUR;0;11;11;1
2018-03-17 07:30:00;SUR;0;13;13;1
2018-03-17 08:00:00;SUR;0;32;32;1
2018-03-17 08:30:00;SUR;0;20;20;1
2018-03-17 09:00:00;SUR;0;32;32;1
2018-03-17 09:30:00;SUR;0;30;30;1
2018-03-17 10:00:00;SUR;0;22;22;1
2018-03-17 10:30:00;SUR;0;34;34;1
2018-03-17 11:00:00;SUR;0;26;26;1
2018-03-17 11:30:00;SUR;0;20;20;1
2018-03-17 12:00:00;SUR;0;26;26;1
2018-03-17 12:30:00;CONFLICTIVA;12;4;16;2
2018-03-17 13:00:00;NORTE;25;0;25;1
2018-03-17 13:30:00;NORTE;26;0;26;1
2018-03-17 14:00:00;NORTE;19;0;19;1
2018-03-17 14:30:00;NORTE;22;0;22;1
2018-03-17 15:00:00;NORTE;32;0;32;1
2018-03-17 15:30:00;NORTE;22;0;22;1
2018-03-17 16:00:00;NORTE;18;0;18;1
2018-03-17 16:30:00;NORTE;14;0;14;1
2018-03-17 17:00:00;NORTE;15;0;15;1
2018-03-17 17:30:00;NORTE;19;0;19;1
2018-03-17 18:00:00;NORTE;21;0;21;1
2018-03-17 18:30:00;NORTE;18;0;18;1
2018-03-17 19:00:00;NORTE;23;0;23;1
2018-03-17 19:30:00;NORTE;16;0;16;1
2018-03-17 20:00:00;NORTE;14;0;14;1
2018-03-17 20:30:00;NORTE;17;0;17;1
2018-03-17 21:00:00;NORTE;19;0;19;1
2018-03-17 21:30:00;NORTE;13;0;13;1
2018-03-17 22:00:00;NORTE;2;0;2;1
2018-03-17 22:30:00;NORTE;9;0;9;1
2018-03-17 23:00:00;NORTE;9;0;9;1
2018-03-17 23:30:00;NORTE;3;0;3;1
2018-03-18 00:00:00;NORTE;1;0;1;1
2018-03-18 00:30:00;NORTE;1;0;1;1
2018-03-18 01:30:00;NORTE;2;0;2;1
2018-03-18 02:00:00;NORTE;1;0;1;1
2018-03-18 02:30:00;NORTE;3;0;3;1
2018-03-18 03:00:00;NORTE;1;0;1;1
2018-03-18 03:30:00;NORTE;4;0;4;1
2018-03-18 04:00:00;NORTE;1;0;1;1
2018-03-18 04:30:00;NORTE;5;0;5;1
2018-03-18 05:00:00;NORTE;4;0;4;1
2018-03-18 05:30:00;NORTE;8;0;8;1
2018-03-18 06:00:00;NORTE;15;0;15;1
2018-03-18 06:30:00;NORTE;20;0;20;1
2018-03-18 07:00:00;NORTE;16;0;16;1
2018-03-18 07:30:00;NORTE;13;0;13;1
2018-03-18 08:00:00;NORTE;29;0;29;1
2018-03-18 08:30:00;NORTE;26;0;26;1
2018-03-18 09:00:00;NORTE;30;0;30;1
2018-03-18 09:30:00;NORTE;21;0;21;1
2018-03-18 10:00:00;NORTE;21;0;21;1
2018-03-18 10:30:00;NORTE;32;0;32;1
2018-03-18 11:00:00;NORTE;39;0;39;1
2018-03-18 11:30:00;NORTE;27;0;27;1
2018-03-18 12:00:00;NORTE;23;0;23;1
2018-03-18 12:30:00;NORTE;23;0;23;1
2018-03-18 13:00:00;NORTE;26;0;26;1
2018-03-18 13:30:00;NORTE;29;0;29;1
2018-03-18 14:00:00;NORTE;23;0;23;1
2018-03-18 14:30:00;NORTE;22;0;22;1
2018-03-18 15:00:00;NORTE;39;0;39;1
2018-03-18 15:30:00;NORTE;28;0;28;1
2018-03-18 16:00:00;NORTE;22;0;22;1
2018-03-18 16:30:00;NORTE;20;0;20;1
2018-03-18 17:00:00;NORTE;18;0;18;1
2018-03-18 17:30:00;NORTE;27;0;27;1
2018-03-18 18:00:00;NORTE;29;0;29;1
2018-03-18 18:30:00;NORTE;26;0;26;1
2018-03-18 19:00:00;NORTE;32;0;32;1
2018-03-18 19:30:00;NORTE;28;0;28;1
2018-03-18 20:00:00;NORTE;28;0;28;1
2018-03-18 20:30:00;NORTE;27;0;27;1
2018-03-18 21:00:00;NORTE;30;0;30;1
2018-03-18 21:30:00;NORTE;20;0;20;1
2018-03-18 22:00:00;NORTE;14;0;14;1
2018-03-18 22:30:00;NORTE;11;0;11;1
2018-03-18 23:00:00;NORTE;10;0;10;1
2018-03-18 23:30:00;NORTE;10;0;10;1
2018-03-19 00:00:00;NORTE;3;0;3;1
2018-03-19 00:30:00;NORTE;1;0;1;1
2018-03-19 01:00:00;NORTE;1;0;1;1
2018-03-19 01:30:00;NORTE;3;0;3;1
2018-03-19 02:00:00;NORTE;2;0;2;1
2018-03-19 02:30:00;NORTE;1;0;1;1
2018-03-19 03:00:00;NORTE;3;0;3;1
2018-03-19 03:30:00;NORTE;2;0;2;1
2018-03-19 04:00:00;NORTE;2;0;2;1
2018-03-19 04:30:00;NORTE;4;0;4;1
2018-03-19 05:00:00;NORTE;9;0;9;1
2018-03-19 05:30:00;NORTE;13;0;13;1
2018-03-19 06:00:00;NORTE;19;0;19;1
2018-03-19 06:30:00;NORTE;34;0;34;1
2018-03-19 07:00:00;NORTE;18;0;18;1
2018-03-19 07:30:00;NORTE;21;0;21;1
2018-03-19 08:00:00;NORTE;33;0;33;1
2018-03-19 08:30:00;NORTE;24;0;24;1
2018-03-19 09:00:00;CONFLICTIVA;10;16;26;2
2018-03-19 09:30:00;SUR;0;34;34;1
2018-03-19 10:00:00;SUR;0;30;30;1
2018-03-19 10:30:00;SUR;0;28;28;1
2018-03-19 11:00:00;SUR;0;32;32;1
2018-03-19 11:30:00;SUR;0;26;26;1
2018-03-19 12:00:00;SUR;0;25;25;1
2018-03-19 12:30:00;SUR;0;27;27;1
2018-03-19 13:00:00;SUR;0;21;21;1
2018-03-19 13:30:00;SUR;0;28;28;1
2018-03-19 14:00:00;SUR;0;26;26;1
2018-03-19 14:30:00;CONFLICTIVA;10;11;21;2
2018-03-19 15:00:00;NORTE;32;0;32;1
2018-03-19 15:30:00;NORTE;33;0;33;1
2018-03-19 16:00:00;NORTE;22;0;22;1
2018-03-19 16:30:00;NORTE;19;0;19;1
2018-03-19 17:00:00;NORTE;21;0;21;1
2018-03-19 17:30:00;NORTE;34;0;34;1
2018-03-19 18:00:00;NORTE;25;0;25;1
2018-03-19 18:30:00;NORTE;22;0;22;1
2018-03-19 19:00:00;NORTE;35;0;35;1
2018-03-19 19:30:00;NORTE;32;0;32;1
2018-03-19 20:00:00;NORTE;23;0;23;1
2018-03-19 20:30:00;NORTE;23;0;23;1
2018-03-19 21:00:00;NORTE;29;0;29;1
2018-03-19 21:30:00;NORTE;21;0;21;1
2018-03-19 22:00:00;NORTE;11;0;11;1
2018-03-19 22:30:00;NORTE;10;0;10;1
2018-03-19 23:00:00;NORTE;12;0;12;1
2018-03-19 23:30:00;NORTE;3;0;3;1
2018-03-20 00:00:00;NORTE;2;0;2;1
2018-03-20 00:30:00;NORTE;1;0;1;1
2018-03-20 02:00:00;NORTE;1;0;1;1
2018-03-20 02:30:00;NORTE;1;0;1;1
2018-03-20 03:00:00;NORTE;1;0;1;1
2018-03-20 03:30:00;NORTE;2;0;2;1
2018-03-20 04:00:00;NORTE;7;0;7;1
2018-03-20 04:30:00;NORTE;3;0;3;1
2018-03-20 05:00:00;NORTE;11;0;11;1
2018-03-20 05:30:00;NORTE;15;0;15;1
2018-03-20 06:00:00;NORTE;15;0;15;1
2018-03-20 06:30:00;NORTE;36;0;36;1
2018-03-20 07:00:00;NORTE;18;0;18;1
2018-03-20 07:30:00;NORTE;17;0;17;1
2018-03-20 08:00:00;NORTE;37;0;37;1
2018-03-20 08:30:00;NORTE;22;0;22;1
2018-03-20 09:00:00;NORTE;36;0;36;1
2018-03-20 09:30:00;NORTE;27;0;27;1
2018-03-20 10:00:00;NORTE;21;0;21;1
2018-03-20 10:30:00;NORTE;31;0;31;1
2018-03-20 11:00:00;NORTE;35;0;35;1
2018-03-20 11:30:00;NORTE;24;0;24;1
2018-03-20 12:00:00;NORTE;26;0;26;1
2018-03-20 12:30:00;NORTE;22;0;22;1
2018-03-20 13:00:00;NORTE;29;0;29;1
2018-03-20 13:30:00;NORTE;30;0;30;1
2018-03-20 14:00:00;NORTE;25;0;25;1
2018-03-20 14:30:00;NORTE;28;0;28;1
2018-03-20 15:00:00;NORTE;36;0;36;1
2018-03-20 15:30:00;NORTE;18;0;18;1
2018-03-20 16:00:00;NORTE;17;0;17;1
2018-03-20 16:30:00;NORTE;20;0;20;1
2018-03-20 17:00:00;NORTE;23;0;23;1
2018-03-20 17:30:00;NORTE;31;0;31;1
2018-03-20 18:00:00;NORTE;27;0;27;1
2018-03-20 18:30:00;NORTE;25;0;25;1
2018-03-20 19:00:00;NORTE;35;0;35;1
2018-03-20 19:30:00;NORTE;22;0;22;1
2018-03-20 20:00:00;NORTE;22;0;22;1
2018-03-20 20:30:00;NORTE;32;0;32;1
2018-03-20 21:00:00;NORTE;24;0;24;1
2018-03-20 21:30:00;NORTE;19;0;19;1
2018-03-20 22:00:00;NORTE;10;0;10;1
2018-03-20 22:30:00;NORTE;6;0;6;1
2018-03-20 23:00:00;NORTE;10;0;10;1
2018-03-20 23:30:00;NORTE;2;0;2;1
2018-03-21 00:00:00;NORTE;2;0;2;1
2018-03-21 00:30:00;NORTE;2;0;2;1
2018-03-21 01:30:00;NORTE;1;0;1;1
2018-03-21 02:00:00;NORTE;2;0;2;1
2018-03-21 03:00:00;NORTE;2;0;2;1
2018-03-21 03:30:00;NORTE;3;0;3;1
2018-03-21 04:00:00;NORTE;5;0;5;1
2018-03-21 04:30:00;NORTE;5;0;5;1
2018-03-21 05:00:00;NORTE;13;0;13;1
2018-03-21 05:30:00;NORTE;13;0;13;1
2018-03-21 06:00:00;NORTE;20;0;20;1
2018-03-21 06:30:00;NORTE;38;0;38;1
2018-03-21 07:00:00;NORTE;17;0;17;1
2018-03-21 07:30:00;NORTE;18;0;18;1
2018-03-21 08:00:00;NORTE;34;0;34;1
2018-03-21 08:30:00;NORTE;25;0;25;1
2018-03-21 09:00:00;NORTE;37;0;37;1
2018-03-21 09:30:00;NORTE;33;0;33;1
2018-03-21 10:00:00;NORTE;21;0;21;1
2018-03-21 10:30:00;NORTE;29;0;29;1
2018-03-21 11:00:00;NORTE;26;0;26;1
2018-03-21 11:30:00;NORTE;26;0;26;1
2018-03-21 12:00:00;NORTE;20;0;20;1
2018-03-21 12:30:00;NORTE;17;0;17;1
2018-03-21 13:00:00;NORTE;27;0;27;1
2018-03-21 13:30:00;NORTE;26;0;26;1
2018-03-21 14:00:00;NORTE;31;0;31;1
2018-03-21 14:30:00;NORTE;30;0;30;1
2018-03-21 15:00:00;NORTE;33;0;33;1
2018-03-21 15:30:00;NORTE;34;0;34;1
2018-03-21 16:00:00;NORTE;20;0;20;1
2018-03-21 16:30:00;NORTE;20;0;20;1
2018-03-21 17:00:00;NORTE;20;0;20;1
2018-03-21 17:30:00;NORTE;31;0;31;1
2018-03-21 18:00:00;NORTE;27;0;27;1
2018-03-21 18:30:00;NORTE;25;0;25;1
2018-03-21 19:00:00;NORTE;33;0;33;1
2018-03-21 19:30:00;NORTE;32;0;32;1
2018-03-21 20:00:00;NORTE;20;0;20;1
2018-03-21 20:30:00;NORTE;30;0;30;1
2018-03-21 21:00:00;NORTE;32;0;32;1
2018-03-21 21:30:00;NORTE;16;0;16;1
2018-03-21 22:00:00;NORTE;14;0;14;1
2018-03-21 22:30:00;NORTE;8;0;8;1
2018-03-21 23:00:00;NORTE;11;0;11;1
2018-03-21 23:30:00;NORTE;2;0;2;1
2018-03-22 00:00:00;NORTE;2;0;2;1
2018-03-22 01:00:00;NORTE;2;0;2;1
2018-03-22 01:30:00;NORTE;1;0;1;1
2018-03-22 02:30:00;NORTE;1;0;1;1
2018-03-22 03:00:00;NORTE;2;0;2;1
2018-03-22 03:30:00;NORTE;3;0;3;1
2018-03-22 04:00:00;NORTE;4;0;4;1
2018-03-22 04:30:00;NORTE;5;0;5;1
2018-03-22 05:00:00;NORTE;5;0;5;1
2018-03-22 05:30:00;NORTE;10;0;10;1
2018-03-22 06:00:00;NORTE;20;0;20;1
2018-03-22 06:30:00;NORTE;31;0;31;1
2018-03-22 07:00:00;NORTE;21;0;21;1
2018-03-22 07:30:00;NORTE;14;0;14;1
2018-03-22 08:00:00;NORTE;24;0;24;1
2018-03-22 08:30:00;NORTE;26;0;26;1
2018-03-22 09:00:00;NORTE;30;0;30;1
2018-03-22 09:30:00;NORTE;20;0;20;1
2018-03-22 10:00:00;NORTE;20;0;20;1
2018-03-22 10:30:00;NORTE;32;0;32;1
2018-03-22 11:00:00;NORTE;34;0;34;1
2018-03-22 11:30:00;NORTE;25;0;25;1
2018-03-22 12:00:00;NORTE;21;0;21;1
2018-03-22 12:30:00;NORTE;23;0;23;1
2018-03-22 13:00:00;NORTE;25;0;25;1
2018-03-22 13:30:00;NORTE;26;0;26;1
2018-03-22 14:00:00;NORTE;23;0;23;1
2018-03-22 14:30:00;NORTE;20;0;20;1
2018-03-22 15:00:00;NORTE;39;0;39;1
2018-03-22 15:30:00;NORTE;24;0;24;1
2018-03-22 16:00:00;NORTE;20;0;20;1
2018-03-22 16:30:00;NORTE;19;0;19;1
2018-03-22 17:00:00;NORTE;18;0;18;1
2018-03-22 17:30:00;NORTE;23;0;23;1
2018-03-22 18:00:00;NORTE;29;0;29;1
2018-03-22 18:30:00;NORTE;16;0;16;1
2018-03-22 19:00:00;NORTE;30;0;30;1
2018-03-22 19:30:00;NORTE;32;0;32;1
2018-03-22 20:00:00;NORTE;23;0;23;1
2018-03-22 20:30:00;NORTE;30;0;30;1
2018-03-22 21:00:00;NORTE;36;0;36;1
2018-03-22 21:30:00;NORTE;24;0;24;1
2018-03-22 22:00:00;NORTE;10;0;10;1
2018-03-22 22:30:00;NORTE;12;0;12;1
2018-03-22 23:00:00;NORTE;15;0;15;1
2018-03-22 23:30:00;NORTE;8;0;8;1
2018-03-23 00:00:00;NORTE;4;0;4;1
2018-03-23 00:30:00;NORTE;2;0;2;1
2018-03-23 01:00:00;NORTE;2;0;2;1
2018-03-23 01:30:00;NORTE;2;0;2;1
2018-03-23 02:00:00;NORTE;3;0;3;1
2018-03-23 02:30:00;NORTE;2;0;2;1
2018-03-23 03:00:00;NORTE;2;0;2;1
2018-03-23 03:30:00;NORTE;3;0;3;1
2018-03-23 04:00:00;NORTE;4;0;4;1
2018-03-23 04:30:00;NORTE;8;0;8;1
2018-03-23 05:00:00;NORTE;9;0;9;1
2018-03-23 05:30:00;NORTE;13;0;13;1
2018-03-23 06:00:00;NORTE;19;0;19;1
2018-03-23 06:30:00;NORTE;36;0;36;1
2018-03-23 07:00:00;NORTE;14;0;14;1
2018-03-23 07:30:00;NORTE;18;0;18;1
2018-03-23 08:00:00;NORTE;35;0;35;1
2018-03-23 09:00:00;SUR;0;31;31;1
2018-03-23 09:30:00;SUR;0;30;30;1
2018-03-23 10:00:00;SUR;0;25;25;1
2018-03-23 10:30:00;SUR;0;27;27;1
2018-03-23 11:00:00;SUR;0;32;32;1
2018-03-23 11:30:00;SUR;0;24;24;1
2018-03-23 12:00:00;SUR;0;30;30;1
2018-03-23 12:30:00;SUR;0;19;19;1
2018-03-23 13:00:00;SUR;0;31;31;1
2018-03-23 13:30:00;SUR;0;32;32;1
2018-03-23 14:00:00;SUR;0;29;29;1
2018-03-23 14:30:00;SUR;0;24;24;1
2018-03-23 15:00:00;SUR;0;32;32;1
2018-03-23 15:30:00;SUR;0;26;26;1
2018-03-23 16:00:00;SUR;0;27;27;1
2018-03-23 16:30:00;SUR;0;23;23;1
2018-03-23 17:00:00;SUR;0;23;23;1
2018-03-23 17:30:00;SUR;0;33;33;1
2018-03-23 18:00:00;SUR;0;20;20;1
2018-03-23 18:30:00;SUR;0;26;26;1
2018-03-23 19:00:00;SUR;0;39;39;1
2018-03-23 19:30:00;SUR;0;33;33;1
2018-03-23 20:00:00;SUR;0;29;29;1
2018-03-23 20:30:00;SUR;0;7;7;1
2018-03-23 20:40:00;SUR;0;15;15;1
2018-03-23 21:00:00;SUR;0;28;28;1
2018-03-23 21:30:00;SUR;0;17;17;1
2018-03-23 22:00:00;SUR;0;16;16;1
2018-03-23 22:30:00;SUR;0;12;12;1
2018-03-23 23:00:00;SUR;0;13;13;1
2018-03-23 23:30:00;SUR;0;4;4;1
2018-03-24 00:00:00;SUR;0;1;1;1
2018-03-24 00:07:00;SUR;0;1;1;1
2018-03-24 00:30:00;NORTE;4;0;4;1
2018-03-24 01:00:00;NORTE;1;0;1;1
2018-03-24 02:30:00;NORTE;1;0;1;1
2018-03-24 03:00:00;NORTE;4;0;4;1
2018-03-24 03:30:00;NORTE;2;0;2;1
2018-03-24 04:00:00;NORTE;1;0;1;1
2018-03-24 04:30:00;NORTE;3;0;3;1
2018-03-24 05:00:00;NORTE;6;0;6;1
2018-03-24 05:30:00;NORTE;16;0;16;1
2018-03-24 06:00:00;NORTE;15;0;15;1
2018-03-24 06:30:00;NORTE;28;0;28;1
2018-03-24 07:00:00;NORTE;14;0;14;1
2018-03-24 07:30:00;NORTE;19;0;19;1
2018-03-24 08:00:00;NORTE;32;0;32;1
2018-03-24 08:30:00;NORTE;29;0;29;1
2018-03-24 09:00:00;NORTE;33;0;33;1
2018-03-24 09:30:00;NORTE;28;0;28;1
2018-03-24 10:00:00;NORTE;16;0;16;1
2018-03-24 10:30:00;NORTE;36;0;36;1
2018-03-24 11:00:00;NORTE;26;0;26;1
2018-03-24 11:30:00;NORTE;28;0;28;1
2018-03-24 12:00:00;NORTE;25;0;25;1
2018-03-24 12:30:00;NORTE;20;0;20;1
2018-03-24 13:00:00;NORTE;19;0;19;1
2018-03-24 13:30:00;NORTE;25;0;25;1
2018-03-24 14:00:00;NORTE;15;0;15;1
2018-03-24 22:00:00;NORTE;8;0;8;1
2018-03-24 22:30:00;NORTE;1;0;1;1
2018-03-24 23:00:30;NORTE;1;0;1;1
2018-03-24 23:01:21;NORTE;1;0;1;1
2018-03-24 23:04:01;NORTE;1;0;1;1
2018-03-24 23:07:06;NORTE;1;0;1;1
2018-03-24 23:10:22;NORTE;1;0;1;1
2018-03-24 23:13:35;NORTE;1;0;1;1
2018-03-24 23:16:52;NORTE;1;0;1;1
2018-03-24 23:20:11;NORTE;1;0;1;1
2018-03-24 23:22:59;NORTE;1;0;1;1
2018-03-24 23:25:31;NORTE;1;0;1;1
2018-03-24 23:28:23;NORTE;1;0;1;1
2018-03-24 23:29:38;NORTE;1;0;1;1
2018-03-24 23:30:00;NORTE;2;0;2;1
2018-03-25 00:00:00;NORTE;2;0;2;1
2018-03-25 01:00:00;NORTE;3;0;3;1
2018-03-25 01:30:00;NORTE;1;0;1;1
2018-03-25 03:00:00;NORTE;3;0;3;1
2018-03-25 03:30:00;NORTE;3;0;3;1
2018-03-25 04:00:00;NORTE;5;0;5;1
2018-03-25 04:30:00;NORTE;9;0;9;1
2018-03-25 05:00:00;NORTE;21;0;21;1
2018-03-25 05:30:00;NORTE;20;0;20;1
2018-03-25 06:00:00;NORTE;17;0;17;1
2018-03-25 06:30:00;NORTE;19;0;19;1
2018-03-25 07:00:00;NORTE;18;0;18;1
2018-03-25 13:00:00;NORTE;26;0;26;1
2018-03-25 18:00:00;NORTE;27;0;27;1
2018-03-25 18:30:00;NORTE;30;0;30;1
2018-03-25 19:00:00;NORTE;28;0;28;1
2018-03-25 19:30:00;NORTE;22;0;22;1
2018-03-25 20:00:00;NORTE;32;0;32;1
2018-03-25 20:30:00;NORTE;21;0;21;1
2018-03-25 21:00:00;NORTE;16;0;16;1
2018-03-25 21:30:00;NORTE;10;0;10;1
2018-03-25 22:00:00;NORTE;13;0;13;1
2018-03-25 22:30:00;NORTE;10;0;10;1
2018-03-25 23:00:00;NORTE;2;0;2;1
2018-03-25 23:30:00;NORTE;2;0;2;1
2018-03-26 00:00:00;NORTE;1;0;1;1
2018-03-26 00:30:00;NORTE;1;0;1;1
2018-03-26 01:00:00;NORTE;1;0;1;1
2018-03-26 02:00:00;NORTE;3;0;3;1
2018-03-26 02:30:00;NORTE;5;0;5;1
2018-03-26 03:00:00;NORTE;1;0;1;1
2018-03-26 03:30:00;NORTE;1;0;1;1
2018-03-26 04:00:00;NORTE;7;0;7;1
2018-03-26 04:30:00;NORTE;9;0;9;1
2018-03-26 05:00:00;NORTE;17;0;17;1
2018-03-26 05:30:00;NORTE;37;0;37;1
2018-03-26 06:00:00;NORTE;12;0;12;1
2018-03-26 06:30:00;NORTE;29;0;29;1
2018-03-26 07:00:00;NORTE;30;0;30;1
2018-03-26 07:30:17;NORTE;1;0;1;1
2018-03-26 07:31:34;NORTE;1;0;1;1
2018-03-26 07:32:38;NORTE;1;0;1;1
2018-03-26 07:34:05;NORTE;1;0;1;1
2018-03-26 07:36:33;NORTE;1;0;1;1
2018-03-26 07:37:52;NORTE;1;0;1;1
2018-03-26 07:39:35;NORTE;1;0;1;1
2018-03-26 07:40:44;NORTE;1;0;1;1
2018-03-26 07:41:18;NORTE;1;0;1;1
2018-03-26 07:43:03;NORTE;1;0;1;1
2018-03-26 07:43:58;NORTE;1;0;1;1
2018-03-26 07:44:55;NORTE;1;0;1;1
2018-03-26 07:45:34;NORTE;1;0;1;1
2018-03-26 07:46:14;NORTE;1;0;1;1
2018-03-26 07:46:19;NORTE;1;0;1;1
2018-03-26 07:47:22;NORTE;1;0;1;1
2018-03-26 07:47:30;NORTE;1;0;1;1
2018-03-26 07:49:50;NORTE;1;0;1;1
2018-03-26 07:51:37;NORTE;1;0;1;1
2018-03-26 07:52:19;NORTE;1;0;1;1
2018-03-26 07:52:48;NORTE;1;0;1;1
2018-03-26 07:54:28;NORTE;1;0;1;1
2018-03-26 07:55:24;NORTE;1;0;1;1
2018-03-26 07:56:55;NORTE;1;0;1;1
2018-03-26 07:57:57;NORTE;1;0;1;1
2018-03-26 07:59:34;NORTE;1;0;1;1
2018-03-26 07:59:50;NORTE;1;0;1;1
2018-03-26 08:00:57;NORTE;1;0;1;1
2018-03-26 08:02:05;NORTE;1;0;1;1
2018-03-26 08:02:53;NORTE;1;0;1;1
2018-03-26 08:04:19;NORTE;1;0;1;1
2018-03-26 08:08:11;NORTE;1;0;1;1
2018-03-26 08:08:15;NORTE;2;0;2;1
2018-03-26 08:09:28;NORTE;1;0;1;1
2018-03-26 08:10:08;NORTE;1;0;1;1
2018-03-26 08:11:34;NORTE;1;0;1;1
2018-03-26 08:11:41;NORTE;1;0;1;1
2018-03-26 08:12:48;NORTE;1;0;1;1
2018-03-26 08:13:02;NORTE;1;0;1;1
2018-03-26 08:14:23;NORTE;1;0;1;1
2018-03-26 08:15:03;NORTE;1;0;1;1
2018-03-26 08:15:21;NORTE;1;0;1;1
2018-03-26 08:16:15;NORTE;1;0;1;1
2018-03-26 08:16:50;NORTE;1;0;1;1
2018-03-26 08:17:53;NORTE;1;0;1;1
2018-03-26 08:18:42;NORTE;1;0;1;1
2018-03-26 08:19:26;NORTE;1;0;1;1
2018-03-26 08:19:30;NORTE;1;0;1;1
2018-03-26 08:21:23;NORTE;1;0;1;1
2018-03-26 08:21:29;NORTE;1;0;1;1
2018-03-26 08:24:33;NORTE;1;0;1;1
2018-03-26 08:25:26;NORTE;1;0;1;1
2018-03-26 08:26:37;NORTE;1;0;1;1
2018-03-26 08:27:03;NORTE;1;0;1;1
2018-03-26 08:28:02;NORTE;1;0;1;1
2018-03-26 08:28:21;NORTE;1;0;1;1
2018-03-26 08:29:32;NORTE;1;0;1;1
2018-03-26 08:29:33;NORTE;1;0;1;1
2018-03-26 08:31:00;NORTE;1;0;1;1
2018-03-26 08:32:16;NORTE;1;0;1;1
2018-03-26 08:32:17;NORTE;1;0;1;1
2018-03-26 08:34:08;NORTE;1;0;1;1
2018-03-26 08:35:09;NORTE;1;0;1;1
2018-03-26 08:35:32;NORTE;1;0;1;1
2018-03-26 08:36:17;NORTE;1;0;1;1
2018-03-26 08:36:47;NORTE;1;0;1;1
2018-03-26 08:36:52;NORTE;1;0;1;1
2018-03-26 08:38:07;NORTE;1;0;1;1
2018-03-26 08:39:05;NORTE;1;0;1;1
2018-03-26 08:39:25;NORTE;1;0;1;1
2018-03-26 08:39:56;NORTE;1;0;1;1
2018-03-26 08:40:06;NORTE;1;0;1;1
2018-03-26 08:41:10;NORTE;1;0;1;1
2018-03-26 08:41:52;NORTE;1;0;1;1
2018-03-26 08:42:44;NORTE;1;0;1;1
2018-03-26 08:43:07;NORTE;1;0;1;1
2018-03-26 08:43:23;NORTE;1;0;1;1
2018-03-26 08:43:33;NORTE;1;0;1;1
2018-03-26 08:44:29;NORTE;1;0;1;1
2018-03-26 08:44:33;NORTE;1;0;1;1
2018-03-26 08:45:09;NORTE;1;0;1;1
2018-03-26 08:45:51;NORTE;1;0;1;1
2018-03-26 08:46:45;NORTE;1;0;1;1
2018-03-26 08:47:17;NORTE;1;0;1;1
2018-03-26 08:48:59;NORTE;1;0;1;1
2018-03-26 08:49:55;NORTE;1;0;1;1
2018-03-26 08:50:12;NORTE;1;0;1;1
2018-03-26 08:51:07;NORTE;1;0;1;1
2018-03-26 08:52:14;NORTE;1;0;1;1
2018-03-26 08:53:33;NORTE;1;0;1;1
2018-03-26 08:54:20;NORTE;1;0;1;1
2018-03-26 08:54:34;NORTE;1;0;1;1
2018-03-26 08:55:48;NORTE;1;0;1;1
2018-03-26 08:56:24;NORTE;1;0;1;1
2018-03-26 08:56:40;NORTE;1;0;1;1
2018-03-26 08:58:04;NORTE;1;0;1;1
2018-03-26 08:59:01;NORTE;1;0;1;1
2018-03-26 08:59:53;NORTE;1;0;1;1
2018-03-26 09:01:21;NORTE;1;0;1;1
2018-03-26 09:07:59;NORTE;1;0;1;1
2018-03-26 09:10:39;NORTE;1;0;1;1
2018-03-26 09:11:15;NORTE;1;0;1;1
2018-03-26 09:14:23;NORTE;1;0;1;1
2018-03-26 09:15:09;NORTE;1;0;1;1
2018-03-26 09:17:07;NORTE;1;0;1;1
2018-03-26 09:17:32;NORTE;1;0;1;1
2018-03-26 09:19:55;NORTE;1;0;1;1
2018-03-26 09:21:34;NORTE;1;0;1;1
2018-03-26 09:22:35;NORTE;1;0;1;1
2018-03-26 09:25:18;NORTE;1;0;1;1
2018-03-26 09:25:30;NORTE;1;0;1;1
2018-03-26 09:26:18;NORTE;1;0;1;1
2018-03-26 09:29:06;NORTE;1;0;1;1
2018-03-26 09:30:00;NORTE;26;0;26;1
2018-03-26 10:00:00;NORTE;40;0;40;1
2018-03-26 10:30:00;NORTE;23;0;23;1
2018-03-26 11:00:00;NORTE;28;0;28;1
2018-03-26 11:30:00;NORTE;24;0;24;1
2018-03-26 12:00:00;NORTE;28;0;28;1
2018-03-26 12:30:00;NORTE;25;0;25;1
2018-03-26 13:00:00;NORTE;27;0;27;1
2018-03-26 13:30:00;NORTE;27;0;27;1
2018-03-26 14:00:00;NORTE;39;0;39;1
2018-03-26 14:30:00;NORTE;23;0;23;1
2018-03-26 15:00:00;NORTE;23;0;23;1
2018-03-26 15:30:00;NORTE;25;0;25;1
2018-03-26 16:00:00;NORTE;22;0;22;1
2018-03-26 16:30:00;NORTE;26;0;26;1
2018-03-26 17:00:00;NORTE;20;0;20;1
2018-03-26 17:30:00;NORTE;26;0;26;1
2018-03-26 18:00:00;NORTE;36;0;36;1
2018-03-26 18:30:00;NORTE;27;0;27;1
2018-03-26 19:00:00;NORTE;34;0;34;1
2018-03-26 19:30:00;NORTE;24;0;24;1
2018-03-26 20:00:00;NORTE;25;0;25;1
2018-03-26 20:30:00;NORTE;19;0;19;1
2018-03-26 21:00:00;NORTE;13;0;13;1
2018-03-26 21:30:00;NORTE;11;0;11;1
2018-03-26 22:00:00;NORTE;12;0;12;1
2018-03-26 22:30:00;NORTE;1;0;1;1
2018-03-26 23:30:00;NORTE;1;0;1;1
2018-03-27 01:00:00;NORTE;1;0;1;1
2018-03-27 01:30:00;NORTE;1;0;1;1
2018-03-27 02:00:00;NORTE;1;0;1;1
2018-03-27 02:30:00;NORTE;7;0;7;1
2018-03-27 03:00:00;NORTE;4;0;4;1
2018-03-27 03:30:00;NORTE;5;0;5;1
2018-03-27 04:00:00;NORTE;11;0;11;1
2018-03-27 04:30:00;NORTE;10;0;10;1
2018-03-27 05:00:00;NORTE;18;0;18;1
2018-03-27 05:30:00;NORTE;34;0;34;1
2018-03-27 06:00:00;NORTE;17;0;17;1
2018-03-27 06:30:00;NORTE;16;0;16;1
2018-03-27 07:00:00;NORTE;29;0;29;1
2018-03-27 07:30:00;NORTE;28;0;28;1
2018-03-27 08:00:00;NORTE;31;0;31;1
2018-03-27 08:30:00;NORTE;32;0;32;1
2018-03-27 09:00:00;CONFLICTIVA;5;14;19;2
2018-03-27 09:30:00;SUR;0;24;24;1
2018-03-27 10:00:00;SUR;0;35;35;1
2018-03-27 10:30:00;SUR;0;35;35;1
2018-03-27 11:00:00;SUR;0;26;26;1
2018-03-27 11:30:00;SUR;0;24;24;1
2018-03-27 12:00:00;SUR;0;30;30;1
2018-03-27 12:30:00;SUR;0;30;30;1
2018-03-27 13:00:00;SUR;0;32;32;1
2018-03-27 13:30:00;SUR;0;24;24;1
2018-03-27 14:00:00;SUR;0;30;30;1
2018-03-27 14:30:00;SUR;0;33;33;1
2018-03-27 15:00:00;SUR;1;11;12;1
2018-03-27 15:30:00;NORTE;16;0;16;1
2018-03-27 16:00:00;NORTE;17;0;17;1
2018-03-27 16:30:00;NORTE;29;0;29;1
2018-03-27 17:00:00;NORTE;23;0;23;1
2018-03-27 17:30:00;NORTE;28;0;28;1
2018-03-27 18:00:00;NORTE;37;0;37;1
2018-03-27 18:30:00;NORTE;32;0;32;1
2018-03-27 19:00:00;NORTE;30;0;30;1
2018-03-27 19:30:00;NORTE;25;0;25;1
2018-03-27 20:00:00;NORTE;29;0;29;1
2018-03-27 20:30:00;NORTE;15;0;15;1
2018-03-27 21:00:00;NORTE;16;0;16;1
2018-03-27 21:30:00;NORTE;15;0;15;1
2018-03-27 22:00:00;NORTE;7;0;7;1
2018-03-27 22:30:00;NORTE;7;0;7;1
2018-03-27 23:00:00;NORTE;5;0;5;1
2018-03-27 23:30:00;NORTE;1;0;1;1
2018-03-28 00:00:00;NORTE;1;0;1;1
2018-03-28 00:30:00;CONFLICTIVA;1;1;2;2
2018-03-28 01:30:00;NORTE;1;0;1;1
2018-03-28 02:00:00;NORTE;5;0;5;1
2018-03-28 02:30:00;NORTE;2;0;2;1
2018-03-28 03:00:00;NORTE;3;0;3;1
2018-03-28 03:30:00;NORTE;4;0;4;1
2018-03-28 04:00:00;NORTE;8;0;8;1
2018-03-28 04:30:00;NORTE;12;0;12;1
2018-03-28 05:00:00;NORTE;8;0;8;1
2018-03-28 05:30:00;NORTE;37;0;37;1
2018-03-28 06:00:00;NORTE;18;0;18;1
2018-03-28 06:30:00;NORTE;21;0;21;1
2018-03-28 07:00:00;NORTE;36;0;36;1
2018-03-28 07:30:00;NORTE;25;0;25;1
2018-03-28 08:00:00;NORTE;38;0;38;1
2018-03-28 08:30:00;NORTE;31;0;31;1
2018-03-28 09:00:00;CONFLICTIVA;15;2;17;2
2018-03-28 09:30:00;SUR;0;35;35;1
2018-03-28 10:00:00;SUR;0;39;39;1
2018-03-28 10:30:00;SUR;0;28;28;1
2018-03-28 11:00:00;SUR;0;23;23;1
2018-03-28 11:30:00;SUR;0;24;24;1
2018-03-28 12:00:00;SUR;0;22;22;1
2018-03-28 12:30:00;SUR;0;30;30;1
2018-03-28 13:00:00;SUR;0;30;30;1
2018-03-28 13:30:00;SUR;0;24;24;1
2018-03-28 14:00:00;SUR;0;36;36;1
2018-03-28 14:30:00;SUR;0;34;34;1
2018-03-28 15:00:00;SUR;0;28;28;1
2018-03-28 15:30:00;SUR;0;19;19;1
2018-03-28 16:00:00;SUR;0;18;18;1
2018-03-28 16:30:00;SUR;0;30;30;1
2018-03-28 17:00:00;SUR;0;24;24;1
2018-03-28 17:30:00;SUR;0;25;25;1
2018-03-28 18:00:00;SUR;0;36;36;1
2018-03-28 18:30:00;SUR;0;33;33;1
2018-03-28 19:00:00;SUR;0;25;25;1
2018-03-28 19:30:00;CONFLICTIVA;3;17;20;2
2018-03-28 20:00:00;NORTE;32;0;32;1
2018-03-28 20:30:00;NORTE;31;0;31;1
2018-03-28 21:00:00;NORTE;13;0;13;1
2018-03-28 21:30:00;NORTE;14;0;14;1
2018-03-28 22:00:00;NORTE;16;0;16;1
2018-03-28 22:30:00;NORTE;3;0;3;1
2018-03-28 23:00:00;NORTE;4;0;4;1
2018-03-28 23:30:00;NORTE;1;0;1;1
2018-03-29 00:30:00;NORTE;2;0;2;1
2018-03-29 01:30:00;NORTE;1;0;1;1
2018-03-29 02:00:00;NORTE;3;0;3;1
2018-03-29 02:30:00;NORTE;4;0;4;1
2018-03-29 03:00:00;NORTE;1;0;1;1
2018-03-29 03:30:00;NORTE;4;0;4;1
2018-03-29 04:00:00;NORTE;11;0;11;1
2018-03-29 04:30:00;NORTE;12;0;12;1
2018-03-29 05:00:00;NORTE;14;0;14;1
2018-03-29 05:30:00;NORTE;32;0;32;1
2018-03-29 06:00:00;NORTE;18;0;18;1
2018-03-29 06:30:00;NORTE;19;0;19;1
2018-03-29 07:00:00;NORTE;31;0;31;1
2018-03-29 07:30:00;NORTE;26;0;26;1
2018-03-29 08:00:00;NORTE;35;0;35;1
2018-03-29 08:30:00;NORTE;37;0;37;1
2018-03-29 09:00:00;NORTE;22;0;22;1
2018-03-29 09:30:00;NORTE;29;0;29;1
2018-03-29 10:00:00;NORTE;39;0;39;1
2018-03-29 10:30:00;NORTE;23;1;24;1
2018-03-29 11:00:00;SUR;0;18;18;1
2018-03-29 11:30:00;SUR;0;23;23;1
2018-03-29 12:00:00;SUR;0;27;27;1
2018-03-29 12:30:00;SUR;0;31;31;1
2018-03-29 13:00:00;SUR;0;37;37;1
2018-03-29 13:30:00;SUR;0;22;22;1
2018-03-29 14:00:00;SUR;0;36;36;1
2018-03-29 14:30:00;SUR;0;35;35;1
2018-03-29 15:00:00;SUR;0;18;18;1
2018-03-29 15:30:00;SUR;0;18;18;1
2018-03-29 16:00:00;SUR;0;17;17;1
2018-03-29 16:30:00;SUR;0;26;26;1
2018-03-29 17:00:00;SUR;0;19;19;1
2018-03-29 17:30:00;SUR;0;25;25;1
2018-03-29 18:00:00;SUR;0;33;33;1
2018-03-29 18:30:00;SUR;0;31;31;1
2018-03-29 19:00:00;SUR;0;31;31;1
2018-03-29 19:30:00;SUR;0;24;24;1
2018-03-29 20:00:00;SUR;0;18;18;1
2018-03-29 20:30:00;SUR;0;23;23;1
2018-03-29 21:00:00;SUR;0;16;16;1
2018-03-29 21:30:00;SUR;0;12;12;1
2018-03-29 22:00:00;SUR;0;14;14;1
2018-03-29 22:30:00;SUR;0;6;6;1
2018-03-29 23:00:00;SUR;0;3;3;1
2018-03-29 23:30:00;SUR;0;1;1;1
2018-03-30 00:30:00;SUR;0;2;2;1
2018-03-30 01:00:00;SUR;0;1;1;1
2018-03-30 01:30:00;SUR;0;2;2;1
2018-03-30 02:30:00;SUR;0;4;4;1
2018-03-30 03:00:00;SUR;0;2;2;1
2018-03-30 03:30:00;SUR;0;6;6;1
2018-03-30 04:00:00;SUR;0;7;7;1
2018-03-30 04:30:00;SUR;0;10;10;1
2018-03-30 05:00:00;NORTE;12;0;12;1
2018-03-30 05:30:00;NORTE;36;0;36;1
2018-03-30 06:00:00;NORTE;20;0;20;1
2018-03-30 06:30:00;NORTE;25;0;25;1
2018-03-30 07:00:00;NORTE;33;0;33;1
2018-03-30 07:30:00;NORTE;26;0;26;1
2018-03-30 08:00:00;NORTE;36;0;36;1
2018-03-30 08:30:00;NORTE;37;0;37;1
2018-03-30 09:00:00;NORTE;28;0;28;1
2018-03-30 09:30:00;NORTE;30;0;30;1
2018-03-30 10:00:00;NORTE;33;0;33;1
2018-03-30 10:30:00;NORTE;29;0;29;1
2018-03-30 11:00:00;NORTE;28;0;28;1
2018-03-30 11:30:00;NORTE;37;0;37;1
2018-03-30 12:00:00;CONFLICTIVA;9;8;17;2
2018-03-30 12:30:00;SUR;0;29;29;1
2018-03-30 13:00:00;SUR;0;37;37;1
2018-03-30 13:30:00;SUR;0;34;34;1
2018-03-30 14:00:00;SUR;0;33;33;1
2018-03-30 14:30:00;SUR;0;30;30;1
2018-03-30 15:00:00;SUR;0;22;22;1
2018-03-30 15:30:00;CONFLICTIVA;4;8;12;2
2018-03-30 16:00:00;CONFLICTIVA;11;6;17;2
2018-03-30 16:30:00;SUR;0;31;31;1
2018-03-30 17:00:00;SUR;0;19;19;1
2018-03-30 17:30:00;SUR;0;35;35;1
2018-03-30 18:00:00;SUR;0;29;29;1
2018-03-30 18:30:00;SUR;0;30;30;1
2018-03-30 19:00:00;SUR;0;23;23;1
2018-03-30 19:30:00;SUR;0;21;21;1
2018-03-30 20:00:00;SUR;0;25;25;1
2018-03-30 20:30:00;SUR;0;14;14;1
2018-03-30 21:00:00;SUR;0;10;10;1
2018-03-30 21:30:00;SUR;0;15;15;1
2018-03-30 22:00:00;SUR;0;7;7;1
2018-03-30 22:30:00;SUR;0;4;4;1
2018-03-30 23:00:00;SUR;0;3;3;1
2018-03-31 00:00:00;SUR;0;1;1;1
2018-03-31 01:00:00;SUR;0;1;1;1
2018-03-31 01:30:00;SUR;0;1;1;1
2018-03-31 02:00:00;SUR;0;3;3;1
2018-03-31 02:30:00;SUR;0;4;4;1
2018-03-31 03:00:00;SUR;0;1;1;1
2018-03-31 03:30:00;SUR;0;2;2;1
2018-03-31 04:00:00;SUR;0;9;9;1
2018-03-31 04:30:00;SUR;0;9;9;1
2018-03-31 05:00:00;SUR;0;13;13;1
2018-03-31 05:30:00;SUR;0;25;25;1
2018-03-31 06:00:00;CONFLICTIVA;5;13;18;2
2018-03-31 06:30:00;NORTE;25;0;25;1
2018-03-31 07:00:00;NORTE;34;0;34;1
2018-03-31 07:30:00;NORTE;29;0;29;1
2018-03-31 08:00:00;NORTE;33;0;33;1
2018-03-31 08:30:00;NORTE;26;0;26;1
2018-03-31 09:00:00;NORTE;19;0;19;1
2018-03-31 09:30:00;NORTE;30;0;30;1
2018-03-31 10:00:00;NORTE;32;0;32;1
2018-03-31 10:30:00;NORTE;20;0;20;1
2018-03-31 11:00:00;NORTE;26;0;26;1
2018-03-31 11:30:00;NORTE;25;0;25;1
2018-03-31 12:00:00;NORTE;21;0;21;1
2018-03-31 12:30:00;NORTE;25;0;25;1
2018-03-31 13:00:00;NORTE;36;0;36;1
2018-03-31 13:30:00;NORTE;21;0;21;1
2018-03-31 14:00:00;NORTE;33;0;33;1
2018-03-31 14:30:00;NORTE;31;0;31;1
2018-03-31 15:00:00;NORTE;19;0;19;1
2018-03-31 15:30:00;NORTE;15;0;15;1
2018-03-31 16:00:00;NORTE;21;0;21;1
2018-03-31 16:30:00;NORTE;26;0;26;1
2018-03-31 17:00:00;NORTE;18;0;18;1
2018-03-31 17:30:00;NORTE;19;0;19;1
2018-03-31 18:00:00;NORTE;33;0;33;1
2018-03-31 18:30:00;NORTE;26;0;26;1
2018-03-31 19:00:00;NORTE;19;0;19;1
2018-03-31 19:30:00;NORTE;20;0;20;1
2018-03-31 20:00:00;NORTE;20;0;20;1
2018-03-31 20:30:00;NORTE;10;0;10;1
2018-03-31 21:00:00;NORTE;12;0;12;1
2018-03-31 21:30:00;NORTE;12;0;12;1
2018-03-31 22:00:00;NORTE;15;0;15;1
2018-03-31 22:30:00;NORTE;4;0;4;1
2018-03-31 23:00:00;NORTE;3;0;3;1
2018-04-01 00:30:00;NORTE;2;0;2;1
2018-04-01 01:00:00;NORTE;2;0;2;1
2018-04-01 01:30:00;NORTE;1;0;1;1
2018-04-01 02:00:00;NORTE;1;0;1;1
2018-04-01 02:30:00;NORTE;3;0;3;1
2018-04-01 03:30:00;NORTE;4;0;4;1
2018-04-01 04:00:00;NORTE;6;0;6;1
2018-04-01 04:30:00;NORTE;9;0;9;1
2018-04-01 05:00:00;NORTE;13;0;13;1
2018-04-01 05:30:00;NORTE;28;0;28;1
2018-04-01 06:00:00;NORTE;14;0;14;1
2018-04-01 06:30:00;NORTE;19;0;19;1
2018-04-01 07:00:00;NORTE;27;0;27;1
2018-04-01 07:30:00;NORTE;30;0;30;1
2018-04-01 08:00:00;NORTE;31;0;31;1
2018-04-01 08:30:00;NORTE;31;0;31;1
2018-04-01 09:00:00;NORTE;13;0;13;1
2018-04-01 09:30:00;NORTE;33;0;33;1
2018-04-01 10:00:00;NORTE;38;0;38;1
2018-04-01 10:30:00;NORTE;31;0;31;1
2018-04-01 11:00:00;NORTE;28;0;28;1
2018-04-01 11:30:00;NORTE;32;0;32;1
2018-04-01 12:00:00;NORTE;27;0;27;1
2018-04-01 12:30:00;NORTE;26;0;26;1
2018-04-01 13:00:00;NORTE;33;0;33;1
2018-04-01 13:30:00;NORTE;33;0;33;1
2018-04-01 14:00:00;NORTE;39;0;39;1
2018-04-01 14:30:00;NORTE;36;0;36;1
2018-04-01 15:00:00;NORTE;25;0;25;1
2018-04-01 15:30:00;NORTE;18;0;18;1
2018-04-01 16:00:00;NORTE;18;0;18;1
2018-04-01 16:30:00;NORTE;23;0;23;1
2018-04-01 17:00:00;NORTE;25;0;25;1
2018-04-01 17:30:00;NORTE;31;0;31;1
2018-04-01 18:00:00;NORTE;34;0;34;1
2018-04-01 18:30:00;NORTE;39;0;39;1
2018-04-01 19:00:00;NORTE;23;0;23;1
2018-04-01 19:30:00;NORTE;28;0;28;1
2018-04-01 20:00:00;NORTE;30;0;30;1
2018-04-01 20:30:00;NORTE;28;0;28;1
2018-04-01 21:00:00;NORTE;11;0;11;1
2018-04-01 21:30:00;NORTE;19;0;19;1
2018-04-01 22:00:00;NORTE;12;0;12;1
2018-04-01 22:30:00;NORTE;14;0;14;1
2018-04-01 23:00:00;NORTE;2;0;2;1
2018-04-01 23:30:00;NORTE;2;0;2;1
2018-04-02 00:00:00;NORTE;3;0;3;1
2018-04-02 00:30:00;NORTE;1;0;1;1
2018-04-02 01:00:00;NORTE;2;0;2;1
2018-04-02 01:30:00;NORTE;2;0;2;1
2018-04-02 02:00:00;NORTE;3;0;3;1
2018-04-02 02:30:00;NORTE;3;0;3;1
2018-04-02 03:00:00;NORTE;1;0;1;1
2018-04-02 03:30:00;NORTE;4;0;4;1
2018-04-02 04:00:00;NORTE;8;0;8;1
2018-04-02 04:30:00;NORTE;11;0;11;1
2018-04-02 05:00:00;NORTE;21;0;21;1
2018-04-02 05:30:00;NORTE;36;0;36;1
2018-04-02 06:00:00;NORTE;18;0;18;1
2018-04-02 06:30:00;NORTE;24;0;24;1
2018-04-02 07:00:00;NORTE;29;0;29;1
2018-04-02 07:30:00;NORTE;21;0;21;1
2018-04-02 08:00:00;NORTE;36;0;36;1
2018-04-02 08:30:00;NORTE;38;0;38;1
2018-04-02 09:00:00;NORTE;21;0;21;1
2018-04-02 09:30:00;SUR;2;26;28;1
2018-04-02 10:00:00;SUR;0;38;38;1
2018-04-02 10:30:00;SUR;0;23;23;1
2018-04-02 11:00:00;SUR;0;22;22;1
2018-04-02 11:30:00;SUR;0;26;26;1
2018-04-02 12:00:00;SUR;0;19;19;1
2018-04-02 12:30:00;SUR;0;33;33;1
2018-04-02 13:00:00;SUR;0;33;33;1
2018-04-02 13:30:00;SUR;0;31;31;1
2018-04-02 14:00:00;SUR;0;39;39;1
2018-04-02 14:30:00;SUR;0;29;29;1
2018-04-02 15:00:00;SUR;0;23;23;1
2018-04-02 15:30:00;SUR;0;18;18;1
2018-04-02 16:00:00;SUR;0;15;15;1
2018-04-02 16:30:00;SUR;0;34;34;1
2018-04-02 17:00:00;SUR;0;21;21;1
2018-04-02 17:30:00;SUR;0;29;29;1
2018-04-02 18:00:00;SUR;0;33;33;1
2018-04-02 18:30:00;SUR;0;34;34;1
2018-04-02 19:00:00;SUR;0;24;24;1
2018-04-02 19:30:00;SUR;0;22;22;1
2018-04-02 20:00:00;SUR;0;28;28;1
2018-04-02 20:30:00;SUR;0;22;22;1
2018-04-02 21:00:00;SUR;0;18;18;1
2018-04-02 21:30:00;SUR;0;11;11;1
2018-04-02 22:00:00;SUR;0;18;18;1
2018-04-02 22:30:00;NORTE;2;0;2;1
2018-04-02 23:00:00;NORTE;2;0;2;1
2018-04-02 23:30:00;SUR;0;2;2;1
2018-04-03 00:00:00;SUR;0;1;1;1
2018-04-03 00:30:00;NORTE;1;0;1;1
2018-04-03 01:00:00;NORTE;1;0;1;1
2018-04-03 01:30:00;NORTE;1;0;1;1
2018-04-03 02:00:00;NORTE;1;0;1;1
2018-04-03 02:30:00;NORTE;5;0;5;1
2018-04-03 03:00:00;NORTE;2;0;2;1
2018-04-03 03:30:00;NORTE;8;0;8;1
2018-04-03 04:00:00;NORTE;10;0;10;1
2018-04-03 04:30:00;CONFLICTIVA;2;11;13;2
2018-04-03 05:00:00;SUR;0;19;19;1
2018-04-03 05:30:00;SUR;0;30;30;1
2018-04-03 06:00:00;SUR;0;23;23;1
2018-04-03 06:30:00;SUR;0;18;18;1
2018-04-03 07:00:00;SUR;0;29;29;1
2018-04-03 07:30:00;SUR;0;28;28;1
2018-04-03 08:00:00;SUR;0;31;31;1
2018-04-03 08:30:00;SUR;0;31;31;1
2018-04-03 09:00:00;SUR;0;25;25;1
2018-04-03 09:30:00;SUR;0;26;26;1
2018-04-03 10:00:00;SUR;0;38;38;1
2018-04-03 10:30:00;SUR;0;33;33;1
2018-04-03 11:00:00;SUR;0;28;28;1
2018-04-03 11:30:00;SUR;0;23;23;1
2018-04-03 12:00:00;SUR;0;23;23;1
2018-04-03 12:30:00;SUR;0;31;31;1
2018-04-03 13:00:00;SUR;0;26;26;1
2018-04-03 13:30:00;SUR;0;28;28;1
2018-04-03 14:00:00;SUR;0;28;28;1
2018-04-03 14:30:00;SUR;0;18;18;1
2018-04-03 15:00:00;SUR;0;27;27;1
2018-04-03 15:30:00;SUR;0;16;16;1
2018-04-03 16:00:00;SUR;0;18;18;1
2018-04-03 16:30:00;SUR;0;22;22;1
2018-04-03 17:00:00;SUR;0;31;31;1
2018-04-03 17:30:00;SUR;0;23;23;1
2018-04-03 18:00:00;SUR;0;43;43;1
2018-04-03 18:30:00;SUR;0;19;19;1
2018-04-03 19:00:00;SUR;0;34;34;1
2018-04-03 19:30:00;SUR;0;25;25;1
2018-04-03 20:00:00;SUR;0;30;30;1
2018-04-03 20:30:00;SUR;0;32;32;1
2018-04-03 21:00:00;SUR;0;16;16;1
2018-04-03 21:30:00;SUR;0;18;18;1
2018-04-03 22:00:00;SUR;0;16;16;1
2018-04-03 22:30:00;SUR;0;9;9;1
2018-04-03 23:00:00;SUR;0;4;4;1
2018-04-03 23:30:00;SUR;0;1;1;1
2018-04-04 00:00:00;SUR;0;1;1;1
2018-04-04 01:00:00;SUR;0;1;1;1
2018-04-04 01:30:00;SUR;0;2;2;1
2018-04-04 02:00:00;SUR;0;2;2;1
2018-04-04 02:30:00;SUR;0;5;5;1
2018-04-04 03:00:00;SUR;0;1;1;1
2018-04-04 03:30:00;SUR;0;6;6;1
2018-04-04 04:00:00;SUR;0;10;10;1
2018-04-04 04:30:00;SUR;0;11;11;1
2018-04-04 05:00:00;SUR;0;18;18;1
2018-04-04 05:30:00;SUR;0;36;36;1
2018-04-04 06:00:00;SUR;0;20;20;1
2018-04-04 06:30:00;SUR;0;19;19;1
2018-04-04 07:00:00;SUR;0;33;33;1
2018-04-04 07:30:00;SUR;0;27;27;1
2018-04-04 08:00:00;SUR;0;28;28;1
2018-04-04 08:30:00;SUR;0;36;36;1
2018-04-04 09:00:00;SUR;0;27;27;1
2018-04-04 09:30:00;SUR;0;32;32;1
2018-04-04 10:00:00;SUR;0;32;32;1
2018-04-04 10:30:00;SUR;0;26;26;1
2018-04-04 11:00:00;SUR;0;24;24;1
2018-04-04 11:30:00;SUR;0;25;25;1
2018-04-04 12:00:00;SUR;0;28;28;1
2018-04-04 12:30:00;SUR;0;27;27;1
2018-04-04 13:00:00;SUR;0;24;24;1
2018-04-04 13:30:00;SUR;0;35;35;1
2018-04-04 14:00:00;SUR;0;31;31;1
2018-04-04 14:30:00;SUR;0;32;32;1
2018-04-04 15:00:00;SUR;0;22;22;1
2018-04-04 15:30:00;SUR;0;20;20;1
2018-04-04 16:00:00;SUR;0;18;18;1
2018-04-04 16:30:00;SUR;0;31;31;1
2018-04-04 17:00:00;SUR;0;23;23;1
2018-04-04 17:30:00;SUR;0;29;29;1
2018-04-04 18:00:00;SUR;0;37;37;1
2018-04-04 18:30:00;SUR;0;33;33;1
2018-04-04 19:00:00;SUR;0;25;25;1
2018-04-04 19:30:00;SUR;0;30;30;1
2018-04-04 20:00:00;SUR;0;32;32;1
2018-04-04 20:30:00;SUR;0;21;21;1
2018-04-04 21:00:00;SUR;0;15;15;1
2018-04-04 21:30:00;SUR;0;9;9;1
2018-04-04 22:00:00;SUR;0;13;13;1
2018-04-04 22:30:00;SUR;0;6;6;1
2018-04-04 23:00:00;SUR;0;1;1;1
2018-04-04 23:30:00;SUR;0;1;1;1
2018-04-05 00:00:00;SUR;0;1;1;1
2018-04-05 01:00:00;SUR;0;1;1;1
2018-04-05 01:30:00;SUR;0;1;1;1
2018-04-05 02:00:00;SUR;0;2;2;1
2018-04-05 02:30:00;SUR;0;4;4;1
2018-04-05 03:00:00;NORTE;2;0;2;1
2018-04-05 03:30:00;NORTE;4;0;4;1
2018-04-05 04:00:00;NORTE;11;0;11;1
2018-04-05 04:30:00;NORTE;13;0;13;1
2018-04-05 05:00:00;NORTE;18;0;18;1
2018-04-05 05:30:00;NORTE;32;0;32;1
2018-04-05 06:00:00;NORTE;22;0;22;1
2018-04-05 06:30:00;NORTE;22;0;22;1
2018-04-05 07:00:00;NORTE;26;0;26;1
2018-04-05 07:30:00;NORTE;27;0;27;1
2018-04-05 08:00:00;NORTE;33;0;33;1
2018-04-05 08:30:00;NORTE;29;0;29;1
2018-04-05 09:00:00;NORTE;25;0;25;1
2018-04-05 09:30:00;NORTE;33;0;33;1
2018-04-05 10:00:00;NORTE;37;0;37;1
2018-04-05 10:30:00;NORTE;31;0;31;1
2018-04-05 11:00:00;NORTE;25;0;25;1
2018-04-05 11:30:00;NORTE;24;0;24;1
2018-04-05 12:00:00;NORTE;18;0;18;1
2018-04-05 12:30:00;NORTE;28;0;28;1
2018-04-05 13:00:00;NORTE;24;0;24;1
2018-04-05 13:30:00;NORTE;35;1;36;1
2018-04-05 14:00:00;NORTE;31;0;31;1
2018-04-05 14:30:00;NORTE;35;0;35;1
2018-04-05 15:00:00;NORTE;21;0;21;1
2018-04-05 15:30:00;NORTE;20;0;20;1
2018-04-05 16:00:00;NORTE;21;0;21;1
2018-04-05 16:30:00;NORTE;26;0;26;1
2018-04-05 17:00:00;NORTE;21;0;21;1
2018-04-05 17:30:00;NORTE;23;0;23;1
2018-04-05 18:00:00;NORTE;40;0;40;1
2018-04-05 18:30:00;NORTE;29;0;29;1
2018-04-05 19:00:00;NORTE;33;1;34;1
2018-04-05 19:30:00;NORTE;22;0;22;1
2018-04-05 20:00:00;NORTE;31;0;31;1
2018-04-05 20:30:00;NORTE;16;0;16;1
2018-04-05 21:00:00;NORTE;19;0;19;1
2018-04-05 21:30:00;NORTE;11;0;11;1
2018-04-05 22:00:00;NORTE;14;0;14;1
2018-04-05 22:30:00;NORTE;4;0;4;1
2018-04-05 23:00:00;NORTE;3;0;3;1
2018-04-05 23:30:00;NORTE;1;0;1;1
2018-04-06 00:00:00;NORTE;1;0;1;1
2018-04-06 00:30:00;NORTE;1;0;1;1
2018-04-06 01:00:00;NORTE;2;0;2;1
2018-04-06 02:00:00;NORTE;4;0;4;1
2018-04-06 02:30:00;NORTE;3;0;3;1
2018-04-06 03:00:00;NORTE;1;0;1;1
2018-04-06 03:30:00;NORTE;6;0;6;1
2018-04-06 04:00:00;NORTE;11;0;11;1
2018-04-06 04:30:00;NORTE;11;0;11;1
2018-04-06 05:00:00;NORTE;12;0;12;1
2018-04-06 05:30:00;NORTE;39;0;39;1
2018-04-06 06:00:00;NORTE;17;0;17;1
2018-04-06 06:30:00;NORTE;26;0;26;1
2018-04-06 07:00:00;NORTE;30;0;30;1
2018-04-06 07:30:00;NORTE;29;0;29;1
2018-04-06 08:00:00;NORTE;36;0;36;1
2018-04-06 08:30:00;NORTE;38;0;38;1
2018-04-06 09:00:00;NORTE;30;0;30;1
2018-04-06 09:30:00;NORTE;33;0;33;1
2018-04-06 10:00:00;NORTE;34;0;34;1
2018-04-06 10:30:00;NORTE;31;0;31;1
2018-04-06 11:00:00;NORTE;23;0;23;1
2018-04-06 11:30:00;NORTE;32;0;32;1
2018-04-06 12:00:00;NORTE;10;0;10;1
2018-04-06 12:18:00;NORTE;9;0;9;1
2018-04-06 12:30:00;NORTE;18;0;18;1
2018-04-06 12:48:00;NORTE;9;0;9;1
2018-04-06 13:03:00;SUR;0;28;28;1
2018-04-06 13:30:00;SUR;0;34;34;1
2018-04-06 14:00:00;SUR;0;28;28;1
2018-04-06 14:30:00;CONFLICTIVA;8;14;22;2
2018-04-06 15:00:00;NORTE;29;0;29;1
2018-04-06 15:30:00;NORTE;27;0;27;1
2018-04-06 16:00:00;NORTE;28;0;28;1
2018-04-06 16:30:00;NORTE;24;0;24;1
2018-04-06 17:00:00;NORTE;22;0;22;1
2018-04-06 17:30:00;NORTE;27;0;27;1
2018-04-06 18:00:00;NORTE;28;0;28;1
2018-04-06 18:30:00;NORTE;34;0;34;1
2018-04-06 19:00:24;NORTE;1;0;1;1
2018-04-06 19:01:27;NORTE;1;0;1;1
2018-04-06 19:01:35;NORTE;1;0;1;1
2018-04-06 19:02:37;NORTE;1;0;1;1
2018-04-06 19:03:15;NORTE;1;0;1;1
2018-04-06 19:03:55;NORTE;1;0;1;1
2018-04-06 19:04:23;NORTE;1;0;1;1
2018-04-06 19:06:55;NORTE;1;0;1;1
2018-04-06 19:06:58;NORTE;1;0;1;1
2018-04-06 19:08:14;NORTE;1;0;1;1
2018-04-06 19:09:13;NORTE;1;0;1;1
2018-04-06 19:09:47;NORTE;1;0;1;1
2018-04-06 19:10:53;NORTE;1;0;1;1
2018-04-06 19:11:04;NORTE;1;0;1;1
2018-04-06 19:12:25;NORTE;1;0;1;1
2018-04-06 19:12:50;NORTE;1;0;1;1
2018-04-06 19:13:29;NORTE;1;0;1;1
2018-04-06 19:16:50;NORTE;1;0;1;1
2018-04-06 19:17:08;NORTE;1;0;1;1
2018-04-06 19:18:49;NORTE;1;0;1;1
2018-04-06 19:20:13;NORTE;1;0;1;1
2018-04-06 19:20:17;NORTE;1;0;1;1
2018-04-06 19:22:35;NORTE;1;0;1;1
2018-04-06 19:22:43;NORTE;1;0;1;1
2018-04-06 19:23:22;NORTE;1;0;1;1
2018-04-06 19:24:40;NORTE;1;0;1;1
2018-04-06 19:25:02;NORTE;1;0;1;1
2018-04-06 19:26:02;NORTE;1;0;1;1
2018-04-06 19:26:43;NORTE;1;0;1;1
2018-04-06 19:27:46;NORTE;1;0;1;1
2018-04-06 19:29:18;NORTE;1;0;1;1
2018-04-06 19:30:00;NORTE;28;0;28;1
2018-04-06 20:00:00;CONFLICTIVA;9;15;24;2
2018-04-06 20:30:00;SUR;0;29;29;1
2018-04-06 21:00:00;SUR;0;10;10;1
2018-04-06 21:30:00;SUR;0;12;12;1
2018-04-06 22:00:00;SUR;0;15;15;1
2018-04-06 22:30:00;SUR;0;4;4;1
2018-04-06 23:00:00;SUR;0;2;2;1
2018-04-06 23:30:00;SUR;0;2;2;1
2018-04-07 00:30:00;SUR;0;3;3;1
2018-04-07 01:30:00;SUR;0;1;1;1
2018-04-07 02:00:00;SUR;0;3;3;1
2018-04-07 02:30:00;SUR;0;3;3;1
2018-04-07 03:00:00;SUR;0;1;1;1
2018-04-07 03:30:00;SUR;0;5;5;1
2018-04-07 04:00:00;SUR;0;10;10;1
2018-04-07 04:30:00;NORTE;11;0;11;1
2018-04-07 05:00:00;NORTE;17;0;17;1
2018-04-07 05:30:00;NORTE;26;0;26;1
2018-04-07 06:00:00;NORTE;10;0;10;1
2018-04-08 07:00:00;NORTE;29;0;29;1
2018-04-08 07:30:00;NORTE;23;0;23;1
2018-04-08 08:00:00;NORTE;33;0;33;1
2018-04-08 08:30:00;NORTE;37;0;37;1
2018-04-08 09:00:00;NORTE;25;0;25;1
2018-04-08 09:30:00;NORTE;27;0;27;1
2018-04-08 10:00:00;NORTE;43;0;43;1
2018-04-08 10:30:00;NORTE;32;0;32;1
2018-04-08 11:00:00;NORTE;29;0;29;1
2018-04-08 11:30:00;NORTE;25;0;25;1
2018-04-08 12:00:00;NORTE;26;0;26;1
2018-04-08 12:30:00;NORTE;26;0;26;1
2018-04-08 13:00:00;NORTE;37;0;37;1
2018-04-08 13:30:00;NORTE;36;0;36;1
2018-04-08 14:00:00;NORTE;36;0;36;1
2018-04-08 14:30:00;NORTE;34;0;34;1
2018-04-08 15:00:00;NORTE;19;0;19;1
2018-04-08 15:30:00;CONFLICTIVA;9;9;18;2
2018-04-08 16:01:00;SUR;0;1;1;1
2018-04-08 16:01:42;SUR;0;1;1;1
2018-04-08 16:03:42;SUR;0;1;1;1
2018-04-08 16:04:54;SUR;0;1;1;1
2018-04-08 16:04:55;SUR;0;1;1;1
2018-04-08 16:05:42;SUR;0;1;1;1
2018-04-08 16:07:10;SUR;0;1;1;1
2018-04-08 16:07:30;SUR;0;1;1;1
2018-04-08 16:09:37;SUR;0;1;1;1
2018-04-08 16:10:49;SUR;0;1;1;1
2018-04-08 16:13:40;SUR;0;1;1;1
2018-04-08 16:15:25;SUR;0;1;1;1
2018-04-08 16:16:39;SUR;0;1;1;1
2018-04-08 16:17:59;SUR;0;1;1;1
2018-04-08 16:19:09;SUR;0;1;1;1
2018-04-08 16:20:29;SUR;0;1;1;1
2018-04-08 16:22:11;SUR;0;1;1;1
2018-04-08 16:23:06;SUR;0;1;1;1
2018-04-08 16:24:50;SUR;0;1;1;1
2018-04-08 16:26:27;SUR;0;1;1;1
2018-04-08 16:27:18;SUR;0;1;1;1
2018-04-08 16:27:52;SUR;0;1;1;1
2018-04-08 16:28:08;SUR;0;1;1;1
2018-04-08 16:29:39;SUR;0;1;1;1
2018-04-08 16:30:00;SUR;0;29;29;1
2018-04-08 17:00:00;SUR;0;22;22;1
2018-04-08 17:30:00;CONFLICTIVA;8;11;19;2
2018-04-08 18:00:00;CONFLICTIVA;15;14;29;2
2018-04-08 18:30:00;SUR;0;34;34;1
2018-04-08 19:00:00;SUR;0;28;28;1
2018-04-08 19:30:00;SUR;0;26;26;1
2018-04-08 20:00:00;SUR;0;27;27;1
2018-04-08 20:30:00;SUR;0;26;26;1
2018-04-08 21:00:00;SUR;0;11;11;1
2018-04-08 21:30:00;SUR;0;10;10;1
2018-04-08 22:00:00;SUR;0;15;15;1
2018-04-08 22:30:00;SUR;0;9;9;1
2018-04-08 23:00:00;SUR;0;8;8;1
2018-04-08 23:30:00;SUR;0;2;2;1
2018-04-09 00:00:00;SUR;0;2;2;1
2018-04-09 00:30:00;SUR;0;1;1;1
2018-04-09 01:30:00;SUR;0;3;3;1
2018-04-09 02:00:00;SUR;0;2;2;1
2018-04-09 02:30:00;SUR;0;3;3;1
2018-04-09 03:00:00;SUR;0;2;2;1
2018-04-09 03:30:00;SUR;0;2;2;1
2018-04-09 04:00:00;SUR;0;8;8;1
2018-04-09 04:30:00;SUR;0;14;14;1
2018-04-09 05:00:00;SUR;0;15;15;1
2018-04-09 05:30:00;SUR;0;34;34;1
2018-04-09 06:00:00;SUR;0;20;20;1
2018-04-09 06:30:00;SUR;0;21;21;1
2018-04-09 07:00:00;SUR;0;29;29;1
2018-04-09 07:30:00;SUR;0;27;27;1
2018-04-09 08:00:00;SUR;0;30;30;1
2018-04-09 08:30:00;SUR;0;39;39;1
2018-04-09 09:00:00;SUR;0;23;23;1
2018-04-09 09:30:00;SUR;0;28;28;1
2018-04-09 10:00:00;SUR;0;28;28;1
2018-04-09 10:30:00;SUR;0;24;24;1
2018-04-09 11:00:00;SUR;0;31;31;1
2018-04-09 11:30:00;SUR;0;29;29;1
2018-04-09 12:00:00;SUR;0;22;22;1
2018-04-09 12:30:00;SUR;0;31;31;1
2018-04-09 13:00:00;SUR;0;35;35;1
2018-04-09 13:30:00;SUR;0;29;29;1
2018-04-09 14:00:00;SUR;0;30;30;1
2018-04-09 14:30:00;SUR;0;30;30;1
2018-04-09 15:00:00;SUR;0;29;29;1
2018-04-09 15:30:00;SUR;0;24;24;1
2018-04-09 16:00:00;SUR;0;16;16;1
2018-04-09 16:30:00;SUR;0;31;31;1
2018-04-09 17:00:00;SUR;0;25;25;1
2018-04-09 17:30:00;SUR;0;27;27;1
2018-04-09 18:00:00;SUR;0;32;32;1
2018-04-09 18:30:00;SUR;0;30;30;1
2018-04-09 19:00:00;SUR;0;23;23;1
2018-04-09 19:30:00;SUR;0;29;29;1
2018-04-09 20:00:00;SUR;0;30;30;1
2018-04-09 20:30:00;SUR;0;20;20;1
2018-04-09 21:00:00;SUR;0;13;13;1
2018-04-09 21:30:00;SUR;0;11;11;1
2018-04-09 22:00:00;SUR;0;13;13;1
2018-04-09 22:30:00;SUR;0;2;2;1
2018-04-09 23:00:00;SUR;0;3;3;1
2018-04-10 00:00:00;SUR;0;1;1;1
2018-04-10 00:30:00;SUR;0;1;1;1
2018-04-10 01:00:00;SUR;0;1;1;1
2018-04-10 01:30:00;SUR;0;1;1;1
2018-04-10 02:00:00;SUR;0;2;2;1
2018-04-10 02:30:00;SUR;0;3;3;1
2018-04-10 03:00:00;SUR;0;6;6;1
2018-04-10 03:30:00;SUR;0;7;7;1
2018-04-10 04:00:00;SUR;0;6;6;1
2018-04-10 04:30:00;SUR;0;18;18;1
2018-04-10 05:00:00;SUR;0;14;14;1
2018-04-10 05:30:00;SUR;0;34;34;1
2018-04-10 06:00:00;SUR;0;15;15;1
2018-04-10 06:30:00;SUR;0;20;20;1
2018-04-10 07:00:00;SUR;0;33;33;1
2018-04-10 07:30:00;SUR;0;26;26;1
2018-04-10 08:00:00;SUR;0;35;35;1
2018-04-10 08:30:00;SUR;0;32;32;1
2018-04-10 09:00:00;SUR;0;23;23;1
2018-04-10 09:30:00;SUR;0;30;30;1
2018-04-10 10:00:00;SUR;0;27;27;1
2018-04-10 10:30:00;SUR;0;32;32;1
2018-04-10 11:00:00;SUR;0;24;24;1
2018-04-10 11:22:00;SUR;0;12;12;1
2018-04-10 11:30:00;SUR;0;25;25;1
2018-04-10 12:00:00;SUR;0;23;23;1
2018-04-10 12:30:00;SUR;0;30;30;1
2018-04-10 13:00:00;SUR;0;26;26;1
2018-04-10 13:30:00;SUR;0;29;29;1
2018-04-10 14:00:00;SUR;0;16;16;1
2018-04-10 14:30:00;SUR;0;29;29;1
2018-04-10 15:00:00;SUR;0;28;28;1
2018-04-10 15:30:00;SUR;0;13;13;1
2018-04-10 16:00:00;SUR;0;23;23;1
2018-04-10 16:30:00;SUR;0;24;24;1
2018-04-10 17:00:00;SUR;0;19;19;1
2018-04-10 17:30:00;SUR;0;28;28;1
2018-04-10 18:00:00;SUR;0;14;14;1
2018-04-10 18:12:00;SUR;0;18;18;1
2018-04-10 18:30:00;CONFLICTIVA;22;4;26;2
2018-04-10 19:00:00;NORTE;32;0;32;1
2018-04-10 19:30:00;NORTE;24;0;24;1
2018-04-10 20:00:00;NORTE;35;0;35;1
2018-04-10 20:30:00;NORTE;25;0;25;1
2018-04-10 21:00:00;NORTE;14;0;14;1
2018-04-10 21:30:00;NORTE;14;0;14;1
2018-04-10 22:00:00;NORTE;12;0;12;1
2018-04-10 22:30:00;NORTE;3;0;3;1
2018-04-10 23:00:00;NORTE;3;0;3;1
2018-04-10 23:30:00;NORTE;2;0;2;1
2018-04-11 00:30:00;NORTE;1;0;1;1
2018-04-11 01:30:00;NORTE;2;0;2;1
2018-04-11 02:00:00;NORTE;2;0;2;1
2018-04-11 02:30:00;NORTE;3;0;3;1
2018-04-11 03:00:00;NORTE;3;0;3;1
2018-04-11 03:30:00;NORTE;6;0;6;1
2018-04-11 04:00:00;NORTE;9;0;9;1
2018-04-11 04:30:00;NORTE;13;0;13;1
2018-04-11 05:00:00;NORTE;12;0;12;1
2018-04-11 05:30:00;NORTE;37;0;37;1
2018-04-11 06:00:00;NORTE;23;0;23;1
2018-04-11 06:30:00;NORTE;23;0;23;1
2018-04-11 07:00:00;NORTE;37;0;37;1
2018-04-11 07:30:00;NORTE;26;0;26;1
2018-04-11 08:00:00;NORTE;28;0;28;1
2018-04-11 08:30:00;NORTE;39;0;39;1
2018-04-11 09:00:00;NORTE;17;0;17;1
2018-04-11 09:30:00;NORTE;24;0;24;1
2018-04-11 10:00:00;NORTE;35;0;35;1
2018-04-11 10:30:00;NORTE;37;0;37;1
2018-04-11 11:00:00;NORTE;26;0;26;1
2018-04-11 11:30:00;NORTE;31;0;31;1
2018-04-11 12:00:00;NORTE;17;0;17;1
2018-04-11 12:30:00;NORTE;31;0;31;1
2018-04-11 13:00:00;NORTE;30;0;30;1
2018-04-11 13:30:00;NORTE;30;0;30;1
2018-04-11 14:00:00;NORTE;31;0;31;1
2018-04-11 14:30:00;NORTE;35;0;35;1
2018-04-11 15:00:00;NORTE;25;0;25;1
2018-04-11 15:30:00;NORTE;17;0;17;1
2018-04-11 16:00:00;NORTE;15;0;15;1
2018-04-11 16:30:00;NORTE;24;0;24;1
2018-04-11 17:00:00;NORTE;27;0;27;1
2018-04-11 17:30:00;NORTE;30;0;30;1
2018-04-11 18:00:00;NORTE;34;0;34;1
2018-04-11 18:30:00;NORTE;35;0;35;1
2018-04-11 19:00:00;NORTE;27;0;27;1
2018-04-11 19:30:00;NORTE;26;0;26;1
2018-04-11 20:00:00;NORTE;35;0;35;1
2018-04-11 20:30:00;NORTE;25;0;25;1
2018-04-11 21:00:00;NORTE;18;0;18;1
2018-04-11 21:30:00;NORTE;13;0;13;1
2018-04-11 22:00:00;NORTE;12;0;12;1
2018-04-11 22:30:00;NORTE;6;0;6;1
2018-04-11 23:00:00;NORTE;3;0;3;1
2018-04-11 23:30:00;NORTE;2;0;2;1
2018-04-12 00:00:00;NORTE;1;0;1;1
2018-04-12 00:30:00;NORTE;1;0;1;1
2018-04-12 01:30:00;NORTE;1;0;1;1
2018-04-12 02:00:00;NORTE;1;0;1;1
2018-04-12 02:30:00;NORTE;3;0;3;1
2018-04-12 03:00:00;NORTE;3;0;3;1
2018-04-12 03:30:00;NORTE;7;0;7;1
2018-04-12 04:00:00;NORTE;7;0;7;1
2018-04-12 04:30:00;NORTE;10;0;10;1
2018-04-12 05:00:00;NORTE;16;0;16;1
2018-04-12 05:30:00;NORTE;40;0;40;1
2018-04-12 06:00:00;NORTE;19;0;19;1
2018-04-12 06:30:00;NORTE;23;0;23;1
2018-04-12 07:00:00;NORTE;29;0;29;1
2018-04-12 07:30:00;NORTE;23;0;23;1
2018-04-12 08:00:00;SUR;1;32;33;1
2018-04-12 08:30:00;SUR;0;32;32;1
2018-04-12 09:00:00;SUR;0;29;29;1
2018-04-12 09:30:00;SUR;0;31;31;1
2018-04-12 10:00:00;SUR;0;32;32;1
2018-04-12 10:30:00;SUR;0;24;24;1
2018-04-12 11:00:00;SUR;0;26;26;1
2018-04-12 11:30:00;SUR;0;26;26;1
2018-04-12 12:00:00;SUR;0;25;25;1
2018-04-12 12:30:00;SUR;0;31;31;1
2018-04-12 13:00:00;SUR;0;24;24;1
2018-04-12 13:30:00;SUR;0;33;33;1
2018-04-12 14:00:00;SUR;0;37;37;1
2018-04-12 14:30:00;SUR;0;30;30;1
2018-04-12 15:00:00;SUR;0;10;10;1
2018-04-12 15:30:00;SUR;0;19;19;1
2018-04-12 16:00:00;SUR;0;19;19;1
2018-04-12 16:30:00;SUR;0;24;24;1
2018-04-12 17:00:00;SUR;0;26;26;1
2018-04-12 17:30:00;SUR;0;23;23;1
2018-04-12 18:00:00;SUR;0;32;32;1
2018-04-12 18:30:00;SUR;0;38;38;1
2018-04-12 19:00:00;SUR;0;30;30;1
2018-04-12 19:30:00;SUR;0;14;14;1
2018-04-12 20:00:00;SUR;0;39;39;1
2018-04-12 20:30:00;SUR;0;15;15;1
2018-04-12 21:00:00;SUR;0;20;20;1
2018-04-12 21:30:00;SUR;0;13;13;1
2018-04-12 22:00:00;SUR;0;14;14;1
2018-04-12 22:30:00;SUR;0;6;6;1
2018-04-12 23:00:00;SUR;0;6;6;1
2018-04-13 00:00:00;SUR;0;5;5;1
2018-04-13 00:30:00;SUR;0;2;2;1
2018-04-13 01:00:00;SUR;0;1;1;1
2018-04-13 02:00:00;SUR;0;3;3;1
2018-04-13 02:30:00;SUR;0;2;2;1
2018-04-13 03:00:00;SUR;0;5;5;1
2018-04-13 03:30:00;SUR;0;4;4;1
2018-04-13 04:00:00;SUR;0;8;8;1
2018-04-13 04:30:00;SUR;0;11;11;1
2018-04-13 05:00:00;SUR;0;14;14;1
2018-04-13 05:30:00;SUR;0;35;35;1
2018-04-13 06:00:00;SUR;0;27;27;1
2018-04-13 06:30:00;CONFLICTIVA;15;7;22;2
2018-04-13 07:00:00;NORTE;33;0;33;1
2018-04-13 07:30:00;NORTE;30;0;30;1
2018-04-13 08:00:00;NORTE;32;0;32;1
2018-04-13 08:31:11;NORTE;1;0;1;1
2018-04-13 08:31:24;NORTE;1;0;1;1
2018-04-13 08:31:55;NORTE;1;0;1;1
2018-04-13 08:32:42;NORTE;1;0;1;1
2018-04-13 08:34:02;NORTE;1;0;1;1
2018-04-13 08:34:21;NORTE;1;0;1;1
2018-04-13 08:34:46;NORTE;2;0;2;1
2018-04-13 08:36:33;NORTE;1;0;1;1
2018-04-13 08:36:43;NORTE;1;0;1;1
2018-04-13 08:37:23;NORTE;1;0;1;1
2018-04-13 08:37:27;NORTE;1;0;1;1
2018-04-13 08:38:27;NORTE;1;0;1;1
2018-04-13 08:39:44;NORTE;1;0;1;1
2018-04-13 08:40:20;NORTE;1;0;1;1
2018-04-13 08:41:38;NORTE;1;0;1;1
2018-04-13 08:43:02;NORTE;1;0;1;1
2018-04-13 08:43:09;NORTE;1;0;1;1
2018-04-13 08:44:42;NORTE;1;0;1;1
2018-04-13 08:46:43;NORTE;1;0;1;1
2018-04-13 08:47:30;NORTE;1;0;1;1
2018-04-13 08:49:02;NORTE;1;0;1;1
2018-04-13 08:49:19;NORTE;1;0;1;1
2018-04-13 08:50:48;NORTE;1;0;1;1
2018-04-13 08:51:24;NORTE;1;0;1;1
2018-04-13 08:51:52;NORTE;1;0;1;1
2018-04-13 08:52:53;NORTE;1;0;1;1
2018-04-13 08:52:56;NORTE;1;0;1;1
2018-04-13 08:54:00;NORTE;1;0;1;1
2018-04-13 08:54:51;NORTE;1;0;1;1
2018-04-13 08:56:05;NORTE;1;0;1;1
2018-04-13 08:56:38;NORTE;1;0;1;1
2018-04-13 08:58:06;NORTE;1;0;1;1
2018-04-13 08:58:35;NORTE;1;0;1;1
2018-04-13 09:00:00;NORTE;26;1;27;1
2018-04-13 09:30:00;CONFLICTIVA;9;18;27;2
2018-04-13 10:00:00;SUR;0;30;30;1
2018-04-13 10:30:00;SUR;0;37;37;1
2018-04-13 11:00:00;SUR;0;27;27;1
2018-04-13 11:30:00;SUR;0;26;26;1
2018-04-13 12:00:00;SUR;0;22;22;1
2018-04-13 12:30:00;SUR;0;29;29;1
2018-04-13 13:00:00;SUR;0;37;37;1
2018-04-13 13:30:00;SUR;0;17;17;1
2018-04-13 14:00:00;SUR;0;36;36;1
2018-04-13 14:30:00;SUR;0;31;31;1
2018-04-13 15:00:00;SUR;0;28;28;1
2018-04-13 15:30:00;SUR;0;18;18;1
2018-04-13 16:00:00;SUR;1;13;14;1
2018-04-13 16:30:00;NORTE;32;0;32;1
2018-04-13 17:00:00;NORTE;30;0;30;1
2018-04-13 17:30:00;NORTE;23;0;23;1
2018-04-13 18:00:00;NORTE;38;0;38;1
2018-04-13 18:30:00;NORTE;41;0;41;1
2018-04-13 19:00:00;NORTE;23;0;23;1
2018-04-13 19:30:00;NORTE;20;0;20;1
2018-04-13 20:00:00;NORTE;28;0;28;1
2018-04-13 20:30:00;NORTE;23;0;23;1
2018-04-13 21:00:00;NORTE;13;0;13;1
2018-04-13 21:30:00;NORTE;11;0;11;1
2018-04-13 22:00:00;NORTE;13;0;13;1
2018-04-13 22:30:00;NORTE;6;0;6;1
2018-04-13 23:00:00;NORTE;1;0;1;1
2018-04-14 00:00:00;NORTE;1;0;1;1
2018-04-14 00:30:00;NORTE;1;0;1;1
2018-04-14 02:00:00;NORTE;2;0;2;1
2018-04-14 02:30:00;NORTE;2;0;2;1
2018-04-14 03:00:00;NORTE;3;0;3;1
2018-04-14 03:30:00;NORTE;4;0;4;1
2018-04-14 04:00:00;NORTE;8;0;8;1
2018-04-14 04:30:00;NORTE;13;0;13;1
2018-04-14 05:00:00;NORTE;15;0;15;1
2018-04-14 05:30:00;NORTE;30;0;30;1
2018-04-14 06:00:00;NORTE;21;0;21;1
2018-04-14 06:30:00;NORTE;24;0;24;1
2018-04-14 07:00:00;NORTE;37;0;37;1
2018-04-14 07:30:00;NORTE;28;0;28;1
2018-04-14 08:00:00;NORTE;34;0;34;1
2018-04-14 08:30:00;NORTE;31;0;31;1
2018-04-14 09:00:00;NORTE;19;0;19;1
2018-04-14 09:30:00;NORTE;36;0;36;1
2018-04-14 10:00:00;NORTE;30;0;30;1
2018-04-14 10:30:00;NORTE;33;0;33;1
2018-04-14 11:00:00;NORTE;22;0;22;1
2018-04-14 11:30:00;NORTE;23;0;23;1
2018-04-14 12:00:00;NORTE;25;0;25;1
2018-04-14 12:30:00;NORTE;27;0;27;1
2018-04-14 13:00:00;NORTE;25;0;25;1
2018-04-14 13:30:00;NORTE;29;0;29;1
2018-04-14 14:00:00;NORTE;31;0;31;1
2018-04-14 14:30:00;NORTE;31;0;31;1
2018-04-14 15:00:00;NORTE;22;0;22;1
2018-04-14 15:30:00;NORTE;16;0;16;1
2018-04-14 16:00:00;NORTE;19;0;19;1
2018-04-14 16:30:00;NORTE;28;0;28;1
2018-04-14 17:00:00;NORTE;17;0;17;1
2018-04-14 17:30:00;NORTE;22;0;22;1
2018-04-14 18:00:00;NORTE;33;0;33;1
2018-04-14 18:30:00;NORTE;20;0;20;1
2018-04-14 19:00:00;NORTE;25;0;25;1
2018-04-14 19:30:00;NORTE;19;0;19;1
2018-04-14 20:00:00;NORTE;17;0;17;1
2018-04-14 20:30:00;NORTE;10;0;10;1
2018-04-14 21:00:00;NORTE;12;0;12;1
2018-04-14 21:30:00;NORTE;13;0;13;1
2018-04-14 22:00:00;NORTE;12;0;12;1
2018-04-14 22:30:00;NORTE;2;0;2;1
2018-04-14 23:00:00;NORTE;2;0;2;1
2018-04-14 23:30:00;NORTE;1;0;1;1
2018-04-15 00:00:00;NORTE;1;0;1;1
2018-04-15 00:30:00;NORTE;1;0;1;1
2018-04-15 01:00:00;NORTE;4;0;4;1
2018-04-15 01:30:00;NORTE;1;0;1;1
2018-04-15 02:30:00;NORTE;4;0;4;1
2018-04-15 03:30:00;NORTE;3;0;3;1
2018-04-15 04:00:00;NORTE;9;0;9;1
2018-04-15 04:30:00;NORTE;9;0;9;1
2018-04-15 05:00:00;NORTE;18;0;18;1
2018-04-15 05:30:00;NORTE;21;0;21;1
2018-04-15 06:00:00;NORTE;16;0;16;1
2018-04-15 06:30:00;NORTE;22;0;22;1
2018-04-15 07:00:00;NORTE;25;0;25;1
2018-04-15 07:30:00;NORTE;29;0;29;1
2018-04-15 08:00:00;NORTE;33;0;33;1
2018-04-15 08:30:00;NORTE;35;0;35;1
2018-04-15 09:00:00;NORTE;18;0;18;1
2018-04-15 09:30:00;CONFLICTIVA;23;5;28;2
2018-04-15 10:00:00;SUR;0;35;35;1
2018-04-15 10:30:00;SUR;0;35;35;1
2018-04-15 11:00:00;SUR;0;24;24;1
2018-04-15 11:30:00;SUR;0;27;27;1
2018-04-15 12:00:00;SUR;0;25;25;1
2018-04-15 12:30:00;SUR;0;26;26;1
2018-04-15 13:00:00;SUR;0;30;30;1
2018-04-15 13:30:00;SUR;0;42;42;1
2018-04-15 14:00:00;SUR;0;33;33;1
2018-04-15 14:30:00;SUR;0;29;29;1
2018-04-15 15:00:00;SUR;0;26;26;1
2018-04-15 15:30:00;SUR;0;23;23;1
2018-04-15 16:00:00;SUR;0;22;22;1
2018-04-15 16:30:00;SUR;0;28;28;1
2018-04-15 17:00:00;SUR;0;18;18;1
2018-04-15 17:30:00;SUR;0;28;28;1
2018-04-15 18:00:00;SUR;0;36;36;1
2018-04-15 18:30:00;SUR;0;29;29;1
2018-04-15 19:00:00;SUR;0;28;28;1
2018-04-15 19:30:00;SUR;0;22;22;1
2018-04-15 20:00:00;SUR;0;31;31;1
2018-04-15 20:30:00;SUR;0;22;22;1
2018-04-15 21:00:00;SUR;0;16;16;1
2018-04-15 21:30:00;SUR;0;11;11;1
2018-04-15 22:00:00;SUR;0;13;13;1
2018-04-15 22:30:00;SUR;0;11;11;1
2018-04-15 23:00:00;SUR;0;8;8;1
2018-04-15 23:30:00;SUR;0;1;1;1
2018-04-16 00:00:00;SUR;0;1;1;1
2018-04-16 00:30:00;SUR;0;2;2;1
2018-04-16 01:30:00;SUR;0;2;2;1
2018-04-16 02:00:00;SUR;0;2;2;1
2018-04-16 02:30:00;SUR;0;5;5;1
2018-04-16 03:00:00;SUR;0;1;1;1
2018-04-16 03:30:00;SUR;0;3;3;1
2018-04-16 04:00:00;SUR;0;9;9;1
2018-04-16 04:30:00;CONFLICTIVA;9;1;10;2
2018-04-16 05:00:00;NORTE;15;0;15;1
2018-04-16 05:30:00;NORTE;35;0;35;1
2018-04-16 06:00:00;NORTE;20;0;20;1
2018-04-16 06:30:00;NORTE;30;0;30;1
2018-04-16 07:00:00;NORTE;29;0;29;1
2018-04-16 07:30:00;NORTE;26;0;26;1
2018-04-16 08:00:00;NORTE;28;0;28;1
2018-04-16 08:30:00;NORTE;33;0;33;1
2018-04-16 09:00:00;NORTE;23;0;23;1
2018-04-16 09:30:00;NORTE;31;0;31;1
2018-04-16 10:00:00;NORTE;29;0;29;1
2018-04-16 10:30:00;NORTE;39;0;39;1
2018-04-16 11:00:00;NORTE;29;0;29;1
2018-04-16 11:30:00;NORTE;23;0;23;1
2018-04-16 12:00:00;NORTE;24;0;24;1
2018-04-16 12:30:00;NORTE;40;0;40;1
2018-04-16 13:00:00;NORTE;30;0;30;1
2018-04-16 13:30:00;NORTE;34;0;34;1
2018-04-16 14:00:00;NORTE;38;0;38;1
2018-04-16 14:30:00;NORTE;30;0;30;1
2018-04-16 15:00:00;NORTE;22;0;22;1
2018-04-16 15:30:00;NORTE;25;0;25;1
2018-04-16 16:00:00;NORTE;27;0;27;1
2018-04-16 16:30:00;NORTE;31;0;31;1
2018-04-16 17:00:00;NORTE;23;0;23;1
2018-04-16 17:30:00;NORTE;27;0;27;1
2018-04-16 18:00:00;CONFLICTIVA;30;8;38;2
2018-04-16 18:30:00;SUR;0;33;33;1
2018-04-16 19:00:00;SUR;0;31;31;1
2018-04-16 19:30:00;SUR;0;21;21;1
2018-04-16 20:00:00;SUR;0;36;36;1
2018-04-16 20:30:00;SUR;0;17;17;1
2018-04-16 21:00:00;SUR;0;16;16;1
2018-04-16 21:30:00;SUR;0;17;17;1
2018-04-16 22:00:00;CONFLICTIVA;6;3;9;2
2018-04-16 22:30:00;NORTE;4;0;4;1
2018-04-16 23:00:00;NORTE;1;0;1;1
2018-04-17 01:00:00;NORTE;1;0;1;1
2018-04-17 01:30:00;NORTE;2;0;2;1
2018-04-17 02:00:00;NORTE;1;0;1;1
2018-04-17 02:30:00;NORTE;6;0;6;1
2018-04-17 03:00:00;NORTE;2;0;2;1
2018-04-17 03:30:00;NORTE;5;0;5;1
2018-04-17 04:00:00;NORTE;11;0;11;1
2018-04-17 04:30:00;NORTE;12;0;12;1
2018-04-17 05:00:00;NORTE;15;0;15;1
2018-04-17 05:30:00;NORTE;36;0;36;1
2018-04-17 06:00:00;NORTE;22;0;22;1
2018-04-17 06:30:00;NORTE;19;0;19;1
2018-04-17 07:00:00;NORTE;30;0;30;1
2018-04-17 07:30:00;NORTE;34;0;34;1
2018-04-17 08:00:00;NORTE;37;0;37;1
2018-04-17 08:30:00;NORTE;36;0;36;1
2018-04-17 09:00:00;NORTE;20;0;20;1
2018-04-17 09:30:00;NORTE;34;0;34;1
2018-04-17 10:00:00;NORTE;41;0;41;1
2018-04-17 10:30:00;NORTE;32;0;32;1
2018-04-17 11:00:00;NORTE;31;0;31;1
2018-04-17 11:30:00;NORTE;27;0;27;1
2018-04-17 12:00:00;NORTE;28;0;28;1
2018-04-17 12:30:00;NORTE;29;0;29;1
2018-04-17 13:00:00;NORTE;30;0;30;1
2018-04-17 13:30:00;NORTE;30;0;30;1
2018-04-17 14:00:00;NORTE;39;0;39;1
2018-04-17 14:30:00;NORTE;33;0;33;1
2018-04-17 15:00:00;NORTE;14;0;14;1
2018-04-17 15:30:00;NORTE;20;0;20;1
2018-04-17 16:00:00;NORTE;20;0;20;1
2018-04-17 16:30:00;NORTE;29;0;29;1
2018-04-17 17:00:00;NORTE;22;0;22;1
2018-04-17 17:30:00;NORTE;29;0;29;1
2018-04-17 18:00:00;NORTE;41;0;41;1
2018-04-17 18:30:00;NORTE;33;0;33;1
2018-04-17 19:00:00;NORTE;31;0;31;1
2018-04-17 19:30:00;NORTE;25;0;25;1
2018-04-17 20:00:00;NORTE;40;0;40;1
2018-04-17 20:30:00;NORTE;21;0;21;1
2018-04-17 21:00:00;NORTE;17;0;17;1
2018-04-17 21:30:00;NORTE;7;0;7;1
2018-04-17 22:00:00;NORTE;12;0;12;1
2018-04-17 22:30:00;NORTE;2;0;2;1
2018-04-17 23:00:00;NORTE;2;0;2;1
2018-04-17 23:30:00;NORTE;2;0;2;1
2018-04-18 00:00:00;NORTE;3;0;3;1
2018-04-18 01:30:00;NORTE;1;0;1;1
2018-04-18 02:00:00;NORTE;3;0;3;1
2018-04-18 02:30:00;NORTE;1;0;1;1
2018-04-18 03:00:00;NORTE;2;0;2;1
2018-04-18 03:30:00;NORTE;8;0;8;1
2018-04-18 04:00:00;NORTE;9;0;9;1
2018-04-18 04:30:00;NORTE;12;0;12;1
2018-04-18 05:00:00;NORTE;17;0;17;1
2018-04-18 05:30:00;NORTE;42;0;42;1
2018-04-18 06:00:00;NORTE;20;0;20;1
2018-04-18 06:30:00;NORTE;29;0;29;1
2018-04-18 07:00:00;NORTE;29;0;29;1
2018-04-18 07:30:00;NORTE;23;0;23;1
2018-04-18 08:00:00;NORTE;37;0;37;1
2018-04-18 08:30:00;NORTE;32;0;32;1
2018-04-18 09:00:00;NORTE;25;0;25;1
2018-04-18 09:30:00;NORTE;33;0;33;1
2018-04-18 10:00:00;NORTE;36;0;36;1
2018-04-18 10:30:00;NORTE;28;0;28;1
2018-04-18 11:00:00;NORTE;35;0;35;1
2018-04-18 11:30:00;NORTE;26;0;26;1
2018-04-18 12:00:00;NORTE;24;0;24;1
2018-04-18 12:30:00;NORTE;31;0;31;1
2018-04-18 13:00:00;CONFLICTIVA;9;16;25;2
2018-04-18 13:30:00;SUR;0;28;28;1
2018-04-18 14:00:00;SUR;0;27;27;1
2018-04-18 14:30:00;SUR;0;34;34;1
2018-04-18 15:00:00;SUR;0;20;20;1
2018-04-18 15:30:00;SUR;0;20;20;1
2018-04-18 16:00:00;CONFLICTIVA;16;4;20;2
2018-04-18 16:30:00;NORTE;33;0;33;1
2018-04-18 17:00:00;CONFLICTIVA;17;5;22;2
2018-04-18 17:30:00;SUR;0;32;32;1
2018-04-18 18:00:00;SUR;0;40;40;1
2018-04-18 18:30:00;SUR;0;32;32;1
2018-04-18 19:00:00;SUR;0;27;27;1
2018-04-18 19:30:00;SUR;0;20;20;1
2018-04-18 20:00:00;SUR;0;35;35;1
2018-04-18 20:30:00;SUR;2;19;21;1
2018-04-18 21:00:00;NORTE;18;0;18;1
2018-04-18 21:30:00;NORTE;12;0;12;1
2018-04-18 22:00:00;CONFLICTIVA;7;2;9;2
2018-04-18 22:30:00;SUR;0;6;6;1
2018-04-18 23:00:00;SUR;0;2;2;1
2018-04-19 00:00:00;SUR;0;3;3;1
2018-04-19 01:30:00;NORTE;1;0;1;1
2018-04-19 02:00:00;NORTE;2;0;2;1
2018-04-19 02:30:00;NORTE;4;0;4;1
2018-04-19 03:00:00;NORTE;2;0;2;1
2018-04-19 03:30:00;NORTE;5;0;5;1
2018-04-19 04:00:00;NORTE;11;0;11;1
2018-04-19 04:30:00;NORTE;13;0;13;1
2018-04-19 05:00:00;NORTE;14;0;14;1
2018-04-19 05:30:00;NORTE;39;0;39;1
2018-04-19 06:00:00;NORTE;21;0;21;1
2018-04-19 06:30:00;NORTE;29;0;29;1
2018-04-19 07:00:00;NORTE;31;0;31;1
2018-04-19 07:30:00;NORTE;29;0;29;1
2018-04-19 08:00:00;NORTE;31;0;31;1
2018-04-19 08:30:00;NORTE;30;0;30;1
2018-04-19 09:00:00;NORTE;24;0;24;1
2018-04-19 09:30:00;NORTE;39;0;39;1
2018-04-19 10:00:00;NORTE;39;0;39;1
2018-04-19 10:30:00;NORTE;31;0;31;1
2018-04-19 11:00:00;CONFLICTIVA;4;14;18;2
2018-04-19 11:30:00;SUR;0;27;27;1
2018-04-19 12:00:00;SUR;0;27;27;1
2018-04-19 12:30:00;SUR;0;27;27;1
2018-04-19 13:00:00;SUR;0;28;28;1
2018-04-19 13:30:00;SUR;0;22;22;1
2018-04-19 14:00:00;SUR;0;39;39;1
2018-04-19 14:30:00;SUR;0;29;29;1
2018-04-19 15:00:00;SUR;0;23;23;1
2018-04-19 15:30:00;SUR;0;15;15;1
2018-04-19 16:00:00;SUR;0;21;21;1
2018-04-19 16:30:00;SUR;0;30;30;1
2018-04-19 17:00:00;SUR;0;22;22;1
2018-04-19 17:30:00;SUR;0;32;32;1
2018-04-19 18:00:00;SUR;0;29;29;1
2018-04-19 18:30:00;SUR;0;35;35;1
2018-04-19 19:00:00;SUR;0;23;23;1
2018-04-19 19:30:00;SUR;0;11;11;1
2018-04-19 20:00:00;SUR;0;36;36;1
2018-04-19 20:30:00;SUR;0;23;23;1
2018-04-19 21:00:00;SUR;0;19;19;1
2018-04-19 21:30:00;SUR;0;10;10;1
2018-04-19 22:00:00;SUR;0;14;14;1
2018-04-19 22:30:00;SUR;0;4;4;1
2018-04-19 23:00:00;SUR;0;2;2;1
2018-04-19 23:30:00;SUR;0;2;2;1
2018-04-20 00:00:00;SUR;0;2;2;1
2018-04-20 00:30:00;SUR;0;1;1;1
2018-04-20 01:00:00;SUR;0;1;1;1
2018-04-20 01:30:00;SUR;0;1;1;1
2018-04-20 02:00:00;SUR;0;3;3;1
2018-04-20 02:30:00;CONFLICTIVA;2;2;4;2
2018-04-20 03:00:00;NORTE;4;0;4;1
2018-04-20 03:30:00;NORTE;4;0;4;1
2018-04-20 04:00:00;NORTE;9;0;9;1
2018-04-20 04:30:00;NORTE;12;0;12;1
2018-04-20 05:00:00;NORTE;9;0;9;1
2018-04-20 05:30:00;NORTE;39;0;39;1
2018-04-20 06:00:00;NORTE;23;0;23;1
2018-04-20 06:30:00;NORTE;25;0;25;1
2018-04-20 07:00:00;NORTE;38;0;38;1
2018-04-20 07:30:00;NORTE;33;0;33;1
2018-04-20 08:00:00;NORTE;39;0;39;1
2018-04-20 08:30:00;NORTE;32;0;32;1
2018-04-20 09:00:00;NORTE;29;0;29;1
2018-04-20 09:30:00;CONFLICTIVA;19;5;24;2
2018-04-20 10:00:00;SUR;0;40;40;1
2018-04-20 10:30:00;SUR;0;30;30;1
2018-04-20 11:00:00;SUR;0;28;28;1
2018-04-20 11:30:00;SUR;0;28;28;1
2018-04-20 12:00:00;SUR;0;22;22;1
2018-04-20 12:30:00;SUR;0;28;28;1
2018-04-20 13:00:00;SUR;0;38;38;1
2018-04-20 13:30:00;SUR;0;35;35;1
2018-04-20 14:00:00;SUR;0;35;35;1
2018-04-20 14:30:00;SUR;0;37;37;1
2018-04-20 15:00:00;SUR;0;28;28;1
2018-04-20 15:30:00;SUR;0;20;20;1
2018-04-20 16:00:00;SUR;0;18;18;1
2018-04-20 16:30:00;SUR;0;30;30;1
2018-04-20 17:00:00;SUR;0;21;21;1
2018-04-20 17:30:00;SUR;0;26;26;1
2018-04-20 18:00:00;SUR;0;43;43;1
2018-04-20 18:30:00;SUR;0;25;25;1
2018-04-20 19:00:00;SUR;0;28;28;1
2018-04-20 19:30:00;SUR;0;29;29;1
2018-04-20 20:00:00;SUR;0;24;24;1
2018-04-20 20:30:00;SUR;0;27;27;1
2018-04-20 21:00:00;SUR;0;15;15;1
2018-04-20 21:30:00;SUR;0;14;14;1
2018-04-20 22:00:00;SUR;0;17;17;1
2018-04-20 22:30:00;CONFLICTIVA;2;3;5;2
2018-04-20 23:00:00;NORTE;1;0;1;1
2018-04-20 23:30:00;NORTE;2;0;2;1
2018-04-21 00:00:00;NORTE;1;0;1;1
2018-04-21 01:00:00;NORTE;1;0;1;1
2018-04-21 01:30:00;NORTE;1;0;1;1
2018-04-21 02:00:00;NORTE;1;0;1;1
2018-04-21 02:30:00;NORTE;4;0;4;1
2018-04-21 03:30:00;NORTE;4;0;4;1
2018-04-21 04:00:00;NORTE;10;0;10;1
2018-04-21 04:30:00;NORTE;17;0;17;1
2018-04-21 05:00:00;NORTE;16;0;16;1
2018-04-21 05:30:00;NORTE;34;0;34;1
2018-04-21 06:00:00;NORTE;14;0;14;1
2018-04-21 06:30:00;NORTE;27;0;27;1
2018-04-21 07:00:00;NORTE;31;0;31;1
2018-04-21 07:30:00;NORTE;29;0;29;1
2018-04-21 08:00:00;NORTE;31;0;31;1
2018-04-21 08:30:00;NORTE;38;0;38;1
2018-04-21 09:00:00;NORTE;21;0;21;1
2018-04-21 09:30:00;NORTE;30;0;30;1
2018-04-21 10:00:00;NORTE;35;0;35;1
2018-04-21 10:30:00;NORTE;34;0;34;1
2018-04-21 11:00:00;NORTE;29;0;29;1
2018-04-21 11:30:00;NORTE;20;0;20;1
2018-04-21 12:00:00;NORTE;27;0;27;1
2018-04-21 12:30:00;NORTE;29;0;29;1
2018-04-21 13:00:00;NORTE;19;0;19;1
2018-04-21 13:30:00;NORTE;31;0;31;1
2018-04-21 14:00:00;NORTE;37;0;37;1
2018-04-21 14:30:00;NORTE;27;0;27;1
2018-04-21 15:00:00;NORTE;17;0;17;1
2018-04-21 15:30:00;NORTE;14;0;14;1
2018-04-21 16:00:00;NORTE;20;0;20;1
2018-04-21 16:30:00;NORTE;28;0;28;1
2018-04-21 17:00:00;NORTE;16;0;16;1
2018-04-21 17:30:00;NORTE;27;0;27;1
2018-04-21 18:00:00;NORTE;30;0;30;1
2018-04-21 18:30:00;NORTE;27;0;27;1
2018-04-21 19:00:00;NORTE;19;0;19;1
2018-04-21 19:30:00;NORTE;22;0;22;1
2018-04-21 20:00:00;NORTE;20;0;20;1
2018-04-21 20:30:00;NORTE;15;0;15;1
2018-04-21 21:00:00;NORTE;10;0;10;1
2018-04-21 21:30:00;NORTE;14;0;14;1
2018-04-21 22:00:00;NORTE;9;0;9;1
2018-04-21 22:30:00;NORTE;3;0;3;1
2018-04-21 23:00:00;NORTE;3;0;3;1
2018-04-21 23:30:00;NORTE;2;0;2;1
2018-04-22 00:00:00;NORTE;1;0;1;1
2018-04-22 01:00:00;NORTE;2;0;2;1
2018-04-22 01:30:00;NORTE;1;0;1;1
2018-04-22 02:00:00;NORTE;3;0;3;1
2018-04-22 02:30:00;NORTE;2;0;2;1
2018-04-22 03:00:00;NORTE;3;0;3;1
2018-04-22 03:30:00;NORTE;3;0;3;1
2018-04-22 04:00:00;NORTE;11;0;11;1
2018-04-22 04:30:00;NORTE;7;0;7;1
2018-04-22 05:00:00;NORTE;17;0;17;1
2018-04-22 05:30:00;NORTE;29;0;29;1
2018-04-22 06:00:00;NORTE;15;0;15;1
2018-04-22 06:30:00;NORTE;22;0;22;1
2018-04-22 07:00:00;NORTE;32;0;32;1
2018-04-22 07:30:00;NORTE;26;0;26;1
2018-04-22 08:00:00;NORTE;36;0;36;1
2018-04-22 08:30:00;NORTE;28;0;28;1
2018-04-22 09:00:00;NORTE;16;0;16;1
2018-04-22 09:30:00;NORTE;34;0;34;1
2018-04-22 10:00:00;NORTE;29;0;29;1
2018-04-22 10:30:00;NORTE;36;0;36;1
2018-04-22 11:00:00;NORTE;33;0;33;1
2018-04-22 11:30:00;NORTE;27;0;27;1
2018-04-22 12:00:00;NORTE;25;0;25;1
2018-04-22 12:30:00;NORTE;36;0;36;1
2018-04-22 13:00:00;NORTE;28;0;28;1
2018-04-22 13:30:00;NORTE;29;0;29;1
2018-04-22 14:00:00;NORTE;38;0;38;1
2018-04-22 14:30:00;NORTE;34;0;34;1
2018-04-22 15:00:00;NORTE;31;0;31;1
2018-04-22 15:30:00;NORTE;16;0;16;1
2018-04-22 16:00:00;NORTE;19;0;19;1
2018-04-22 16:30:00;NORTE;29;0;29;1
2018-04-22 17:00:00;NORTE;23;0;23;1
2018-04-22 17:30:00;NORTE;29;0;29;1
2018-04-22 18:00:00;NORTE;39;0;39;1
2018-04-22 18:30:00;NORTE;31;0;31;1
2018-04-22 19:00:00;NORTE;29;0;29;1
2018-04-22 19:30:00;NORTE;27;0;27;1
2018-04-22 20:00:00;NORTE;30;0;30;1
2018-04-22 20:30:00;NORTE;30;0;30;1
2018-04-22 21:00:00;NORTE;12;0;12;1
2018-04-22 21:30:00;NORTE;13;0;13;1
2018-04-22 22:00:00;NORTE;13;0;13;1
2018-04-22 22:30:00;NORTE;6;0;6;1
2018-04-22 23:00:00;NORTE;4;0;4;1
2018-04-22 23:30:00;NORTE;2;0;2;1
2018-04-23 00:00:00;NORTE;2;0;2;1
2018-04-23 00:30:00;NORTE;2;0;2;1
2018-04-23 01:30:00;NORTE;1;0;1;1
2018-04-23 02:00:00;NORTE;3;0;3;1
2018-04-23 02:30:00;NORTE;4;0;4;1
2018-04-23 03:00:00;NORTE;2;0;2;1
2018-04-23 03:30:00;NORTE;4;0;4;1
2018-04-23 04:00:00;NORTE;6;0;6;1
2018-04-23 04:30:00;NORTE;14;0;14;1
2018-04-23 05:00:00;NORTE;19;0;19;1
2018-04-23 05:30:00;NORTE;42;0;42;1
2018-04-23 06:00:00;NORTE;19;0;19;1
2018-04-23 06:30:00;NORTE;26;0;26;1
2018-04-23 07:00:00;NORTE;32;0;32;1
2018-04-23 07:30:00;NORTE;28;0;28;1
2018-04-23 08:00:00;NORTE;36;0;36;1
2018-04-23 08:30:00;NORTE;30;0;30;1
2018-04-23 09:00:00;NORTE;25;0;25;1
2018-04-23 09:30:00;NORTE;32;0;32;1
2018-04-23 10:00:00;NORTE;35;0;35;1
2018-04-23 10:30:00;NORTE;31;0;31;1
2018-04-23 11:00:00;NORTE;30;0;30;1
2018-04-23 11:30:36;NORTE;1;0;1;1
2018-04-23 11:31:18;NORTE;1;0;1;1
2018-04-23 11:31:45;NORTE;1;0;1;1
2018-04-23 11:33:13;NORTE;1;0;1;1
2018-04-23 11:34:45;NORTE;1;0;1;1
2018-04-23 11:35:58;NORTE;1;0;1;1
2018-04-23 11:37:14;NORTE;1;0;1;1
2018-04-23 11:39:05;NORTE;1;0;1;1
2018-04-23 11:41:37;NORTE;1;0;1;1
2018-04-23 11:43:16;NORTE;1;0;1;1
2018-04-23 11:43:52;NORTE;1;0;1;1
2018-04-23 11:44:48;NORTE;1;0;1;1
2018-04-23 11:45:26;NORTE;1;0;1;1
2018-04-23 11:47:40;NORTE;1;0;1;1
2018-04-23 11:48:13;NORTE;1;0;1;1
2018-04-23 11:50:25;NORTE;1;0;1;1
2018-04-23 11:51:03;NORTE;1;0;1;1
2018-04-23 11:53:53;NORTE;1;0;1;1
2018-04-23 11:55:06;NORTE;1;0;1;1
2018-04-23 11:55:38;NORTE;1;0;1;1
2018-04-23 11:56:10;NORTE;1;0;1;1
2018-04-23 11:57:55;NORTE;1;0;1;1
2018-04-23 12:00:00;NORTE;30;0;30;1
2018-04-23 12:30:00;NORTE;34;0;34;1
2018-04-23 13:00:00;NORTE;29;0;29;1
2018-04-23 13:30:00;NORTE;29;0;29;1
2018-04-23 14:00:00;NORTE;40;0;40;1
2018-04-23 14:30:00;NORTE;28;0;28;1
2018-04-23 15:00:00;NORTE;33;0;33;1
2018-04-23 15:30:00;NORTE;18;0;18;1
2018-04-23 16:00:00;NORTE;23;0;23;1
2018-04-23 16:30:00;NORTE;37;0;37;1
2018-04-23 17:00:00;NORTE;29;0;29;1
2018-04-23 17:30:00;NORTE;27;0;27;1
2018-04-23 18:00:00;NORTE;38;0;38;1
2018-04-23 18:30:00;NORTE;40;0;40;1
2018-04-23 19:00:00;NORTE;35;0;35;1
2018-04-23 19:30:00;NORTE;27;0;27;1
2018-04-23 20:00:30;NORTE;1;0;1;1
2018-04-23 20:01:32;NORTE;1;0;1;1
2018-04-23 20:01:54;NORTE;1;0;1;1
2018-04-23 20:01:56;NORTE;1;0;1;1
2018-04-23 20:03:48;NORTE;1;0;1;1
2018-04-23 20:05:23;NORTE;1;0;1;1
2018-04-23 20:05:43;NORTE;1;0;1;1
2018-04-23 20:06:27;NORTE;1;0;1;1
2018-04-23 20:07:42;NORTE;1;0;1;1
2018-04-23 20:10:33;NORTE;1;0;1;1
2018-04-23 20:12:57;NORTE;1;0;1;1
2018-04-23 20:16:36;NORTE;1;0;1;1
2018-04-23 20:17:09;NORTE;1;0;1;1
2018-04-23 20:17:26;NORTE;1;0;1;1
2018-04-23 20:17:36;NORTE;1;0;1;1
2018-04-23 20:18:33;NORTE;1;0;1;1
2018-04-23 20:19:01;NORTE;1;0;1;1
2018-04-23 20:19:47;NORTE;1;0;1;1
2018-04-23 20:20:12;NORTE;1;0;1;1
2018-04-23 20:20:40;NORTE;1;0;1;1
2018-04-23 20:21:34;NORTE;1;0;1;1
2018-04-23 20:22:19;NORTE;1;0;1;1
2018-04-23 20:22:53;NORTE;1;0;1;1
2018-04-23 20:23:07;NORTE;1;0;1;1
2018-04-23 20:24:40;NORTE;1;0;1;1
2018-04-23 20:25:24;NORTE;1;0;1;1
2018-04-23 20:25:31;NORTE;1;0;1;1
2018-04-23 20:26:51;NORTE;1;0;1;1
2018-04-23 20:27:12;NORTE;1;0;1;1
2018-04-23 20:30:08;NORTE;1;0;1;1
2018-04-23 20:30:38;NORTE;1;0;1;1
2018-04-23 20:31:08;NORTE;1;0;1;1
2018-04-23 20:32:51;NORTE;1;0;1;1
2018-04-23 20:33:09;NORTE;1;0;1;1
2018-04-23 20:34:10;NORTE;1;0;1;1
2018-04-23 20:36:08;NORTE;1;0;1;1
2018-04-23 20:37:50;NORTE;1;0;1;1
2018-04-23 20:38:24;NORTE;1;0;1;1
2018-04-23 20:39:55;NORTE;1;0;1;1
2018-04-23 20:41:05;NORTE;1;0;1;1
2018-04-23 20:41:27;NORTE;1;0;1;1
2018-04-23 20:43:21;NORTE;1;0;1;1
2018-04-23 20:43:59;NORTE;1;0;1;1
2018-04-23 20:44:45;NORTE;1;0;1;1
2018-04-23 20:48:46;NORTE;1;0;1;1
2018-04-23 20:50:37;NORTE;1;0;1;1
2018-04-23 20:52:27;NORTE;1;0;1;1
2018-04-23 20:54:00;NORTE;1;0;1;1
2018-04-23 20:55:52;NORTE;1;0;1;1
2018-04-23 20:56:34;NORTE;1;0;1;1
2018-04-23 20:57:45;NORTE;1;0;1;1
2018-04-23 21:00:38;NORTE;1;0;1;1
2018-04-23 21:03:10;NORTE;1;0;1;1
2018-04-23 21:03:20;NORTE;1;0;1;1
2018-04-23 21:05:03;NORTE;1;0;1;1
2018-04-23 21:07:30;NORTE;1;0;1;1
2018-04-23 21:10:02;NORTE;1;0;1;1
2018-04-23 21:10:37;NORTE;1;0;1;1
2018-04-23 21:12:10;NORTE;1;0;1;1
2018-04-23 21:17:14;NORTE;1;0;1;1
2018-04-23 21:19:55;NORTE;1;0;1;1
2018-04-23 21:22:35;NORTE;1;0;1;1
2018-04-23 21:28:45;NORTE;1;0;1;1
2018-04-23 21:35:20;NORTE;1;0;1;1
2018-04-23 21:36:44;NORTE;1;0;1;1
2018-04-23 21:39:33;NORTE;1;0;1;1
2018-04-23 21:41:25;NORTE;1;0;1;1
2018-04-23 21:43:28;NORTE;1;0;1;1
2018-04-23 21:45:38;NORTE;1;0;1;1
2018-04-23 21:47:49;NORTE;1;0;1;1
2018-04-23 21:51:10;NORTE;1;0;1;1
2018-04-23 21:55:15;NORTE;1;0;1;1
2018-04-23 22:00:52;NORTE;1;0;1;1
2018-04-23 22:02:00;NORTE;1;0;1;1
2018-04-23 22:03:09;NORTE;1;0;1;1
2018-04-23 22:05:37;NORTE;1;0;1;1
2018-04-23 22:07:03;NORTE;1;0;1;1
2018-04-23 22:07:15;NORTE;1;0;1;1
2018-04-23 22:09:38;NORTE;1;0;1;1
2018-04-23 22:10:10;NORTE;1;0;1;1
2018-04-23 22:12:33;NORTE;1;0;1;1
2018-04-23 22:14:53;NORTE;1;0;1;1
2018-04-23 22:18:06;NORTE;1;0;1;1
2018-04-23 22:20:50;NORTE;1;0;1;1
2018-04-23 22:22:28;NORTE;1;0;1;1
2018-04-23 22:26:38;NORTE;1;0;1;1
2018-04-23 22:29:55;NORTE;1;0;1;1
2018-04-23 22:30:00;NORTE;5;0;5;1
2018-04-23 23:00:00;NORTE;1;0;1;1
2018-04-24 00:00:00;NORTE;2;0;2;1
2018-04-24 01:00:00;NORTE;1;0;1;1
2018-04-24 01:30:00;NORTE;1;0;1;1
2018-04-24 02:00:00;NORTE;5;0;5;1
2018-04-24 02:30:00;NORTE;3;0;3;1
2018-04-24 03:00:00;NORTE;4;0;4;1
2018-04-24 03:30:00;NORTE;4;0;4;1
2018-04-24 04:00:00;NORTE;16;0;16;1
2018-04-24 04:30:00;NORTE;10;0;10;1
2018-04-24 05:00:00;NORTE;22;0;22;1
2018-04-24 05:30:00;NORTE;34;0;34;1
2018-04-24 06:00:00;NORTE;12;0;12;1
2018-04-24 06:30:00;NORTE;23;0;23;1
2018-04-24 07:00:00;NORTE;11;0;11;1
2018-04-24 07:30:00;NORTE;33;0;33;1
2018-04-24 08:00:00;NORTE;28;0;28;1
2018-04-24 08:30:00;NORTE;31;0;31;1
2018-04-24 09:00:00;NORTE;29;0;29;1
2018-04-24 09:30:00;NORTE;26;0;26;1
2018-04-24 10:00:00;NORTE;37;0;37;1
2018-04-24 10:30:00;NORTE;33;0;33;1
2018-04-24 11:00:00;NORTE;30;0;30;1
2018-04-24 11:30:00;NORTE;18;0;18;1
2018-04-24 12:00:00;NORTE;27;0;27;1
2018-04-24 12:30:00;NORTE;31;0;31;1
2018-04-24 13:00:00;NORTE;32;0;32;1
2018-04-24 13:30:00;NORTE;23;0;23;1
2018-04-24 14:00:00;NORTE;30;0;30;1
2018-04-24 14:30:00;NORTE;35;0;35;1
2018-04-24 15:00:00;NORTE;20;0;20;1
2018-04-24 15:30:00;NORTE;17;0;17;1
2018-04-24 16:00:00;NORTE;14;0;14;1
2018-04-24 16:30:00;NORTE;29;0;29;1
2018-04-24 17:00:00;NORTE;22;0;22;1
2018-04-24 17:30:00;NORTE;30;0;30;1
2018-04-24 18:00:00;NORTE;42;0;42;1
2018-04-24 18:30:00;NORTE;33;0;33;1
2018-04-24 19:00:00;NORTE;30;0;30;1
2018-04-24 19:30:00;NORTE;26;0;26;1
2018-04-24 20:00:00;NORTE;34;0;34;1
2018-04-24 20:30:00;NORTE;17;0;17;1
2018-04-24 21:00:00;NORTE;14;0;14;1
2018-04-24 21:30:00;NORTE;9;0;9;1
2018-04-24 22:00:00;NORTE;14;0;14;1
2018-04-24 22:30:00;NORTE;4;0;4;1
2018-04-24 23:00:00;NORTE;2;0;2;1
2018-04-24 23:30:00;NORTE;3;0;3;1
2018-04-25 00:00:00;NORTE;1;0;1;1
2018-04-25 00:30:00;NORTE;1;0;1;1
2018-04-25 01:30:00;NORTE;1;0;1;1
2018-04-25 02:00:00;NORTE;1;0;1;1
2018-04-25 02:30:00;NORTE;3;0;3;1
2018-04-25 03:00:00;NORTE;3;0;3;1
2018-04-25 03:30:00;NORTE;3;0;3;1
2018-04-25 04:00:00;NORTE;10;0;10;1
2018-04-25 04:30:00;NORTE;15;0;15;1
2018-04-25 05:00:00;NORTE;13;0;13;1
2018-04-25 05:30:00;NORTE;31;0;31;1
2018-04-25 06:00:00;NORTE;27;0;27;1
2018-04-25 06:30:00;NORTE;26;0;26;1
2018-04-25 07:00:00;NORTE;33;0;33;1
2018-04-25 07:30:00;NORTE;30;0;30;1
2018-04-25 08:00:00;NORTE;29;0;29;1
2018-04-25 08:30:00;NORTE;33;0;33;1
2018-04-25 09:00:00;NORTE;23;0;23;1
2018-04-25 09:30:00;NORTE;30;0;30;1
2018-04-25 10:00:00;NORTE;37;0;37;1
2018-04-25 10:30:00;NORTE;30;0;30;1
2018-04-25 11:00:00;NORTE;27;0;27;1
2018-04-25 11:30:00;NORTE;21;0;21;1
2018-04-25 12:00:00;NORTE;25;0;25;1
2018-04-25 12:30:00;NORTE;33;0;33;1
2018-04-25 13:00:00;NORTE;22;0;22;1
2018-04-25 13:30:00;NORTE;23;0;23;1
2018-04-25 14:00:00;NORTE;38;0;38;1
2018-04-25 14:30:00;NORTE;32;0;32;1
2018-04-25 15:00:00;NORTE;24;0;24;1
2018-04-25 15:30:00;NORTE;19;0;19;1
2018-04-25 16:00:00;NORTE;20;0;20;1
2018-04-25 16:30:00;NORTE;32;0;32;1
2018-04-25 17:00:00;NORTE;28;0;28;1
2018-04-25 17:30:00;NORTE;34;0;34;1
2018-04-25 18:00:00;NORTE;38;0;38;1
2018-04-25 18:30:00;NORTE;24;0;24;1
2018-04-25 19:00:00;SUR;0;32;32;1
2018-04-25 19:30:00;SUR;0;20;20;1
2018-04-25 20:00:00;SUR;0;39;39;1
2018-04-25 20:30:00;SUR;0;19;19;1
2018-04-25 21:00:00;SUR;0;14;14;1
2018-04-25 21:30:00;SUR;0;11;11;1
2018-04-25 22:00:00;CONFLICTIVA;7;3;10;2
2018-04-25 22:30:00;NORTE;6;0;6;1
2018-04-25 23:00:00;NORTE;2;0;2;1
2018-04-25 23:30:00;NORTE;1;0;1;1
2018-04-26 00:00:00;NORTE;2;0;2;1
2018-04-26 00:30:00;NORTE;2;0;2;1
2018-04-26 01:00:00;NORTE;3;0;3;1
2018-04-26 01:30:00;NORTE;2;0;2;1
2018-04-26 02:00:00;NORTE;1;0;1;1
2018-04-26 02:30:00;NORTE;4;0;4;1
2018-04-26 03:00:00;NORTE;3;0;3;1
2018-04-26 03:30:00;NORTE;3;0;3;1
2018-04-26 04:00:00;NORTE;12;0;12;1
2018-04-26 04:30:00;NORTE;16;0;16;1
2018-04-26 05:00:00;NORTE;18;0;18;1
2018-04-26 05:30:00;NORTE;43;0;43;1
2018-04-26 06:00:00;NORTE;20;0;20;1
2018-04-26 06:30:00;NORTE;23;0;23;1
2018-04-26 07:00:00;NORTE;31;0;31;1
2018-04-26 07:30:00;NORTE;31;0;31;1
2018-04-26 08:00:00;NORTE;36;0;36;1
2018-04-26 08:30:00;NORTE;34;0;34;1
2018-04-26 09:00:00;NORTE;22;0;22;1
2018-04-26 09:30:00;NORTE;37;0;37;1
2018-04-26 10:00:00;NORTE;35;0;35;1
2018-04-26 10:30:00;NORTE;30;0;30;1
2018-04-26 11:00:00;NORTE;29;0;29;1
2018-04-26 11:30:00;NORTE;24;0;24;1
2018-04-26 12:00:00;NORTE;23;0;23;1
2018-04-26 12:30:00;NORTE;28;0;28;1
2018-04-26 13:00:00;CONFLICTIVA;12;15;27;2
2018-04-26 13:30:00;SUR;0;35;35;1
2018-04-26 14:00:00;SUR;0;41;41;1
2018-04-26 14:30:00;SUR;0;35;35;1
2018-04-26 15:00:00;SUR;0;18;18;1
2018-04-26 15:30:00;SUR;0;21;21;1
2018-04-26 16:00:00;SUR;0;15;15;1
2018-04-26 16:30:00;SUR;0;29;29;1
2018-04-26 17:00:00;SUR;0;28;28;1
2018-04-26 17:30:00;SUR;0;26;26;1
2018-04-26 18:00:00;SUR;0;33;33;1
2018-04-26 18:30:00;SUR;0;25;25;1
2018-04-26 19:00:00;SUR;0;25;25;1
2018-04-26 19:30:00;SUR;0;29;29;1
2018-04-26 20:00:00;SUR;0;34;34;1
2018-04-26 20:30:00;SUR;0;19;19;1
2018-04-26 21:00:00;SUR;0;19;19;1
2018-04-26 21:30:00;SUR;0;19;19;1
2018-04-26 22:00:00;SUR;0;7;7;1
2018-04-26 22:30:00;SUR;0;5;5;1
2018-04-26 23:00:00;SUR;0;6;6;1
2018-04-27 01:00:00;SUR;0;2;2;1
2018-04-27 01:30:00;SUR;0;1;1;1
2018-04-27 02:00:00;SUR;0;2;2;1
2018-04-27 02:30:00;SUR;0;5;5;1
2018-04-27 03:00:00;SUR;0;3;3;1
2018-04-27 03:30:00;SUR;0;8;8;1
2018-04-27 04:00:00;SUR;0;10;10;1
2018-04-27 04:30:00;SUR;0;11;11;1
2018-04-27 05:00:00;SUR;0;16;16;1
2018-04-27 05:30:00;SUR;0;32;32;1
2018-04-27 06:00:00;SUR;0;22;22;1
2018-04-27 06:30:00;SUR;0;20;20;1
2018-04-27 07:00:00;SUR;0;31;31;1
2018-04-27 07:30:00;SUR;0;26;26;1
2018-04-27 08:00:00;SUR;0;37;37;1
2018-04-27 08:30:00;SUR;0;31;31;1
2018-04-27 09:00:00;SUR;0;22;22;1
2018-04-27 09:30:00;SUR;0;29;29;1
2018-04-27 10:00:00;SUR;0;30;30;1
2018-04-27 10:30:00;SUR;0;22;22;1
2018-04-27 11:00:00;SUR;0;27;27;1
2018-04-27 11:30:00;SUR;0;30;30;1
2018-04-27 12:00:00;SUR;0;25;25;1
2018-04-27 12:30:00;SUR;0;24;24;1
2018-04-27 13:00:00;SUR;0;29;29;1
2018-04-27 13:30:00;SUR;0;41;41;1
2018-04-27 14:00:00;SUR;0;37;37;1
2018-04-27 14:30:00;SUR;0;27;27;1
2018-04-27 15:00:00;SUR;0;27;27;1
2018-04-27 15:30:00;SUR;0;17;17;1
2018-04-27 16:00:00;SUR;0;12;12;1
2018-04-27 16:30:00;SUR;0;22;22;1
2018-04-27 17:00:00;SUR;0;31;31;1
2018-04-27 17:30:00;SUR;0;28;28;1
2018-04-27 18:00:00;SUR;0;34;34;1
2018-04-27 18:30:00;SUR;0;33;33;1
2018-04-27 19:00:00;SUR;0;37;37;1
2018-04-27 19:30:00;SUR;0;20;20;1
2018-04-27 20:00:00;SUR;0;31;31;1
2018-04-27 20:30:00;SUR;0;28;28;1
2018-04-27 21:00:00;SUR;0;12;12;1
2018-04-27 21:30:00;SUR;0;15;15;1
2018-04-27 22:00:00;SUR;0;14;14;1
2018-04-27 22:30:00;SUR;0;4;4;1
2018-04-27 23:00:00;SUR;0;3;3;1
2018-04-27 23:30:00;SUR;0;2;2;1
2018-04-28 00:30:00;SUR;0;1;1;1
2018-04-28 01:00:00;SUR;0;2;2;1
2018-04-28 02:00:00;SUR;0;2;2;1
2018-04-28 02:30:00;SUR;0;5;5;1
2018-04-28 03:30:00;SUR;0;4;4;1
2018-04-28 04:00:00;SUR;0;9;9;1
2018-04-28 04:30:00;SUR;0;10;10;1
2018-04-28 05:00:00;SUR;0;13;13;1
2018-04-28 05:30:00;SUR;0;27;27;1
2018-04-28 06:00:00;SUR;0;24;24;1
2018-04-28 06:30:00;SUR;0;21;21;1
2018-04-28 07:00:00;SUR;0;35;35;1
2018-04-28 07:30:00;SUR;0;20;20;1
2018-04-28 08:00:00;SUR;0;32;32;1
2018-04-28 08:30:00;SUR;0;32;32;1
2018-04-28 09:00:00;SUR;0;27;27;1
2018-04-28 09:30:00;SUR;0;25;25;1
2018-04-28 10:00:00;SUR;0;27;27;1
2018-04-28 10:30:00;SUR;0;31;31;1
2018-04-28 11:00:00;SUR;0;32;32;1
2018-04-28 11:30:00;SUR;0;16;16;1
2018-04-28 12:00:00;SUR;0;19;19;1
2018-04-28 12:30:00;SUR;0;26;26;1
2018-04-28 13:00:00;SUR;0;28;28;1
2018-04-28 13:30:00;SUR;0;29;29;1
2018-04-28 14:00:00;SUR;0;30;30;1
2018-04-28 14:30:00;SUR;0;28;28;1
2018-04-28 15:00:00;SUR;0;19;19;1
2018-04-28 15:30:00;SUR;0;22;22;1
2018-04-28 16:00:00;SUR;0;17;17;1
2018-04-28 16:30:00;SUR;0;20;20;1
2018-04-28 17:00:00;SUR;0;21;21;1
2018-04-28 17:30:00;SUR;0;21;21;1
2018-04-28 18:00:00;SUR;0;26;26;1
2018-04-28 18:30:00;SUR;0;29;29;1
2018-04-28 19:00:00;SUR;0;11;11;1
2018-04-28 19:30:00;SUR;0;18;18;1
2018-04-28 20:00:00;SUR;0;23;23;1
2018-04-28 20:30:00;SUR;0;19;19;1
2018-04-28 21:00:00;SUR;0;9;9;1
2018-04-28 21:30:00;SUR;0;17;17;1
2018-04-28 22:00:00;SUR;0;9;9;1
2018-04-28 22:30:00;SUR;0;11;11;1
2018-04-28 23:00:00;SUR;0;2;2;1
2018-04-29 01:00:00;SUR;0;3;3;1
2018-04-29 01:30:00;SUR;0;3;3;1
2018-04-29 02:00:00;SUR;0;2;2;1
2018-04-29 02:30:00;SUR;0;1;1;1
2018-04-29 03:00:00;SUR;0;2;2;1
2018-04-29 03:30:00;SUR;0;4;4;1
2018-04-29 04:00:00;SUR;0;5;5;1
2018-04-29 04:30:00;SUR;0;10;10;1
2018-04-29 05:00:00;SUR;0;8;8;1
2018-04-29 05:30:00;SUR;0;21;21;1
2018-04-29 06:00:00;SUR;0;17;17;1
2018-04-29 06:30:00;SUR;0;17;17;1
2018-04-29 07:00:00;SUR;0;26;26;1
2018-04-29 07:30:00;SUR;0;21;21;1
2018-04-29 08:00:00;SUR;0;28;28;1
2018-04-29 08:30:00;SUR;0;31;31;1
2018-04-29 09:00:00;SUR;0;21;21;1
2018-04-29 09:30:00;SUR;0;27;27;1
2018-04-29 10:00:00;SUR;0;26;26;1
2018-04-29 10:30:00;SUR;0;28;28;1
2018-04-29 11:00:00;SUR;0;28;28;1
2018-04-29 11:30:00;SUR;0;22;22;1
2018-04-29 12:00:00;SUR;0;24;24;1
2018-04-29 12:30:00;SUR;0;24;24;1
2018-04-29 13:00:00;SUR;0;28;28;1
2018-04-29 13:30:00;SUR;0;31;31;1
2018-04-29 14:00:00;SUR;0;34;34;1
2018-04-29 14:30:00;SUR;0;24;24;1
2018-04-29 15:00:00;SUR;0;23;23;1
2018-04-29 15:30:00;SUR;0;21;21;1
2018-04-29 16:00:00;SUR;0;22;22;1
2018-04-29 16:30:00;SUR;0;21;21;1
2018-04-29 17:00:00;SUR;0;21;21;1
2018-04-29 17:30:00;SUR;0;26;26;1
2018-04-29 18:00:00;SUR;0;25;25;1
2018-04-29 18:30:00;SUR;2;22;24;1
2018-04-29 19:00:00;NORTE;36;0;36;1
2018-04-29 19:30:00;NORTE;29;0;29;1
2018-04-29 20:00:00;NORTE;27;0;27;1
2018-04-29 20:30:00;NORTE;31;0;31;1
2018-04-29 21:00:00;NORTE;12;0;12;1
2018-04-29 21:30:00;NORTE;15;0;15;1
2018-04-29 22:00:00;NORTE;15;0;15;1
2018-04-29 22:30:00;NORTE;9;0;9;1
2018-04-29 23:00:00;NORTE;8;0;8;1
2018-04-29 23:30:00;NORTE;3;0;3;1
2018-04-30 00:00:00;NORTE;2;0;2;1
2018-04-30 00:30:00;NORTE;2;0;2;1
2018-04-30 01:00:00;NORTE;1;0;1;1
2018-04-30 01:30:00;NORTE;3;0;3;1
2018-04-30 02:00:00;NORTE;5;0;5;1
2018-04-30 03:00:00;NORTE;1;0;1;1
2018-04-30 03:30:00;NORTE;3;0;3;1
2018-04-30 04:00:00;NORTE;7;0;7;1
2018-04-30 04:30:00;NORTE;10;0;10;1
2018-04-30 05:00:00;NORTE;10;0;10;1
2018-04-30 05:30:00;NORTE;38;0;38;1
2018-04-30 06:00:00;NORTE;19;0;19;1
2018-04-30 06:30:00;NORTE;21;0;21;1
2018-04-30 07:00:00;NORTE;30;0;30;1
2018-04-30 07:30:00;NORTE;35;0;35;1
2018-04-30 08:00:00;CONFLICTIVA;16;11;27;2
2018-04-30 08:30:00;SUR;0;37;37;1
2018-04-30 09:00:00;SUR;0;23;23;1
2018-04-30 09:30:00;SUR;0;28;28;1
2018-04-30 10:00:00;SUR;0;34;34;1
2018-04-30 10:30:00;SUR;0;35;35;1
2018-04-30 11:00:00;SUR;0;30;30;1
2018-04-30 11:30:00;SUR;0;21;21;1
2018-04-30 12:00:00;CONFLICTIVA;8;11;19;2
2018-04-30 12:30:00;NORTE;36;0;36;1
2018-04-30 13:00:00;NORTE;35;0;35;1
2018-04-30 13:30:00;NORTE;6;0;6;1
2018-04-30 13:37:00;NORTE;23;0;23;1
2018-04-30 14:00:00;NORTE;34;0;34;1
2018-04-30 14:30:00;NORTE;30;0;30;1
2018-04-30 15:00:00;NORTE;25;0;25;1
2018-04-30 15:30:00;NORTE;29;0;29;1
2018-04-30 16:00:00;NORTE;24;0;24;1
2018-04-30 16:30:00;NORTE;35;0;35;1
2018-04-30 17:00:00;NORTE;28;0;28;1
2018-04-30 17:30:00;NORTE;28;0;28;1
2018-04-30 18:00:00;NORTE;38;0;38;1
2018-04-30 18:30:00;NORTE;37;0;37;1
2018-04-30 19:00:00;NORTE;28;0;28;1
2018-04-30 19:30:00;NORTE;28;0;28;1
2018-04-30 20:00:00;NORTE;30;0;30;1
2018-04-30 20:30:00;NORTE;20;0;20;1
2018-04-30 21:00:00;NORTE;15;0;15;1
2018-04-30 21:30:00;NORTE;14;0;14;1
2018-04-30 22:00:00;NORTE;11;0;11;1
2018-04-30 22:30:00;NORTE;8;0;8;1
2018-04-30 23:00:00;NORTE;2;0;2;1
2018-05-01 00:00:00;NORTE;1;0;1;1
2018-05-01 00:30:00;NORTE;2;0;2;1
2018-05-01 01:30:00;NORTE;2;0;2;1
2018-05-01 02:00:00;NORTE;4;0;4;1
2018-05-01 02:30:00;NORTE;2;0;2;1
2018-05-01 03:00:00;NORTE;3;0;3;1
2018-05-01 03:30:00;NORTE;7;0;7;1
2018-05-01 04:00:00;NORTE;8;0;8;1
2018-05-01 04:30:00;NORTE;15;0;15;1
2018-05-01 05:00:00;NORTE;17;0;17;1
2018-05-01 05:30:00;NORTE;28;0;28;1
2018-05-01 06:00:00;NORTE;15;0;15;1
2018-05-01 06:30:00;NORTE;24;0;24;1
2018-05-01 07:00:00;NORTE;40;0;40;1
2018-05-01 07:30:00;NORTE;27;0;27;1
2018-05-01 08:00:00;NORTE;32;0;32;1
2018-05-01 08:30:00;NORTE;36;0;36;1
2018-05-01 09:00:00;NORTE;28;0;28;1
2018-05-01 09:30:00;NORTE;31;0;31;1
2018-05-01 10:00:00;NORTE;32;0;32;1
2018-05-01 10:30:00;NORTE;40;0;40;1
2018-05-01 11:00:00;NORTE;29;0;29;1
2018-05-01 11:30:00;NORTE;27;0;27;1
2018-05-01 12:00:00;NORTE;25;0;25;1
2018-05-01 12:30:00;NORTE;30;0;30;1
2018-05-01 13:00:00;NORTE;36;0;36;1
2018-05-01 13:30:00;NORTE;28;0;28;1
2018-05-01 14:00:00;NORTE;40;0;40;1
2018-05-01 14:30:00;NORTE;39;0;39;1
2018-05-01 15:00:00;NORTE;23;0;23;1
2018-05-01 15:30:00;NORTE;23;0;23;1
2018-05-01 16:00:00;NORTE;19;0;19;1
2018-05-01 16:30:00;NORTE;30;0;30;1
2018-05-01 17:00:00;NORTE;26;0;26;1
2018-05-01 17:30:00;NORTE;21;0;21;1
2018-05-01 18:00:00;NORTE;38;0;38;1
2018-05-01 18:30:00;NORTE;26;0;26;1
2018-05-01 19:00:00;NORTE;34;0;34;1
2018-05-01 19:30:00;NORTE;28;0;28;1
2018-05-01 20:00:00;NORTE;26;0;26;1
2018-05-01 20:30:00;NORTE;19;0;19;1
2018-05-01 21:00:00;NORTE;13;0;13;1
2018-05-01 21:30:00;NORTE;11;0;11;1
2018-05-01 22:00:00;NORTE;12;0;12;1
2018-05-01 22:30:09;NORTE;1;0;1;1
2018-05-01 22:32:53;NORTE;1;0;1;1
2018-05-01 22:40:50;NORTE;1;0;1;1
2018-05-01 22:45:04;NORTE;1;0;1;1
2018-05-01 23:02:10;NORTE;1;0;1;1
2018-05-01 23:24:16;NORTE;1;0;1;1
2018-05-01 23:33:02;NORTE;1;0;1;1
2018-05-01 23:40:09;NORTE;1;0;1;1
2018-05-02 00:30:00;NORTE;5;0;5;1
2018-05-02 01:00:00;NORTE;1;0;1;1
2018-05-02 01:30:00;NORTE;1;0;1;1
2018-05-02 02:07:31;NORTE;1;0;1;1
2018-05-02 02:13:10;NORTE;1;0;1;1
2018-05-02 02:20:20;NORTE;1;0;1;1
2018-05-02 02:30:00;NORTE;1;0;1;1
2018-05-02 03:00:00;NORTE;3;0;3;1
2018-05-02 03:30:00;NORTE;6;0;6;1
2018-05-02 04:00:00;NORTE;10;0;10;1
2018-05-02 04:30:00;NORTE;13;0;13;1
2018-05-02 05:00:00;NORTE;11;0;11;1
2018-05-02 05:30:00;NORTE;39;0;39;1
2018-05-02 06:00:00;NORTE;23;0;23;1
2018-05-02 06:30:00;NORTE;23;0;23;1
2018-05-02 07:00:00;NORTE;36;0;36;1
2018-05-02 07:30:00;NORTE;27;0;27;1
2018-05-02 08:00:00;NORTE;36;0;36;1
2018-05-02 08:30:00;NORTE;37;0;37;1
2018-05-02 09:00:00;NORTE;31;0;31;1
2018-05-02 09:30:00;NORTE;37;0;37;1
2018-05-02 10:00:00;NORTE;35;0;35;1
2018-05-02 10:30:00;NORTE;29;0;29;1
2018-05-02 11:00:00;NORTE;33;0;33;1
2018-05-02 11:30:00;NORTE;25;0;25;1
2018-05-02 12:00:00;NORTE;24;0;24;1
2018-05-02 12:30:00;NORTE;26;0;26;1
2018-05-02 13:00:00;NORTE;37;0;37;1
2018-05-02 13:30:00;NORTE;30;0;30;1
2018-05-02 14:00:00;NORTE;34;0;34;1
2018-05-02 14:30:00;NORTE;32;0;32;1
2018-05-02 15:00:00;NORTE;19;0;19;1
2018-05-02 15:30:00;NORTE;19;0;19;1
2018-05-02 16:00:00;NORTE;26;0;26;1
2018-05-02 16:30:00;NORTE;32;0;32;1
2018-05-02 17:00:00;NORTE;27;0;27;1
2018-05-02 17:30:00;NORTE;33;0;33;1
2018-05-02 18:00:00;NORTE;42;0;42;1
2018-05-02 18:30:00;NORTE;37;0;37;1
2018-05-02 19:00:00;NORTE;29;0;29;1
2018-05-02 19:30:00;NORTE;19;0;19;1
2018-05-02 20:00:00;NORTE;35;0;35;1
2018-05-02 20:30:00;NORTE;22;0;22;1
2018-05-02 21:00:00;NORTE;11;0;11;1
2018-05-02 21:30:00;NORTE;12;0;12;1
2018-05-02 22:00:00;NORTE;14;0;14;1
2018-05-02 22:30:00;NORTE;3;0;3;1
2018-05-02 23:00:00;NORTE;1;0;1;1
2018-05-02 23:30:00;NORTE;1;0;1;1
2018-05-03 00:00:00;NORTE;1;0;1;1
2018-05-03 01:00:00;NORTE;2;0;2;1
2018-05-03 01:30:00;NORTE;1;0;1;1
2018-05-03 02:00:00;NORTE;6;0;6;1
2018-05-03 02:30:00;NORTE;2;0;2;1
2018-05-03 03:00:00;NORTE;1;0;1;1
2018-05-03 03:30:00;NORTE;4;0;4;1
2018-05-03 04:00:00;NORTE;7;0;7;1
2018-05-03 04:30:00;NORTE;16;0;16;1
2018-05-03 05:00:00;NORTE;18;0;18;1
2018-05-03 05:30:00;NORTE;38;0;38;1
2018-05-03 06:00:00;NORTE;25;0;25;1
2018-05-03 06:30:00;NORTE;25;0;25;1
2018-05-03 07:00:00;NORTE;33;0;33;1
2018-05-03 07:30:00;NORTE;18;0;18;1
2018-05-03 08:00:00;NORTE;33;0;33;1
2018-05-03 08:30:00;NORTE;35;0;35;1
2018-05-03 09:00:00;NORTE;20;0;20;1
2018-05-03 09:30:00;NORTE;36;0;36;1
2018-05-03 10:00:00;NORTE;33;0;33;1
2018-05-03 10:30:00;NORTE;35;0;35;1
2018-05-03 11:00:00;NORTE;25;0;25;1
2018-05-03 11:30:00;NORTE;20;0;20;1
2018-05-03 12:00:00;NORTE;33;0;33;1
2018-05-03 12:30:00;NORTE;28;0;28;1
2018-05-03 13:00:00;NORTE;33;0;33;1
2018-05-03 13:30:00;NORTE;30;0;30;1
2018-05-03 14:00:00;NORTE;34;0;34;1
2018-05-03 14:30:00;NORTE;36;0;36;1
2018-05-03 15:00:00;NORTE;13;0;13;1
2018-05-03 15:30:00;NORTE;18;0;18;1
2018-05-03 16:00:00;NORTE;22;0;22;1
2018-05-03 16:30:00;NORTE;29;0;29;1
2018-05-03 17:00:00;NORTE;20;0;20;1
2018-05-03 17:30:00;NORTE;33;0;33;1
2018-05-03 18:00:00;NORTE;36;0;36;1
2018-05-03 18:30:00;NORTE;38;0;38;1
2018-05-03 19:00:00;NORTE;31;0;31;1
2018-05-03 19:30:00;NORTE;23;0;23;1
2018-05-03 20:00:00;NORTE;38;0;38;1
2018-05-03 20:30:00;NORTE;21;0;21;1
2018-05-03 21:00:00;NORTE;16;0;16;1
2018-05-03 21:30:00;NORTE;9;0;9;1
2018-05-03 22:00:00;NORTE;13;0;13;1
2018-05-03 22:30:00;NORTE;6;0;6;1
2018-05-03 23:00:00;NORTE;4;0;4;1
2018-05-03 23:30:00;NORTE;2;0;2;1
2018-05-04 00:00:00;NORTE;1;0;1;1
2018-05-04 00:30:00;NORTE;1;0;1;1
2018-05-04 01:00:00;NORTE;3;0;3;1
2018-05-04 01:30:00;NORTE;1;0;1;1
2018-05-04 02:00:00;NORTE;4;0;4;1
2018-05-04 02:30:00;NORTE;2;0;2;1
2018-05-04 03:00:00;NORTE;3;0;3;1
2018-05-04 03:30:00;NORTE;5;0;5;1
2018-05-04 04:00:00;NORTE;9;0;9;1
2018-05-04 04:30:00;NORTE;13;0;13;1
2018-05-04 05:00:00;NORTE;16;0;16;1
2018-05-04 05:30:00;NORTE;30;0;30;1
2018-05-04 06:00:00;NORTE;26;0;26;1
2018-05-04 06:30:00;NORTE;29;0;29;1
2018-05-04 07:00:00;NORTE;37;0;37;1
2018-05-04 07:30:00;NORTE;25;0;25;1
2018-05-04 08:00:00;NORTE;39;0;39;1
2018-05-04 08:30:00;NORTE;30;0;30;1
2018-05-04 09:00:00;NORTE;29;0;29;1
2018-05-04 09:30:00;NORTE;34;0;34;1
2018-05-04 10:00:00;NORTE;38;0;38;1
2018-05-04 10:30:00;NORTE;35;0;35;1
2018-05-04 11:00:00;NORTE;35;0;35;1
2018-05-04 11:30:00;NORTE;25;0;25;1
2018-05-04 12:00:00;NORTE;25;0;25;1
2018-05-04 12:30:00;NORTE;32;0;32;1
2018-05-04 13:00:00;NORTE;42;0;42;1
2018-05-04 13:30:00;NORTE;32;0;32;1
2018-05-04 14:00:00;NORTE;36;0;36;1
2018-05-04 14:30:00;NORTE;38;0;38;1
2018-05-04 15:00:00;NORTE;21;0;21;1
2018-05-04 15:30:00;NORTE;18;0;18;1
2018-05-04 16:00:00;NORTE;23;0;23;1
2018-05-04 16:30:00;NORTE;28;0;28;1
2018-05-04 17:00:00;NORTE;27;0;27;1
2018-05-04 17:30:00;NORTE;30;0;30;1
2018-05-04 18:00:00;NORTE;32;0;32;1
2018-05-04 18:30:00;NORTE;37;0;37;1
2018-05-04 19:00:00;NORTE;27;0;27;1
2018-05-04 19:30:00;NORTE;26;0;26;1
2018-05-04 20:00:00;NORTE;33;0;33;1
2018-05-04 20:30:00;NORTE;17;0;17;1
2018-05-04 21:00:00;NORTE;15;0;15;1
2018-05-04 21:30:00;NORTE;11;0;11;1
2018-05-04 22:00:00;NORTE;11;0;11;1
2018-05-04 22:30:00;NORTE;6;0;6;1
2018-05-04 23:00:00;NORTE;5;0;5;1
2018-05-04 23:30:00;NORTE;1;0;1;1
2018-05-05 00:00:00;NORTE;1;0;1;1
2018-05-05 01:00:00;NORTE;1;0;1;1
2018-05-05 01:30:00;NORTE;2;0;2;1
2018-05-05 02:00:00;NORTE;1;0;1;1
2018-05-05 02:30:00;NORTE;4;0;4;1
2018-05-05 03:00:00;NORTE;2;0;2;1
2018-05-05 03:30:00;NORTE;3;0;3;1
2018-05-05 04:00:00;NORTE;11;0;11;1
2018-05-05 04:30:00;NORTE;11;0;11;1
2018-05-05 05:00:00;NORTE;12;0;12;1
2018-05-05 05:30:00;NORTE;30;0;30;1
2018-05-05 06:00:00;NORTE;26;0;26;1
2018-05-05 06:30:00;NORTE;20;0;20;1
2018-05-05 07:00:00;NORTE;34;0;34;1
2018-05-05 07:30:00;NORTE;29;0;29;1
2018-05-05 08:00:00;NORTE;34;0;34;1
2018-05-05 08:30:00;NORTE;33;0;33;1
2018-05-05 09:00:00;NORTE;16;0;16;1
2018-05-05 09:30:00;NORTE;33;0;33;1
2018-05-05 10:00:00;NORTE;29;0;29;1
2018-05-05 10:30:00;NORTE;31;0;31;1
2018-05-05 11:00:00;NORTE;30;0;30;1
2018-05-05 11:30:00;NORTE;18;0;18;1
2018-05-05 12:00:00;NORTE;21;0;21;1
2018-05-05 12:30:00;NORTE;28;0;28;1
2018-05-05 13:00:00;NORTE;22;0;22;1
2018-05-05 13:30:00;NORTE;21;0;21;1
2018-05-05 14:00:00;NORTE;43;0;43;1
2018-05-05 14:30:00;NORTE;30;0;30;1
2018-05-05 15:00:00;NORTE;18;0;18;1
2018-05-05 15:30:00;NORTE;20;0;20;1
2018-05-05 16:00:00;NORTE;23;0;23;1
2018-05-05 16:30:00;NORTE;30;0;30;1
2018-05-05 17:00:00;NORTE;13;0;13;1
2018-05-05 17:30:00;NORTE;23;0;23;1
2018-05-05 18:00:00;NORTE;28;0;28;1
2018-05-05 18:30:00;NORTE;27;0;27;1
2018-05-05 19:00:00;NORTE;20;0;20;1
2018-05-05 19:30:00;NORTE;23;0;23;1
2018-05-05 20:00:00;NORTE;21;0;21;1
2018-05-05 20:30:00;NORTE;7;0;7;1
2018-05-05 20:48:00;NORTE;1;0;1;1
2018-05-05 21:00:00;SUR;0;6;6;1
2018-05-05 21:17:00;SUR;0;5;5;1
2018-05-05 21:30:00;SUR;0;11;11;1
2018-05-05 22:00:00;SUR;0;13;13;1
2018-05-05 22:30:00;SUR;0;4;4;1
2018-05-05 23:00:00;SUR;0;7;7;1
2018-05-06 00:00:00;CONFLICTIVA;1;1;2;2
2018-05-06 00:30:00;NORTE;1;0;1;1
2018-05-06 01:00:00;NORTE;3;0;3;1
2018-05-06 01:30:00;NORTE;2;0;2;1
2018-05-06 02:00:00;NORTE;3;0;3;1
2018-05-06 02:30:00;NORTE;1;0;1;1
2018-05-06 03:30:00;NORTE;4;0;4;1
2018-05-06 04:00:00;NORTE;11;0;11;1
2018-05-06 04:30:00;NORTE;9;0;9;1
2018-05-06 05:00:00;NORTE;17;0;17;1
2018-05-06 05:30:00;NORTE;25;0;25;1
2018-05-06 06:00:00;NORTE;19;0;19;1
2018-05-06 06:30:00;NORTE;17;0;17;1
2018-05-06 07:00:00;NORTE;31;0;31;1
2018-05-06 07:30:00;NORTE;26;0;26;1
2018-05-06 08:00:00;NORTE;33;0;33;1
2018-05-06 08:30:00;NORTE;33;0;33;1
2018-05-06 09:00:00;NORTE;20;0;20;1
2018-05-06 09:30:00;NORTE;41;0;41;1
2018-05-06 10:00:00;NORTE;35;0;35;1
2018-05-06 10:30:00;NORTE;26;0;26;1
2018-05-06 11:00:00;NORTE;27;0;27;1
2018-05-06 11:30:00;NORTE;29;0;29;1
2018-05-06 12:00:00;NORTE;29;0;29;1
2018-05-06 12:30:00;NORTE;35;0;35;1
2018-05-06 13:00:00;NORTE;32;0;32;1
2018-05-06 13:30:00;NORTE;29;0;29;1
2018-05-06 14:00:00;NORTE;40;0;40;1
2018-05-06 14:30:00;NORTE;32;0;32;1
2018-05-06 15:00:00;NORTE;21;0;21;1
2018-05-06 15:30:00;NORTE;21;0;21;1
2018-05-06 16:00:00;NORTE;19;0;19;1
2018-05-06 16:30:00;NORTE;25;1;26;1
2018-05-06 17:00:00;NORTE;27;0;27;1
2018-05-06 17:30:00;NORTE;30;0;30;1
2018-05-06 18:00:00;NORTE;29;0;29;1
2018-05-06 18:30:00;NORTE;34;0;34;1
2018-05-06 19:00:00;CONFLICTIVA;9;16;25;2
2018-05-06 19:30:00;SUR;0;33;33;1
2018-05-06 20:00:00;SUR;0;33;33;1
2018-05-06 20:30:00;SUR;0;5;5;1
2018-05-06 20:35:00;SUR;0;24;24;1
2018-05-06 21:00:00;SUR;0;5;5;1
2018-05-06 21:16:00;SUR;0;11;11;1
2018-05-06 21:30:00;SUR;0;16;16;1
2018-05-06 22:00:00;SUR;0;16;16;1
2018-05-06 22:30:00;NORTE;10;0;10;1
2018-05-06 23:00:00;NORTE;9;0;9;1
2018-05-07 00:00:00;NORTE;1;0;1;1
2018-05-07 00:30:00;NORTE;3;0;3;1
2018-05-07 01:30:00;NORTE;1;0;1;1
2018-05-07 02:00:00;NORTE;3;0;3;1
2018-05-07 02:30:00;NORTE;3;0;3;1
2018-05-07 03:30:00;NORTE;6;0;6;1
2018-05-07 04:06:16;NORTE;1;0;1;1
2018-05-07 04:10:09;NORTE;1;0;1;1
2018-05-07 04:12:48;NORTE;1;0;1;1
2018-05-07 04:15:41;NORTE;1;0;1;1
2018-05-07 04:20:08;NORTE;1;0;1;1
2018-05-07 04:25:18;NORTE;1;0;1;1
2018-05-07 04:26:33;NORTE;1;0;1;1
2018-05-07 04:30:00;NORTE;11;0;11;1
2018-05-07 05:00:00;NORTE;20;0;20;1
2018-05-07 05:30:00;NORTE;36;0;36;1
2018-05-07 06:00:00;NORTE;26;0;26;1
2018-05-07 06:30:00;NORTE;29;0;29;1
2018-05-07 07:00:00;NORTE;26;0;26;1
2018-05-07 07:30:00;NORTE;27;0;27;1
2018-05-07 08:00:00;NORTE;40;0;40;1
2018-05-07 08:30:00;NORTE;37;0;37;1
2018-05-07 09:00:00;NORTE;24;0;24;1
2018-05-07 09:30:00;NORTE;33;0;33;1
2018-05-07 10:00:00;NORTE;34;0;34;1
2018-05-07 10:30:00;NORTE;30;0;30;1
2018-05-07 11:00:00;NORTE;32;0;32;1
2018-05-07 11:30:00;NORTE;25;0;25;1
2018-05-07 12:00:00;NORTE;23;0;23;1
2018-05-07 12:30:00;NORTE;38;0;38;1
2018-05-07 13:00:00;NORTE;36;0;36;1
2018-05-07 13:30:00;NORTE;31;0;31;1
2018-05-07 14:00:00;NORTE;35;0;35;1
2018-05-07 14:30:00;NORTE;30;0;30;1
2018-05-07 15:00:00;NORTE;29;0;29;1
2018-05-07 15:30:00;NORTE;24;0;24;1
2018-05-07 16:00:00;NORTE;19;0;19;1
2018-05-07 16:30:00;NORTE;34;0;34;1
2018-05-07 17:00:00;NORTE;27;0;27;1
2018-05-07 17:30:00;NORTE;30;0;30;1
2018-05-07 18:00:00;NORTE;28;0;28;1
2018-05-07 18:30:00;NORTE;4;0;4;1
2018-05-07 18:37:00;NORTE;19;1;20;1
2018-05-07 19:00:00;NORTE;32;0;32;1
2018-05-07 19:30:00;NORTE;31;0;31;1
2018-05-07 20:00:00;NORTE;29;0;29;1
2018-05-07 20:30:00;NORTE;33;0;33;1
2018-05-07 21:00:00;NORTE;19;0;19;1
2018-05-07 21:30:00;NORTE;16;0;16;1
2018-05-07 22:00:00;NORTE;12;0;12;1
2018-05-07 22:30:00;NORTE;6;0;6;1
2018-05-07 23:00:00;NORTE;2;0;2;1
2018-05-08 00:30:00;NORTE;2;0;2;1
2018-05-08 01:00:00;NORTE;1;0;1;1
2018-05-08 01:30:00;NORTE;2;0;2;1
2018-05-08 02:00:00;NORTE;3;0;3;1
2018-05-08 02:30:00;NORTE;4;0;4;1
2018-05-08 03:00:00;NORTE;3;0;3;1
2018-05-08 03:30:00;NORTE;10;0;10;1
2018-05-08 04:00:00;NORTE;11;0;11;1
2018-05-08 04:30:00;NORTE;9;0;9;1
2018-05-08 05:00:00;NORTE;26;0;26;1
2018-05-08 05:30:00;NORTE;38;0;38;1
2018-05-08 06:00:00;NORTE;12;0;12;1
2018-05-08 06:30:00;NORTE;24;0;24;1
2018-05-08 07:00:00;NORTE;23;0;23;1
2018-05-08 07:30:00;NORTE;29;0;29;1
2018-05-08 08:00:00;NORTE;22;0;22;1
2018-05-08 08:30:00;NORTE;33;0;33;1
2018-05-08 09:00:00;NORTE;29;0;29;1
2018-05-08 09:30:00;NORTE;35;0;35;1
2018-05-08 10:00:00;NORTE;34;0;34;1
2018-05-08 10:30:00;NORTE;29;0;29;1
2018-05-08 11:00:00;NORTE;32;0;32;1
2018-05-08 11:30:00;NORTE;26;0;26;1
2018-05-08 12:00:00;NORTE;25;0;25;1
2018-05-08 12:30:00;NORTE;27;0;27;1
2018-05-08 13:00:00;NORTE;29;0;29;1
2018-05-08 13:30:00;NORTE;21;0;21;1
2018-05-08 14:00:00;NORTE;18;0;18;1
2018-05-08 14:30:00;NORTE;23;0;23;1
2018-05-08 15:00:00;NORTE;30;0;30;1
2018-05-08 15:30:00;NORTE;30;0;30;1
2018-05-08 16:00:00;NORTE;34;0;34;1
2018-05-08 16:30:00;NORTE;20;0;20;1
2018-05-08 17:00:00;NORTE;25;0;25;1
2018-05-08 17:30:00;NORTE;34;0;34;1
2018-05-08 18:00:00;NORTE;33;0;33;1
2018-05-08 18:30:00;NORTE;31;0;31;1
2018-05-08 19:00:00;NORTE;33;0;33;1
2018-05-08 19:30:00;NORTE;23;0;23;1
2018-05-08 20:00:00;NORTE;33;0;33;1
2018-05-08 20:30:00;NORTE;29;0;29;1
2018-05-08 21:00:00;NORTE;22;0;22;1
2018-05-08 21:30:00;NORTE;11;0;11;1
2018-05-08 22:00:00;NORTE;14;0;14;1
2018-05-08 22:30:00;NORTE;3;0;3;1
2018-05-08 23:00:00;NORTE;1;0;1;1
2018-05-08 23:30:00;NORTE;1;0;1;1
2018-05-09 00:00:00;NORTE;1;0;1;1
2018-05-09 00:30:00;NORTE;1;0;1;1
2018-05-09 01:00:00;NORTE;1;0;1;1
2018-05-09 01:30:00;NORTE;1;0;1;1
2018-05-09 02:00:00;NORTE;1;0;1;1
2018-05-09 02:30:00;NORTE;4;0;4;1
2018-05-09 03:00:00;NORTE;4;0;4;1
2018-05-09 03:30:00;NORTE;6;0;6;1
2018-05-09 04:00:00;NORTE;13;0;13;1
2018-05-09 04:30:00;NORTE;10;0;10;1
2018-05-09 05:00:00;NORTE;21;0;21;1
2018-05-09 05:30:00;NORTE;32;0;32;1
2018-05-09 06:00:00;NORTE;19;0;19;1
2018-05-09 06:30:00;NORTE;26;0;26;1
2018-05-09 07:00:00;NORTE;39;0;39;1
2018-05-09 07:30:00;NORTE;26;0;26;1
2018-05-09 08:00:00;NORTE;36;0;36;1
2018-05-09 08:30:00;NORTE;36;0;36;1
2018-05-09 09:00:00;NORTE;29;0;29;1
2018-05-09 09:30:00;NORTE;32;0;32;1
2018-05-09 10:00:00;NORTE;35;0;35;1
2018-05-09 10:30:00;NORTE;38;0;38;1
2018-05-09 11:00:00;NORTE;34;0;34;1
2018-05-09 11:30:00;NORTE;25;0;25;1
2018-05-09 12:00:00;NORTE;21;0;21;1
2018-05-09 12:30:00;NORTE;35;0;35;1
2018-05-09 13:00:00;NORTE;32;0;32;1
2018-05-09 13:30:00;NORTE;23;0;23;1
2018-05-09 14:00:00;NORTE;41;0;41;1
2018-05-09 14:30:00;NORTE;32;0;32;1
2018-05-09 15:00:00;NORTE;23;0;23;1
2018-05-09 15:30:00;NORTE;14;0;14;1
2018-05-09 16:00:00;NORTE;25;0;25;1
2018-05-09 16:30:00;NORTE;28;0;28;1
2018-05-09 17:00:00;NORTE;27;0;27;1
2018-05-09 17:30:00;NORTE;28;0;28;1
2018-05-09 18:00:00;NORTE;46;0;46;1
2018-05-09 18:30:00;NORTE;34;0;34;1
2018-05-09 19:00:00;NORTE;32;0;32;1
2018-05-09 19:30:00;NORTE;20;0;20;1
2018-05-09 20:00:00;NORTE;33;0;33;1
2018-05-09 20:30:00;NORTE;22;0;22;1
2018-05-09 21:00:02;NORTE;1;0;1;1
2018-05-09 21:00:09;NORTE;1;0;1;1
2018-05-09 21:01:22;NORTE;1;0;1;1
2018-05-09 21:01:40;NORTE;1;0;1;1
2018-05-09 21:03:16;NORTE;1;0;1;1
2018-05-09 21:06:25;NORTE;1;0;1;1
2018-05-09 21:08:33;NORTE;1;0;1;1
2018-05-09 21:11:15;NORTE;1;0;1;1
2018-05-09 21:12:36;NORTE;1;0;1;1
2018-05-09 21:12:52;NORTE;1;0;1;1
2018-05-09 21:13:47;NORTE;1;0;1;1
2018-05-09 21:15:51;NORTE;1;0;1;1
2018-05-09 21:15:59;NORTE;1;0;1;1
2018-05-09 21:17:41;NORTE;1;0;1;1
2018-05-09 21:19:06;NORTE;1;0;1;1
2018-05-09 21:20:53;NORTE;1;0;1;1
2018-05-09 21:23:16;NORTE;1;0;1;1
2018-05-09 21:26:06;NORTE;1;0;1;1
2018-05-09 21:27:53;NORTE;1;0;1;1
2018-05-09 21:29:25;NORTE;1;0;1;1
2018-05-09 21:30:00;NORTE;11;0;11;1
2018-05-09 22:00:00;NORTE;10;0;10;1
2018-05-09 22:30:00;NORTE;2;0;2;1
2018-05-09 23:00:00;NORTE;5;0;5;1
2018-05-09 23:30:00;NORTE;6;0;6;1
2018-05-10 00:00:00;NORTE;1;0;1;1
2018-05-10 00:30:00;NORTE;1;0;1;1
2018-05-10 01:00:00;NORTE;2;0;2;1
2018-05-10 02:00:00;NORTE;2;0;2;1
2018-05-10 02:30:00;NORTE;3;0;3;1
2018-05-10 03:00:00;NORTE;3;0;3;1
2018-05-10 03:30:00;NORTE;8;0;8;1
2018-05-10 04:00:00;NORTE;9;0;9;1
2018-05-10 04:30:00;NORTE;16;0;16;1
2018-05-10 05:00:00;NORTE;20;0;20;1
2018-05-10 05:30:00;NORTE;39;0;39;1
2018-05-10 06:00:00;NORTE;18;0;18;1
2018-05-10 06:30:00;NORTE;26;0;26;1
2018-05-10 07:00:00;NORTE;22;1;23;1
2018-05-10 07:30:00;NORTE;28;0;28;1
2018-05-10 08:00:00;NORTE;38;0;38;1
2018-05-10 08:30:00;NORTE;34;0;34;1
2018-05-10 09:00:00;NORTE;26;0;26;1
2018-05-10 09:30:00;NORTE;36;0;36;1
2018-05-10 10:00:00;NORTE;40;0;40;1
2018-05-10 10:30:00;NORTE;16;0;16;1
2018-05-10 12:00:00;NORTE;21;0;21;1
2018-05-10 12:30:00;NORTE;29;0;29;1
2018-05-10 13:00:00;NORTE;36;0;36;1
2018-05-10 13:30:00;NORTE;28;0;28;1
2018-05-10 14:00:00;NORTE;37;0;37;1
2018-05-10 14:30:00;NORTE;34;0;34;1
2018-05-10 15:00:00;NORTE;16;1;17;1
2018-05-10 15:30:00;NORTE;21;0;21;1
2018-05-10 16:00:00;NORTE;17;0;17;1
2018-05-10 16:30:00;NORTE;32;0;32;1
2018-05-10 17:00:00;NORTE;27;0;27;1
2018-05-10 17:30:00;NORTE;34;0;34;1
2018-05-10 18:00:00;NORTE;30;0;30;1
2018-05-10 18:30:00;NORTE;33;0;33;1
2018-05-10 19:00:00;NORTE;22;0;22;1
2018-05-10 19:30:00;NORTE;18;0;18;1
2018-05-10 19:43:00;NORTE;15;0;15;1
2018-05-10 20:00:00;NORTE;36;0;36;1
2018-05-10 20:30:00;NORTE;22;0;22;1
2018-05-10 21:00:00;NORTE;14;0;14;1
2018-05-10 21:30:00;NORTE;13;0;13;1
2018-05-10 22:00:00;NORTE;14;0;14;1
2018-05-10 22:30:00;NORTE;3;0;3;1
2018-05-10 23:00:00;NORTE;4;0;4;1
2018-05-11 00:00:00;NORTE;1;0;1;1
2018-05-11 00:30:00;NORTE;1;0;1;1
2018-05-11 01:00:00;NORTE;2;0;2;1
2018-05-11 01:30:00;NORTE;2;0;2;1
2018-05-11 02:00:00;NORTE;4;0;4;1
2018-05-11 02:30:00;NORTE;2;0;2;1
2018-05-11 03:00:00;NORTE;2;0;2;1
2018-05-11 03:30:00;NORTE;6;0;6;1
2018-05-11 04:00:00;NORTE;14;0;14;1
2018-05-11 04:30:00;NORTE;13;0;13;1
2018-05-11 05:30:00;NORTE;34;0;34;1
2018-05-11 06:00:00;NORTE;25;0;25;1
2018-05-11 06:30:00;NORTE;31;0;31;1
2018-05-11 07:00:00;NORTE;34;0;34;1
2018-05-11 07:30:00;NORTE;26;0;26;1
2018-05-11 08:00:00;NORTE;39;0;39;1
2018-05-11 08:30:00;NORTE;35;0;35;1
2018-05-11 09:00:00;NORTE;22;0;22;1
2018-05-11 09:30:00;NORTE;32;0;32;1
2018-05-11 10:00:00;NORTE;35;0;35;1
2018-05-11 10:30:00;SUR;0;28;28;1
2018-05-11 11:00:00;SUR;0;31;31;1
2018-05-11 11:30:00;SUR;0;27;27;1
2018-05-11 12:00:00;SUR;0;24;24;1
2018-05-11 12:30:00;SUR;0;12;12;1
2018-05-11 13:00:00;SUR;0;32;32;1
2018-05-11 13:30:00;SUR;0;31;31;1
2018-05-11 14:00:00;SUR;0;33;33;1
2018-05-11 14:30:00;SUR;0;33;33;1
2018-05-11 15:00:00;SUR;0;31;31;1
2018-05-11 15:30:00;SUR;0;18;18;1
2018-05-11 16:00:00;SUR;0;21;21;1
2018-05-11 16:30:00;SUR;0;27;27;1
2018-05-11 17:00:00;SUR;0;27;27;1
2018-05-11 17:30:00;SUR;0;27;27;1
2018-05-11 18:00:00;SUR;0;32;32;1
2018-05-11 18:30:00;SUR;0;18;18;1
2018-05-11 19:00:00;SUR;0;33;33;1
2018-05-11 19:30:00;SUR;0;19;19;1
2018-05-11 20:00:00;SUR;0;28;28;1
2018-05-11 20:30:00;SUR;0;26;26;1
2018-05-11 21:00:00;SUR;0;12;12;1
2018-05-11 21:30:00;SUR;0;12;12;1
2018-05-11 22:00:00;SUR;0;11;11;1
2018-05-11 22:30:00;SUR;0;2;2;1
2018-05-11 23:00:00;SUR;0;2;2;1
2018-05-11 23:30:00;SUR;0;1;1;1
2018-05-12 00:00:00;SUR;0;1;1;1
2018-05-12 01:00:00;SUR;0;2;2;1
2018-05-12 01:30:00;SUR;0;1;1;1
2018-05-12 02:00:00;SUR;0;3;3;1
2018-05-12 02:30:00;SUR;0;4;4;1
2018-05-12 03:00:00;SUR;0;1;1;1
2018-05-12 03:30:00;SUR;0;4;4;1
2018-05-12 04:00:00;SUR;0;8;8;1
2018-05-12 04:30:00;SUR;0;15;15;1
2018-05-12 05:00:00;SUR;0;12;12;1
2018-05-12 05:30:00;SUR;0;26;26;1
2018-05-12 06:00:00;SUR;0;22;22;1
2018-05-12 06:30:00;SUR;0;22;22;1
2018-05-12 07:00:00;SUR;0;34;34;1
2018-05-12 07:30:00;SUR;0;20;20;1
2018-05-12 08:00:00;SUR;0;32;32;1
2018-05-12 08:30:00;SUR;0;36;36;1
2018-05-12 09:00:00;SUR;0;18;18;1
2018-05-12 09:30:00;CONFLICTIVA;22;4;26;2
2018-05-12 10:00:00;NORTE;34;0;34;1
2018-05-12 10:30:00;NORTE;35;0;35;1
2018-05-12 11:00:00;NORTE;24;0;24;1
2018-05-12 11:30:00;NORTE;22;0;22;1
2018-05-12 12:00:00;NORTE;23;0;23;1
2018-05-12 12:30:00;NORTE;36;0;36;1
2018-05-12 13:00:00;NORTE;26;0;26;1
2018-05-12 13:30:00;NORTE;32;0;32;1
2018-05-12 14:00:00;NORTE;35;0;35;1
2018-05-12 14:30:00;NORTE;23;0;23;1
2018-05-12 15:00:00;NORTE;14;0;14;1
2018-05-12 15:30:00;NORTE;20;0;20;1
2018-05-12 16:00:00;NORTE;21;0;21;1
2018-05-12 16:30:00;NORTE;24;0;24;1
2018-05-12 17:00:00;NORTE;18;0;18;1
2018-05-12 17:30:00;NORTE;21;0;21;1
2018-05-12 18:00:00;NORTE;32;0;32;1
2018-05-12 18:30:00;NORTE;27;0;27;1
2018-05-12 19:00:00;NORTE;20;0;20;1
2018-05-12 19:30:00;NORTE;22;0;22;1
2018-05-12 20:00:00;NORTE;23;0;23;1
2018-05-12 20:30:00;NORTE;16;0;16;1
2018-05-12 21:00:00;NORTE;13;0;13;1
2018-05-12 21:30:00;NORTE;8;0;8;1
2018-05-12 22:00:00;NORTE;15;0;15;1
2018-05-12 22:30:00;NORTE;6;0;6;1
2018-05-12 23:00:00;NORTE;6;0;6;1
2018-05-12 23:30:00;NORTE;1;0;1;1
2018-05-13 00:00:00;NORTE;3;0;3;1
2018-05-13 01:00:00;NORTE;3;0;3;1
2018-05-13 02:00:00;NORTE;2;0;2;1
2018-05-13 02:30:00;NORTE;2;0;2;1
2018-05-13 03:00:00;NORTE;2;0;2;1
2018-05-13 03:30:00;NORTE;3;0;3;1
2018-05-13 04:00:00;NORTE;9;0;9;1
2018-05-13 04:30:00;NORTE;9;0;9;1
2018-05-13 05:00:00;NORTE;12;0;12;1
2018-05-13 05:30:00;NORTE;25;0;25;1
2018-05-13 06:00:00;NORTE;18;0;18;1
2018-05-13 06:30:00;NORTE;20;0;20;1
2018-05-13 07:00:00;NORTE;31;0;31;1
2018-05-13 07:30:00;NORTE;26;0;26;1
2018-05-13 08:00:00;NORTE;30;0;30;1
2018-05-13 08:30:00;NORTE;33;0;33;1
2018-05-13 09:00:00;NORTE;19;0;19;1
2018-05-13 09:30:00;NORTE;30;0;30;1
2018-05-13 10:00:00;NORTE;38;0;38;1
2018-05-13 10:30:00;NORTE;32;0;32;1
2018-05-13 11:00:00;NORTE;28;0;28;1
2018-05-13 11:30:00;NORTE;31;0;31;1
2018-05-13 12:00:00;NORTE;24;0;24;1
2018-05-13 12:30:00;NORTE;25;0;25;1
2018-05-13 13:00:00;NORTE;31;0;31;1
2018-05-13 13:30:00;NORTE;31;0;31;1
2018-05-13 14:00:00;NORTE;38;0;38;1
2018-05-13 14:30:00;NORTE;33;0;33;1
2018-05-13 15:00:00;NORTE;29;0;29;1
2018-05-13 15:30:00;NORTE;22;0;22;1
2018-05-13 16:00:00;NORTE;18;0;18;1
2018-05-13 16:30:00;NORTE;35;0;35;1
2018-05-13 17:00:00;NORTE;19;0;19;1
2018-05-13 17:30:00;NORTE;26;0;26;1
2018-05-13 18:00:00;NORTE;31;0;31;1
2018-05-13 18:30:00;NORTE;30;0;30;1
2018-05-13 19:00:00;NORTE;26;0;26;1
2018-05-13 19:30:00;NORTE;25;0;25;1
2018-05-13 20:00:00;NORTE;32;0;32;1
2018-05-13 20:30:00;NORTE;33;0;33;1
2018-05-13 21:00:00;NORTE;18;0;18;1
2018-05-13 21:30:00;NORTE;16;0;16;1
2018-05-13 22:00:00;NORTE;10;0;10;1
2018-05-13 22:30:00;NORTE;13;0;13;1
2018-05-13 23:00:00;NORTE;8;0;8;1
2018-05-13 23:30:00;NORTE;1;0;1;1
2018-05-14 00:00:00;NORTE;5;0;5;1
2018-05-14 00:30:00;NORTE;1;0;1;1
2018-05-14 01:30:00;NORTE;1;0;1;1
2018-05-14 02:00:00;NORTE;3;0;3;1
2018-05-14 02:30:00;NORTE;2;0;2;1
2018-05-14 03:00:00;NORTE;3;0;3;1
2018-05-14 03:30:00;NORTE;3;0;3;1
2018-05-14 04:00:00;NORTE;11;0;11;1
2018-05-14 04:30:00;NORTE;9;0;9;1
2018-05-14 05:00:00;NORTE;14;0;14;1
2018-05-14 05:30:00;NORTE;39;0;39;1
2018-05-14 06:00:00;NORTE;22;0;22;1
2018-05-14 06:30:00;NORTE;25;0;25;1
2018-05-14 07:00:00;NORTE;30;0;30;1
2018-05-14 07:30:00;NORTE;28;0;28;1
2018-05-14 08:00:00;NORTE;34;0;34;1
2018-05-14 08:30:00;NORTE;34;0;34;1
2018-05-14 09:00:00;NORTE;24;0;24;1
2018-05-14 09:30:00;NORTE;31;0;31;1
2018-05-14 10:00:00;NORTE;36;0;36;1
2018-05-14 10:30:00;NORTE;27;0;27;1
2018-05-14 11:00:00;NORTE;29;0;29;1
2018-05-14 11:30:00;NORTE;29;0;29;1
2018-05-14 12:00:00;NORTE;26;0;26;1
2018-05-14 12:30:00;NORTE;35;0;35;1
2018-05-14 13:00:00;NORTE;37;0;37;1
2018-05-14 13:30:00;NORTE;29;0;29;1
2018-05-14 14:00:00;NORTE;27;0;27;1
2018-05-14 14:30:00;NORTE;33;0;33;1
2018-05-14 15:00:00;NORTE;27;0;27;1
2018-05-14 15:30:00;NORTE;20;0;20;1
2018-05-14 16:00:00;NORTE;24;0;24;1
2018-05-14 16:30:00;NORTE;29;0;29;1
2018-05-14 17:00:00;NORTE;23;0;23;1
2018-05-14 17:30:00;NORTE;22;0;22;1
2018-05-14 18:00:00;NORTE;37;0;37;1
2018-05-14 18:30:00;NORTE;33;0;33;1
2018-05-14 19:00:00;NORTE;29;0;29;1
2018-05-14 19:30:00;NORTE;25;0;25;1
2018-05-14 20:00:00;NORTE;25;0;25;1
2018-05-14 20:30:00;NORTE;22;0;22;1
2018-05-14 21:00:00;NORTE;16;0;16;1
2018-05-14 21:30:00;NORTE;14;0;14;1
2018-05-14 22:00:00;NORTE;12;0;12;1
2018-05-14 22:30:00;NORTE;2;0;2;1
2018-05-14 23:00:00;NORTE;1;0;1;1
2018-05-14 23:30:00;NORTE;2;0;2;1
2018-05-15 00:00:00;NORTE;1;0;1;1
2018-05-15 01:00:00;NORTE;1;0;1;1
2018-05-15 01:30:00;NORTE;1;0;1;1
2018-05-15 02:00:00;NORTE;3;0;3;1
2018-05-15 02:30:00;NORTE;4;0;4;1
2018-05-15 03:00:00;NORTE;2;0;2;1
2018-05-15 03:30:00;NORTE;4;0;4;1
2018-05-15 04:00:00;NORTE;14;0;14;1
2018-05-15 04:30:00;NORTE;14;0;14;1
2018-05-15 05:00:00;NORTE;15;0;15;1
2018-05-15 05:30:00;NORTE;27;0;27;1
2018-05-15 06:00:00;NORTE;19;0;19;1
2018-05-15 06:30:00;NORTE;16;0;16;1
2018-05-15 07:00:00;NORTE;39;0;39;1
2018-05-15 07:30:00;NORTE;23;0;23;1
2018-05-15 08:00:00;NORTE;28;0;28;1
2018-05-15 08:30:00;NORTE;38;0;38;1
2018-05-15 09:00:00;NORTE;21;0;21;1
2018-05-15 09:30:00;NORTE;31;0;31;1
2018-05-15 10:00:00;NORTE;39;0;39;1
2018-05-15 10:30:00;NORTE;38;0;38;1
2018-05-15 11:00:00;NORTE;32;0;32;1
2018-05-15 11:30:00;NORTE;28;0;28;1
2018-05-15 12:00:00;NORTE;27;0;27;1
2018-05-15 12:30:00;NORTE;29;0;29;1
2018-05-15 13:00:00;NORTE;37;0;37;1
2018-05-15 13:30:00;NORTE;31;0;31;1
2018-05-15 14:00:00;NORTE;35;0;35;1
2018-05-15 14:30:00;NORTE;34;0;34;1
2018-05-15 15:00:00;NORTE;19;0;19;1
2018-05-15 15:30:00;NORTE;18;0;18;1
2018-05-15 16:00:00;NORTE;23;0;23;1
2018-05-15 16:30:00;NORTE;24;0;24;1
2018-05-15 17:00:00;NORTE;24;0;24;1
2018-05-15 17:30:00;NORTE;29;0;29;1
2018-05-15 18:00:00;NORTE;40;0;40;1
2018-05-15 18:30:00;NORTE;34;0;34;1
2018-05-15 19:00:00;NORTE;31;0;31;1
2018-05-15 19:30:00;NORTE;27;0;27;1
2018-05-15 20:00:00;NORTE;29;0;29;1
2018-05-15 20:30:00;NORTE;23;0;23;1
2018-05-15 21:00:00;NORTE;14;0;14;1
2018-05-15 21:30:00;NORTE;16;0;16;1
2018-05-15 22:00:00;NORTE;7;0;7;1
2018-05-15 22:30:00;NORTE;2;0;2;1
2018-05-15 23:00:00;NORTE;3;0;3;1
2018-05-15 23:30:00;NORTE;1;0;1;1
2018-05-16 00:00:00;NORTE;1;0;1;1
2018-05-16 01:30:00;NORTE;1;0;1;1
2018-05-16 02:00:00;NORTE;1;0;1;1
2018-05-16 02:30:00;NORTE;3;0;3;1
2018-05-16 03:00:00;NORTE;1;0;1;1
2018-05-16 03:30:00;NORTE;4;0;4;1
2018-05-16 04:00:00;NORTE;11;0;11;1
2018-05-16 04:30:00;NORTE;19;0;19;1
2018-05-16 05:00:00;NORTE;17;0;17;1
2018-05-16 05:30:00;NORTE;41;0;41;1
2018-05-16 06:00:00;NORTE;29;0;29;1
2018-05-16 06:30:00;NORTE;24;0;24;1
2018-05-16 07:00:00;NORTE;32;0;32;1
2018-05-16 07:30:00;NORTE;24;0;24;1
2018-05-16 08:00:00;NORTE;24;0;24;1
2018-05-16 08:30:00;NORTE;36;0;36;1
2018-05-16 09:00:00;NORTE;26;0;26;1
2018-05-16 09:30:00;NORTE;35;0;35;1
2018-05-16 10:00:00;NORTE;34;0;34;1
2018-05-16 10:30:00;NORTE;41;0;41;1
2018-05-16 11:00:00;NORTE;29;0;29;1
2018-05-16 11:30:00;NORTE;27;0;27;1
2018-05-16 12:00:00;NORTE;25;0;25;1
2018-05-16 12:30:00;NORTE;21;0;21;1
2018-05-16 13:00:00;NORTE;36;0;36;1
2018-05-16 13:30:00;NORTE;26;0;26;1
2018-05-16 14:00:00;NORTE;34;0;34;1
2018-05-16 14:30:00;NORTE;32;0;32;1
2018-05-16 15:00:00;NORTE;28;0;28;1
2018-05-16 15:30:00;NORTE;18;0;18;1
2018-05-16 16:00:00;NORTE;26;0;26;1
2018-05-16 16:30:00;NORTE;31;0;31;1
2018-05-16 17:00:00;NORTE;18;0;18;1
2018-05-16 17:30:00;NORTE;27;0;27;1
2018-05-16 18:00:00;NORTE;43;1;44;1
2018-05-16 18:30:00;NORTE;37;0;37;1
2018-05-16 19:00:00;NORTE;25;0;25;1
2018-05-16 19:30:00;NORTE;25;0;25;1
2018-05-16 20:00:00;NORTE;34;0;34;1
2018-05-16 20:30:00;NORTE;25;0;25;1
2018-05-16 21:00:00;NORTE;15;0;15;1
2018-05-16 21:30:00;NORTE;9;0;9;1
2018-05-16 22:00:00;NORTE;16;0;16;1
2018-05-16 22:30:00;NORTE;4;0;4;1
2018-05-16 23:00:00;NORTE;2;0;2;1
2018-05-16 23:30:00;NORTE;2;0;2;1
2018-05-17 00:00:00;NORTE;1;0;1;1
2018-05-17 00:30:00;NORTE;1;0;1;1
2018-05-17 01:00:00;NORTE;1;0;1;1
2018-05-17 01:30:00;NORTE;3;0;3;1
2018-05-17 02:00:00;NORTE;7;0;7;1
2018-05-17 02:30:00;NORTE;6;0;6;1
2018-05-17 03:00:00;NORTE;5;0;5;1
2018-05-17 03:30:00;NORTE;8;0;8;1
2018-05-17 04:00:00;NORTE;11;0;11;1
2018-05-17 04:30:00;NORTE;13;0;13;1
2018-05-17 05:00:00;NORTE;17;0;17;1
2018-05-17 05:30:00;NORTE;33;0;33;1
2018-05-17 06:00:00;NORTE;27;0;27;1
2018-05-17 06:30:00;NORTE;28;0;28;1
2018-05-17 07:00:00;NORTE;29;0;29;1
2018-05-17 07:30:00;NORTE;35;0;35;1
2018-05-17 08:00:00;NORTE;33;0;33;1
2018-05-17 08:30:00;NORTE;31;0;31;1
2018-05-17 09:00:00;NORTE;32;0;32;1
2018-05-17 09:30:00;NORTE;27;1;28;1
2018-05-17 10:00:00;NORTE;35;0;35;1
2018-05-17 10:30:00;NORTE;26;0;26;1
2018-05-17 11:00:00;NORTE;32;0;32;1
2018-05-17 11:30:00;NORTE;20;0;20;1
2018-05-17 14:00:00;NORTE;24;0;24;1
2018-05-17 14:30:00;NORTE;33;0;33;1
2018-05-17 15:00:00;NORTE;15;0;15;1
2018-05-17 15:30:00;NORTE;17;0;17;1
2018-05-17 16:00:00;NORTE;22;0;22;1
2018-05-17 16:30:00;NORTE;29;0;29;1
2018-05-17 17:00:00;NORTE;27;0;27;1
2018-05-17 17:30:00;NORTE;26;0;26;1
2018-05-17 18:00:00;NORTE;33;0;33;1
2018-05-17 18:30:00;NORTE;35;0;35;1
2018-05-17 19:00:00;CONFLICTIVA;5;1;6;2
2018-05-17 21:00:00;NORTE;13;0;13;1
2018-05-17 21:30:00;NORTE;16;0;16;1
2018-05-17 22:00:00;NORTE;15;0;15;1
2018-05-17 22:30:00;NORTE;8;0;8;1
2018-05-17 23:00:00;NORTE;5;0;5;1
2018-05-17 23:30:00;NORTE;1;0;1;1
2018-05-18 00:00:00;NORTE;3;0;3;1
2018-05-18 00:30:00;NORTE;1;0;1;1
2018-05-18 01:00:00;NORTE;2;0;2;1
2018-05-18 01:30:00;NORTE;1;0;1;1
2018-05-18 02:00:00;NORTE;2;0;2;1
2018-05-18 02:30:00;NORTE;4;0;4;1
2018-05-18 03:00:00;NORTE;2;0;2;1
2018-05-18 03:30:00;NORTE;7;0;7;1
2018-05-18 04:00:00;NORTE;13;0;13;1
2018-05-18 04:30:00;NORTE;11;0;11;1
2018-05-18 05:00:00;NORTE;18;0;18;1
2018-05-18 05:30:00;NORTE;39;0;39;1
2018-05-18 06:00:00;NORTE;24;0;24;1
2018-05-18 06:30:00;NORTE;22;0;22;1
2018-05-18 07:00:00;NORTE;22;0;22;1
2018-05-18 07:30:00;NORTE;24;0;24;1
2018-05-18 08:00:00;NORTE;36;0;36;1
2018-05-18 08:30:00;NORTE;40;0;40;1
2018-05-18 09:00:00;NORTE;32;0;32;1
2018-05-18 09:30:00;NORTE;37;0;37;1
2018-05-18 10:00:00;NORTE;37;0;37;1
2018-05-18 10:30:00;NORTE;29;0;29;1
2018-05-18 11:00:00;NORTE;26;0;26;1
2018-05-18 11:30:00;NORTE;26;0;26;1
2018-05-18 12:00:00;SUR;1;22;23;1
2018-05-18 12:30:00;SUR;0;28;28;1
2018-05-18 13:00:00;SUR;0;34;34;1
2018-05-18 13:30:00;SUR;0;30;30;1
2018-05-18 14:00:00;SUR;0;32;32;1
2018-05-18 14:30:00;SUR;0;20;20;1
2018-05-18 14:48:00;SUR;0;11;11;1
2018-05-18 15:00:00;SUR;0;33;33;1
2018-05-18 15:30:00;SUR;0;26;26;1
2018-05-18 16:00:00;SUR;0;32;32;1
2018-05-18 16:30:00;SUR;0;16;16;1
2018-05-18 17:00:00;NORTE;29;0;29;1
2018-05-18 17:30:00;NORTE;30;1;31;1
2018-05-18 18:00:00;NORTE;33;0;33;1
2018-05-18 18:30:00;NORTE;35;0;35;1
2018-05-18 19:00:00;NORTE;31;1;32;1
2018-05-18 19:30:00;NORTE;33;0;33;1
2018-05-18 20:00:00;NORTE;34;0;34;1
2018-05-18 20:30:00;NORTE;25;0;25;1
2018-05-18 21:00:00;NORTE;12;0;12;1
2018-05-18 21:30:00;NORTE;15;0;15;1
2018-05-18 22:00:00;NORTE;11;0;11;1
2018-05-18 22:30:00;NORTE;10;0;10;1
2018-05-18 23:00:00;NORTE;2;0;2;1
2018-05-18 23:30:00;NORTE;2;0;2;1
2018-05-19 00:30:00;NORTE;1;0;1;1
2018-05-19 01:00:00;NORTE;2;0;2;1
2018-05-19 01:30:00;NORTE;1;0;1;1
2018-05-19 02:00:00;NORTE;2;0;2;1
2018-05-19 02:30:00;NORTE;5;0;5;1
2018-05-19 03:30:00;NORTE;3;0;3;1
2018-05-19 04:00:00;NORTE;12;0;12;1
2018-05-19 04:30:00;NORTE;13;0;13;1
2018-05-19 05:00:00;NORTE;17;0;17;1
2018-05-19 05:30:00;NORTE;33;0;33;1
2018-05-19 06:00:00;NORTE;18;0;18;1
2018-05-19 06:30:00;NORTE;27;0;27;1
2018-05-19 07:00:00;NORTE;36;0;36;1
2018-05-19 07:30:00;NORTE;25;0;25;1
2018-05-19 08:00:00;NORTE;38;0;38;1
2018-05-19 08:30:00;NORTE;30;0;30;1
2018-05-19 09:00:00;NORTE;16;0;16;1
2018-05-19 09:30:00;NORTE;35;0;35;1
2018-05-19 10:00:00;NORTE;26;0;26;1
2018-05-19 10:30:00;NORTE;33;0;33;1
2018-05-19 11:00:00;NORTE;26;0;26;1
2018-05-19 11:30:00;NORTE;17;0;17;1
2018-05-19 12:00:00;NORTE;29;0;29;1
2018-05-19 12:30:00;NORTE;27;0;27;1
2018-05-19 13:00:00;NORTE;25;0;25;1
2018-05-19 13:30:00;NORTE;25;0;25;1
2018-05-19 14:00:00;NORTE;28;0;28;1
2018-05-19 14:30:00;NORTE;37;0;37;1
2018-05-19 15:00:00;NORTE;27;0;27;1
2018-05-19 15:30:00;NORTE;17;0;17;1
2018-05-19 16:00:00;NORTE;19;0;19;1
2018-05-19 16:30:00;NORTE;21;0;21;1
2018-05-19 17:00:00;NORTE;20;0;20;1
2018-05-19 17:30:00;NORTE;21;0;21;1
2018-05-19 18:00:00;NORTE;35;0;35;1
2018-05-19 18:30:00;NORTE;27;0;27;1
2018-05-19 19:00:00;NORTE;16;0;16;1
2018-05-19 19:30:00;NORTE;23;0;23;1
2018-05-19 20:00:00;NORTE;16;0;16;1
2018-05-19 20:30:00;NORTE;9;0;9;1
2018-05-19 21:00:00;NORTE;15;0;15;1
2018-05-19 21:30:00;NORTE;12;0;12;1
2018-05-19 22:00:00;NORTE;14;0;14;1
2018-05-19 22:30:00;NORTE;3;0;3;1
2018-05-19 23:00:00;NORTE;2;0;2;1
2018-05-19 23:30:00;NORTE;3;0;3;1
2018-05-20 00:30:00;NORTE;1;0;1;1
2018-05-20 01:00:00;NORTE;3;0;3;1
2018-05-20 01:30:00;NORTE;1;0;1;1
2018-05-20 02:30:00;NORTE;2;0;2;1
2018-05-20 03:00:00;NORTE;1;0;1;1
2018-05-20 03:30:00;NORTE;3;0;3;1
2018-05-20 04:00:00;NORTE;6;0;6;1
2018-05-20 04:30:00;NORTE;12;0;12;1
2018-05-20 05:00:00;NORTE;13;0;13;1
2018-05-20 05:30:00;NORTE;27;0;27;1
2018-05-20 06:00:00;NORTE;19;0;19;1
2018-05-20 06:30:00;NORTE;22;0;22;1
2018-05-20 07:00:00;NORTE;30;0;30;1
2018-05-20 07:30:00;NORTE;27;0;27;1
2018-05-20 08:00:00;NORTE;36;0;36;1
2018-05-20 08:30:00;NORTE;38;0;38;1
2018-05-20 09:00:00;NORTE;15;0;15;1
2018-05-20 09:30:00;NORTE;34;0;34;1
2018-05-20 10:00:00;CONFLICTIVA;14;17;31;2
2018-05-20 10:30:00;SUR;0;31;31;1
2018-05-20 11:00:00;SUR;0;28;28;1
2018-05-20 11:30:00;SUR;0;27;27;1
2018-05-20 12:00:00;SUR;0;27;27;1
2018-05-20 12:30:00;SUR;0;29;29;1
2018-05-20 13:00:00;SUR;0;36;36;1
2018-05-20 13:30:00;SUR;0;36;36;1
2018-05-20 14:00:00;SUR;0;42;42;1
2018-05-20 14:30:00;SUR;0;31;31;1
2018-05-20 15:00:00;NORTE;23;1;24;1
2018-05-20 15:30:00;NORTE;20;0;20;1
2018-05-20 16:00:00;NORTE;20;0;20;1
2018-05-20 16:30:00;NORTE;27;0;27;1
2018-05-20 17:00:00;NORTE;24;0;24;1
2018-05-20 17:30:00;NORTE;21;0;21;1
2018-05-20 18:00:00;NORTE;37;0;37;1
2018-05-20 18:30:00;NORTE;33;0;33;1
2018-05-20 19:00:00;NORTE;19;0;19;1
2018-05-20 19:19:00;NORTE;14;0;14;1
2018-05-20 19:30:00;NORTE;32;0;32;1
2018-05-20 20:00:00;NORTE;28;0;28;1
2018-05-20 20:30:00;NORTE;34;0;34;1
2018-05-20 21:00:00;NORTE;13;0;13;1
2018-05-20 21:30:00;NORTE;13;0;13;1
2018-05-20 22:00:00;NORTE;12;0;12;1
2018-05-20 22:30:00;NORTE;10;0;10;1
2018-05-20 23:00:00;NORTE;1;0;1;1
2018-05-20 23:30:00;NORTE;2;0;2;1
2018-05-21 00:00:00;NORTE;3;0;3;1
2018-05-21 00:30:00;NORTE;1;0;1;1
2018-05-21 01:30:00;NORTE;1;0;1;1
2018-05-21 02:00:00;NORTE;3;0;3;1
2018-05-21 02:30:00;NORTE;4;0;4;1
2018-05-21 03:00:00;NORTE;2;0;2;1
2018-05-21 03:30:00;NORTE;1;0;1;1
2018-05-21 04:00:00;NORTE;11;0;11;1
2018-05-21 04:30:00;NORTE;14;0;14;1
2018-05-21 05:00:00;NORTE;14;0;14;1
2018-05-21 05:30:00;NORTE;39;0;39;1
2018-05-21 06:00:00;NORTE;22;0;22;1
2018-05-21 06:30:00;NORTE;30;0;30;1
2018-05-21 07:00:00;NORTE;35;0;35;1
2018-05-21 07:30:00;NORTE;27;0;27;1
2018-05-21 08:00:00;NORTE;34;0;34;1
2018-05-21 08:30:00;NORTE;33;0;33;1
2018-05-21 09:00:00;CONFLICTIVA;19;3;22;2
2018-05-21 09:30:00;SUR;0;27;27;1
2018-05-21 10:00:00;SUR;0;31;31;1
2018-05-21 10:30:00;SUR;0;28;28;1
2018-05-21 11:00:00;SUR;0;27;27;1
2018-05-21 11:30:00;SUR;0;18;18;1
2018-05-21 12:00:00;SUR;0;26;26;1
2018-05-21 12:30:00;SUR;0;33;33;1
2018-05-21 13:00:00;SUR;0;32;32;1
2018-05-21 13:30:00;SUR;0;33;33;1
2018-05-21 14:00:00;SUR;0;41;41;1
2018-05-21 14:30:00;SUR;0;34;34;1
2018-05-21 15:00:00;SUR;0;23;23;1
2018-05-21 15:30:00;CONFLICTIVA;16;2;18;2
2018-05-21 16:00:00;NORTE;31;0;31;1
2018-05-21 16:30:00;NORTE;21;0;21;1
2018-05-21 16:51:00;NORTE;8;0;8;1
2018-05-21 17:00:00;NORTE;16;1;17;1
2018-05-21 17:30:00;SUR;0;39;39;1
2018-05-21 18:00:00;CONFLICTIVA;4;18;22;2
2018-05-21 18:30:00;NORTE;42;0;42;1
2018-05-21 19:00:00;NORTE;29;0;29;1
2018-05-21 19:30:00;NORTE;4;0;4;1
2018-05-21 19:35:00;NORTE;23;0;23;1
2018-05-21 20:00:00;SUR;2;21;23;1
2018-05-21 20:30:00;SUR;0;33;33;1
2018-05-21 21:00:00;SUR;0;14;14;1
2018-05-21 21:30:00;SUR;0;12;12;1
2018-05-21 21:53:00;SUR;0;6;6;1
2018-05-21 22:00:00;SUR;0;14;14;1
2018-05-21 22:30:00;SUR;0;8;8;1
2018-05-21 23:00:00;SUR;0;1;1;1
2018-05-21 23:30:00;NORTE;1;0;1;1
2018-05-22 00:30:00;NORTE;1;0;1;1
2018-05-22 01:00:00;NORTE;1;0;1;1
2018-05-22 01:30:00;NORTE;2;0;2;1
2018-05-22 02:00:00;NORTE;5;0;5;1
2018-05-22 02:30:00;NORTE;2;0;2;1
2018-05-22 03:00:00;NORTE;5;0;5;1
2018-05-22 03:30:00;NORTE;5;0;5;1
2018-05-22 04:00:00;NORTE;12;0;12;1
2018-05-22 04:30:00;NORTE;12;0;12;1
2018-05-22 05:00:00;NORTE;15;0;15;1
2018-05-22 05:30:00;NORTE;25;0;25;1
2018-05-22 06:00:00;NORTE;33;0;33;1
2018-05-22 06:30:00;NORTE;19;0;19;1
2018-05-22 07:00:00;NORTE;30;0;30;1
2018-05-22 07:30:00;NORTE;26;0;26;1
2018-05-22 08:00:00;NORTE;28;0;28;1
2018-05-22 08:30:00;NORTE;29;0;29;1
2018-05-22 09:00:00;NORTE;26;0;26;1
2018-05-22 09:30:00;NORTE;25;0;25;1
2018-05-22 10:00:00;NORTE;30;0;30;1
2018-05-22 10:30:00;NORTE;35;0;35;1
2018-05-22 11:00:00;NORTE;32;0;32;1
2018-05-22 11:30:00;NORTE;18;0;18;1
2018-05-22 12:00:00;NORTE;23;0;23;1
2018-05-22 12:30:00;NORTE;28;0;28;1
2018-05-22 13:00:00;NORTE;24;0;24;1
2018-05-22 13:30:00;NORTE;21;0;21;1
2018-05-22 14:00:00;NORTE;29;0;29;1
2018-05-22 14:30:00;NORTE;32;0;32;1
2018-05-22 15:00:00;NORTE;30;0;30;1
2018-05-22 15:30:00;NORTE;21;0;21;1
2018-05-22 16:00:00;NORTE;23;0;23;1
2018-05-22 16:30:00;NORTE;25;0;25;1
2018-05-22 17:00:00;NORTE;16;0;16;1
2018-05-22 17:30:00;NORTE;27;0;27;1
2018-05-22 18:00:00;NORTE;29;0;29;1
2018-05-22 18:30:00;NORTE;25;0;25;1
2018-05-22 19:00:00;NORTE;21;0;21;1
2018-05-22 19:30:00;NORTE;23;0;23;1
2018-05-22 20:00:00;NORTE;25;0;25;1
2018-05-22 20:30:00;NORTE;27;0;27;1
2018-05-22 21:00:00;NORTE;10;0;10;1
2018-05-22 21:30:00;NORTE;16;0;16;1
2018-05-22 22:00:00;NORTE;18;0;18;1
2018-05-22 22:30:00;NORTE;9;0;9;1
2018-05-22 23:00:00;NORTE;5;0;5;1
2018-05-22 23:30:00;NORTE;4;0;4;1
2018-05-23 00:00:00;NORTE;2;0;2;1
2018-05-23 00:30:00;NORTE;4;0;4;1
2018-05-23 01:00:00;NORTE;1;0;1;1
2018-05-23 01:30:00;NORTE;1;0;1;1
2018-05-23 02:00:00;NORTE;2;0;2;1
2018-05-23 02:30:00;NORTE;3;0;3;1
2018-05-23 03:00:00;NORTE;4;0;4;1
2018-05-23 03:30:00;NORTE;3;0;3;1
2018-05-23 04:00:00;NORTE;10;0;10;1
2018-05-23 04:30:00;NORTE;18;0;18;1
2018-05-23 05:00:00;NORTE;13;0;13;1
2018-05-23 05:30:00;NORTE;38;0;38;1
2018-05-23 06:00:00;NORTE;20;0;20;1
2018-05-23 06:30:00;NORTE;23;0;23;1
2018-05-23 07:00:00;NORTE;33;0;33;1
2018-05-23 07:30:00;NORTE;27;0;27;1
2018-05-23 08:00:00;NORTE;32;0;32;1
2018-05-23 08:30:00;NORTE;29;0;29;1
2018-05-23 09:00:00;NORTE;34;0;34;1
2018-05-23 09:30:00;NORTE;28;0;28;1
2018-05-23 10:00:00;NORTE;28;0;28;1
2018-05-23 10:30:00;NORTE;36;0;36;1
2018-05-23 11:00:00;NORTE;29;0;29;1
2018-05-23 11:30:00;NORTE;21;0;21;1
2018-05-23 12:00:00;NORTE;23;0;23;1
2018-05-23 12:30:00;NORTE;33;0;33;1
2018-05-23 13:00:00;NORTE;21;0;21;1
2018-05-23 13:30:00;SUR;0;28;28;1
2018-05-23 14:00:00;SUR;0;34;34;1
2018-05-23 14:30:00;SUR;0;36;36;1
2018-05-23 15:00:00;SUR;0;25;25;1
2018-05-23 15:30:00;SUR;0;15;15;1
2018-05-23 16:00:00;SUR;0;23;23;1
2018-05-23 16:30:00;SUR;0;28;28;1
2018-05-23 17:00:00;SUR;0;21;21;1
2018-05-23 17:30:00;SUR;0;19;19;1
2018-05-23 17:56:00;SUR;0;4;4;1
2018-05-23 18:00:00;SUR;0;7;7;1
2018-05-23 18:09:00;SUR;0;20;20;1
2018-05-23 18:30:00;SUR;0;7;7;1
2018-05-23 18:37:00;SUR;0;14;14;1
2018-05-23 18:52:00;SUR;0;1;1;1
2018-05-23 19:00:00;CONFLICTIVA;20;8;28;2
2018-05-23 19:30:00;NORTE;38;0;38;1
2018-05-23 20:00:00;NORTE;28;0;28;1
2018-05-23 20:30:00;NORTE;27;0;27;1
2018-05-23 21:00:00;NORTE;15;0;15;1
2018-05-23 21:30:00;NORTE;16;0;16;1
2018-05-23 22:03:35;NORTE;1;0;1;1
2018-05-23 22:07:49;NORTE;1;0;1;1
2018-05-23 22:09:26;NORTE;1;0;1;1
2018-05-23 22:09:27;NORTE;1;0;1;1
2018-05-23 22:12:47;NORTE;1;0;1;1
2018-05-23 22:13:19;NORTE;1;0;1;1
2018-05-23 22:15:48;NORTE;1;0;1;1
2018-05-23 22:16:54;NORTE;1;0;1;1
2018-05-23 22:18:01;NORTE;1;0;1;1
2018-05-23 22:18:53;NORTE;1;0;1;1
2018-05-23 22:21:02;NORTE;1;0;1;1
2018-05-23 22:23:20;NORTE;1;0;1;1
2018-05-23 22:23:31;NORTE;1;0;1;1
2018-05-23 22:26:47;NORTE;1;0;1;1
2018-05-23 22:30:00;NORTE;4;0;4;1
2018-05-23 23:00:00;NORTE;4;0;4;1
2018-05-23 23:30:00;NORTE;2;0;2;1
2018-05-24 00:00:00;NORTE;2;0;2;1
2018-05-24 01:00:00;NORTE;3;0;3;1
2018-05-24 02:00:00;NORTE;1;0;1;1
2018-05-24 02:30:00;NORTE;3;0;3;1
2018-05-24 03:18:16;NORTE;1;0;1;1
2018-05-24 03:23:52;NORTE;1;0;1;1
2018-05-24 03:27:19;NORTE;1;0;1;1
2018-05-24 03:30:00;NORTE;5;0;5;1
2018-05-24 04:00:00;NORTE;10;0;10;1
2018-05-24 04:30:00;NORTE;13;0;13;1
2018-05-24 05:00:00;NORTE;20;0;20;1
2018-05-24 05:30:00;NORTE;35;0;35;1
2018-05-24 06:00:00;NORTE;28;0;28;1
2018-05-24 06:30:00;NORTE;28;0;28;1
2018-05-24 07:00:00;NORTE;31;0;31;1
2018-05-24 07:30:00;NORTE;28;0;28;1
2018-05-24 08:00:00;NORTE;36;0;36;1
2018-05-24 08:30:00;NORTE;34;0;34;1
2018-05-24 09:00:00;NORTE;24;0;24;1
2018-05-24 09:30:00;NORTE;28;0;28;1
2018-05-24 10:00:00;NORTE;36;0;36;1
2018-05-24 10:30:00;NORTE;32;0;32;1
2018-05-24 11:00:00;NORTE;24;0;24;1
2018-05-24 11:30:00;NORTE;24;0;24;1
2018-05-24 12:00:00;NORTE;28;0;28;1
2018-05-24 12:30:00;NORTE;35;0;35;1
2018-05-24 13:00:00;NORTE;30;0;30;1
2018-05-24 13:30:00;NORTE;35;0;35;1
2018-05-24 14:00:00;NORTE;32;0;32;1
2018-05-24 14:30:00;NORTE;33;0;33;1
2018-05-24 15:00:00;NORTE;18;0;18;1
2018-05-24 15:30:00;NORTE;26;1;27;1
2018-05-24 16:00:00;NORTE;17;0;17;1
2018-05-24 16:30:00;CONFLICTIVA;4;12;16;2
2018-05-24 17:00:00;SUR;0;31;31;1
2018-05-24 17:30:00;SUR;0;27;27;1
2018-05-24 18:00:00;SUR;0;33;33;1
2018-05-24 18:30:00;SUR;0;37;37;1
2018-05-24 19:00:00;SUR;0;24;24;1
2018-05-24 19:30:00;SUR;0;18;18;1
2018-05-24 20:00:00;SUR;0;34;34;1
2018-05-24 20:30:00;SUR;0;24;24;1
2018-05-24 21:00:00;SUR;0;19;19;1
2018-05-24 21:30:00;SUR;0;23;23;1
2018-05-24 22:00:00;SUR;0;12;12;1
2018-05-24 22:30:00;SUR;0;5;5;1
2018-05-24 23:00:00;SUR;0;9;9;1
2018-05-24 23:30:00;SUR;0;2;2;1
2018-05-25 00:00:00;SUR;0;1;1;1
2018-05-25 00:30:00;NORTE;1;0;1;1
2018-05-25 01:42:00;NORTE;1;0;1;1
2018-05-25 02:30:00;NORTE;5;0;5;1
2018-05-25 03:00:00;NORTE;1;0;1;1
2018-05-25 03:30:00;NORTE;6;0;6;1
2018-05-25 04:00:00;NORTE;9;0;9;1
2018-05-25 04:30:00;NORTE;5;0;5;1
2018-05-25 04:50:00;NORTE;6;0;6;1
2018-05-25 05:00:00;NORTE;9;0;9;1
2018-05-25 05:30:00;NORTE;13;0;13;1
2018-05-25 05:47:00;NORTE;8;0;8;1
2018-05-25 06:00:00;NORTE;7;0;7;1
2018-05-25 06:14:00;NORTE;12;0;12;1
2018-05-25 06:30:00;NORTE;12;0;12;1
2018-05-25 06:46:00;NORTE;17;0;17;1
2018-05-25 07:00:00;NORTE;39;0;39;1
2018-05-25 07:30:00;NORTE;31;0;31;1
2018-05-25 08:00:00;NORTE;37;0;37;1
2018-05-25 08:30:00;NORTE;33;0;33;1
2018-05-25 09:00:00;NORTE;30;0;30;1
2018-05-25 09:30:00;NORTE;33;1;34;1
2018-05-25 10:00:00;NORTE;34;0;34;1
2018-05-25 10:30:00;NORTE;28;0;28;1
2018-05-25 11:00:00;NORTE;36;0;36;1
2018-05-25 11:30:00;NORTE;22;0;22;1
2018-05-25 12:00:00;NORTE;22;0;22;1
2018-05-25 12:30:00;NORTE;29;0;29;1
2018-05-25 13:00:00;NORTE;31;0;31;1
2018-05-25 13:30:00;NORTE;39;0;39;1
2018-05-25 14:00:00;NORTE;34;0;34;1
2018-05-25 14:30:00;NORTE;29;0;29;1
2018-05-25 15:00:00;NORTE;32;0;32;1
2018-05-25 15:30:00;NORTE;33;0;33;1
2018-05-25 16:00:00;NORTE;26;0;26;1
2018-05-25 16:30:00;NORTE;24;0;24;1
2018-05-25 17:00:00;NORTE;23;0;23;1
2018-05-25 17:30:00;NORTE;33;0;33;1
2018-05-25 18:00:00;NORTE;34;0;34;1
2018-05-25 18:30:00;NORTE;32;0;32;1
2018-05-25 19:00:00;NORTE;23;0;23;1
2018-05-25 19:20:00;NORTE;13;0;13;1
2018-05-25 19:30:00;NORTE;5;0;5;1
2018-05-25 19:36:00;NORTE;20;0;20;1
2018-05-25 20:00:00;NORTE;30;0;30;1
2018-05-25 20:30:00;NORTE;29;0;29;1
2018-05-25 21:00:00;NORTE;17;0;17;1
2018-05-25 21:30:00;NORTE;17;0;17;1
2018-05-25 22:00:00;NORTE;19;0;19;1
2018-05-25 22:30:00;NORTE;13;0;13;1
2018-05-25 23:00:00;NORTE;8;0;8;1
2018-05-25 23:30:00;NORTE;2;0;2;1
2018-05-26 00:00:00;NORTE;3;0;3;1
2018-05-26 00:30:00;NORTE;1;0;1;1
2018-05-26 01:00:00;NORTE;2;0;2;1
2018-05-26 01:30:00;NORTE;4;0;4;1
2018-05-26 02:00:00;NORTE;4;0;4;1
2018-05-26 02:30:00;NORTE;4;0;4;1
2018-05-26 03:00:00;NORTE;3;0;3;1
2018-05-26 03:30:00;NORTE;2;0;2;1
2018-05-26 04:00:00;NORTE;8;0;8;1
2018-05-26 04:30:00;NORTE;19;0;19;1
2018-05-26 05:00:00;NORTE;16;0;16;1
2018-05-26 05:30:00;NORTE;30;0;30;1
2018-05-26 06:00:00;NORTE;22;0;22;1
2018-05-26 06:30:00;NORTE;24;0;24;1
2018-05-26 07:00:00;NORTE;37;0;37;1
2018-05-26 07:30:00;NORTE;27;0;27;1
2018-05-26 08:00:00;NORTE;38;0;38;1
2018-05-26 08:30:00;NORTE;30;1;31;1
2018-05-26 09:00:00;NORTE;24;0;24;1
2018-05-26 09:30:00;NORTE;25;0;25;1
2018-05-26 10:00:00;NORTE;32;0;32;1
2018-05-26 10:30:00;NORTE;31;0;31;1
2018-05-26 11:00:00;SUR;1;18;19;1
2018-05-26 11:30:00;SUR;0;18;18;1
2018-05-26 12:00:00;SUR;0;26;26;1
2018-05-26 12:30:00;SUR;1;28;29;1
2018-05-26 13:00:00;SUR;0;24;24;1
2018-05-26 13:30:00;SUR;0;33;33;1
2018-05-26 14:00:00;SUR;0;34;34;1
2018-05-26 14:30:00;SUR;0;25;25;1
2018-05-26 15:00:00;SUR;0;20;20;1
2018-05-26 15:30:00;SUR;0;21;21;1
2018-05-26 16:00:00;SUR;0;16;16;1
2018-05-26 16:30:00;SUR;0;19;19;1
2018-05-26 17:00:00;SUR;0;17;17;1
2018-05-26 17:30:00;SUR;0;20;20;1
2018-05-26 18:00:00;SUR;0;25;25;1
2018-05-26 18:30:00;CONFLICTIVA;16;5;21;2
2018-05-26 19:00:00;NORTE;22;0;22;1
2018-05-26 19:30:00;NORTE;26;0;26;1
2018-05-26 20:00:00;NORTE;21;0;21;1
2018-05-26 20:30:00;NORTE;13;0;13;1
2018-05-26 21:00:00;NORTE;13;0;13;1
2018-05-26 21:30:00;NORTE;14;0;14;1
2018-05-26 22:00:00;NORTE;13;0;13;1
2018-05-26 22:30:00;NORTE;8;0;8;1
2018-05-26 23:00:00;NORTE;6;0;6;1
2018-05-26 23:30:00;NORTE;1;0;1;1
2018-05-27 00:00:00;NORTE;3;0;3;1
2018-05-27 00:30:00;NORTE;1;0;1;1
2018-05-27 01:00:00;NORTE;6;0;6;1
2018-05-27 02:30:00;NORTE;3;0;3;1
2018-05-27 03:00:00;NORTE;2;0;2;1
2018-05-27 03:30:00;NORTE;3;0;3;1
2018-05-27 04:00:00;NORTE;9;0;9;1
2018-05-27 04:30:00;NORTE;5;0;5;1
2018-05-27 05:00:00;NORTE;20;0;20;1
2018-05-27 05:30:00;NORTE;29;0;29;1
2018-05-27 06:00:00;NORTE;21;0;21;1
2018-05-27 06:30:00;NORTE;25;0;25;1
2018-05-27 07:00:00;NORTE;32;0;32;1
2018-05-27 07:30:00;NORTE;29;0;29;1
2018-05-27 08:00:00;NORTE;33;0;33;1
2018-05-27 08:30:00;NORTE;41;0;41;1
2018-05-27 09:00:00;NORTE;22;0;22;1
2018-05-27 09:30:00;NORTE;31;0;31;1
2018-05-27 10:00:00;NORTE;31;0;31;1
2018-05-27 10:30:00;NORTE;27;0;27;1
2018-05-27 11:00:00;NORTE;33;0;33;1
2018-05-27 11:30:00;NORTE;25;0;25;1
2018-05-27 12:00:00;NORTE;25;0;25;1
2018-05-27 12:30:00;NORTE;29;0;29;1
2018-05-27 13:00:00;NORTE;36;0;36;1
2018-05-27 13:30:00;NORTE;38;0;38;1
2018-05-27 14:00:00;NORTE;34;0;34;1
2018-05-27 14:30:00;NORTE;33;0;33;1
2018-05-27 15:00:00;NORTE;32;0;32;1
2018-05-27 15:30:00;NORTE;21;0;21;1
2018-05-27 16:00:00;NORTE;20;0;20;1
2018-05-27 16:30:00;NORTE;30;0;30;1
2018-05-27 17:00:00;NORTE;19;0;19;1
2018-05-27 17:30:00;NORTE;29;0;29;1
2018-05-27 18:00:00;NORTE;8;0;8;1
2018-05-27 18:15:00;NORTE;2;0;2;1
2018-05-27 18:19:00;NORTE;9;0;9;1
2018-05-27 18:30:00;NORTE;24;0;24;1
2018-05-27 19:00:00;CONFLICTIVA;1;6;7;2
2018-05-27 19:30:00;SUR;0;24;24;1
2018-05-27 20:00:00;SUR;0;30;30;1
2018-05-27 20:30:00;SUR;0;29;29;1
2018-05-27 21:00:00;SUR;0;30;30;1
2018-05-27 21:30:00;SUR;0;19;19;1
2018-05-27 22:00:00;CONFLICTIVA;8;5;13;2
2018-05-27 22:30:00;NORTE;18;0;18;1
2018-05-27 23:00:00;NORTE;16;0;16;1
2018-05-27 23:30:00;NORTE;6;0;6;1
2018-05-28 00:00:00;NORTE;4;0;4;1
2018-05-28 00:30:00;NORTE;3;0;3;1
2018-05-28 01:00:00;NORTE;3;0;3;1
2018-05-28 01:30:00;NORTE;3;0;3;1
2018-05-28 02:30:00;NORTE;7;0;7;1
2018-05-28 03:30:00;NORTE;4;0;4;1
2018-05-28 04:00:00;NORTE;6;0;6;1
2018-05-28 04:30:00;NORTE;16;0;16;1
2018-05-28 05:00:00;NORTE;17;0;17;1
2018-05-28 05:30:00;NORTE;39;0;39;1
2018-05-28 06:00:00;NORTE;22;0;22;1
2018-05-28 06:30:00;NORTE;24;0;24;1
2018-05-28 07:00:00;NORTE;38;0;38;1
2018-05-28 07:30:00;NORTE;25;0;25;1
2018-05-28 08:00:00;NORTE;33;0;33;1
2018-05-28 08:30:00;NORTE;30;0;30;1
2018-05-28 09:00:00;NORTE;28;0;28;1
2018-05-28 09:30:00;NORTE;25;0;25;1
2018-05-28 10:00:00;NORTE;34;0;34;1
2018-05-28 10:30:00;NORTE;34;0;34;1
2018-05-28 11:00:00;NORTE;29;0;29;1
2018-05-28 11:30:00;NORTE;23;0;23;1
2018-05-28 12:00:00;NORTE;24;0;24;1
2018-05-28 12:30:00;NORTE;28;0;28;1
2018-05-28 13:00:00;NORTE;38;0;38;1
2018-05-28 13:30:00;NORTE;33;0;33;1
2018-05-28 14:00:00;CONFLICTIVA;8;18;26;2
2018-05-28 14:30:00;SUR;0;29;29;1
2018-05-28 15:00:00;SUR;0;28;28;1
2018-05-28 15:30:00;SUR;0;18;18;1
2018-05-28 15:52:00;CONFLICTIVA;3;1;4;2
2018-05-28 16:00:00;NORTE;20;0;20;1
2018-05-28 16:17:00;NORTE;13;0;13;1
2018-05-28 16:30:00;NORTE;26;0;26;1
2018-05-28 17:00:00;NORTE;29;0;29;1
2018-05-28 17:30:00;NORTE;28;0;28;1
2018-05-28 18:00:00;NORTE;32;0;32;1
2018-05-28 18:30:00;NORTE;31;0;31;1
2018-05-28 19:00:00;NORTE;32;0;32;1
2018-05-28 19:30:00;NORTE;1;0;1;1
2018-05-28 20:30:00;NORTE;1;0;1;1
2018-05-28 21:00:00;NORTE;21;0;21;1
2018-05-28 21:30:00;NORTE;18;0;18;1
2018-05-28 22:00:00;NORTE;10;0;10;1
2018-05-28 22:30:00;NORTE;10;0;10;1
2018-05-28 23:00:00;NORTE;3;0;3;1
2018-05-28 23:30:00;NORTE;1;0;1;1
2018-05-29 00:30:00;NORTE;2;0;2;1
2018-05-29 01:30:00;NORTE;2;0;2;1
2018-05-29 02:00:00;NORTE;4;0;4;1
2018-05-29 02:30:00;NORTE;3;0;3;1
2018-05-29 03:00:00;NORTE;2;0;2;1
2018-05-29 03:30:00;NORTE;6;0;6;1
2018-05-29 04:00:00;NORTE;17;0;17;1
2018-05-29 04:30:00;NORTE;13;0;13;1
2018-05-29 05:00:00;NORTE;17;0;17;1
2018-05-29 05:30:00;NORTE;36;0;36;1
2018-05-29 06:00:00;NORTE;22;0;22;1
2018-05-29 06:30:00;NORTE;25;0;25;1
2018-05-29 07:00:00;NORTE;28;0;28;1
2018-05-29 07:30:00;NORTE;22;0;22;1
2018-05-29 08:00:00;NORTE;35;0;35;1
2018-05-29 08:30:00;NORTE;23;0;23;1
2018-05-29 09:00:00;NORTE;28;0;28;1
2018-05-29 09:30:00;NORTE;17;0;17;1
2018-05-29 10:00:00;NORTE;36;0;36;1
2018-05-29 10:30:00;NORTE;24;0;24;1
2018-05-29 11:00:00;NORTE;34;0;34;1
2018-05-29 11:30:00;NORTE;26;0;26;1
2018-05-29 12:00:00;NORTE;27;0;27;1
2018-05-29 12:30:00;NORTE;26;0;26;1
2018-05-29 13:00:00;NORTE;29;0;29;1
2018-05-29 13:30:00;NORTE;31;0;31;1
2018-05-29 14:00:00;NORTE;31;0;31;1
2018-05-29 14:30:00;NORTE;15;0;15;1
2018-05-29 14:41:00;CONFLICTIVA;7;5;12;2
2018-05-29 15:00:00;SUR;0;30;30;1
2018-05-29 15:30:00;SUR;0;26;26;1
2018-05-29 16:00:00;SUR;0;32;32;1
2018-05-29 16:30:00;SUR;0;24;24;1
2018-05-29 17:00:00;SUR;0;22;22;1
2018-05-29 17:30:00;NORTE;26;1;27;1
2018-05-29 18:00:00;NORTE;30;0;30;1
2018-05-29 18:30:00;NORTE;33;0;33;1
2018-05-29 19:00:00;NORTE;36;0;36;1
2018-05-29 19:30:00;NORTE;31;0;31;1
2018-05-29 20:00:00;NORTE;34;0;34;1
2018-05-29 20:30:00;NORTE;24;0;24;1
2018-05-29 21:00:00;NORTE;16;0;16;1
2018-05-29 21:30:00;NORTE;15;0;15;1
2018-05-29 22:00:00;NORTE;13;0;13;1
2018-05-29 22:30:00;NORTE;11;0;11;1
2018-05-29 23:00:00;NORTE;6;0;6;1
2018-05-29 23:30:00;NORTE;2;0;2;1
2018-05-30 00:30:00;NORTE;2;0;2;1
2018-05-30 01:30:00;NORTE;1;0;1;1
2018-05-30 02:00:00;NORTE;1;0;1;1
2018-05-30 02:30:00;NORTE;3;0;3;1
2018-05-30 03:00:00;NORTE;1;0;1;1
2018-05-30 03:30:00;NORTE;8;0;8;1
2018-05-30 04:00:00;NORTE;14;0;14;1
2018-05-30 04:30:00;NORTE;12;0;12;1
2018-05-30 05:00:00;NORTE;13;0;13;1
2018-05-30 05:30:00;NORTE;44;0;44;1
2018-05-30 06:00:00;NORTE;23;0;23;1
2018-05-30 06:30:00;NORTE;27;0;27;1
2018-05-30 07:00:00;NORTE;27;0;27;1
2018-05-30 07:30:00;NORTE;28;0;28;1
2018-05-30 08:00:00;NORTE;34;0;34;1
2018-05-30 08:30:00;NORTE;30;0;30;1
2018-05-30 09:00:00;NORTE;26;0;26;1
2018-05-30 09:30:00;NORTE;31;0;31;1
2018-05-30 10:00:00;NORTE;38;0;38;1
2018-05-30 10:30:00;NORTE;26;0;26;1
2018-05-30 11:00:00;NORTE;40;0;40;1
2018-05-30 11:30:00;CONFLICTIVA;18;4;22;2
2018-05-30 12:00:00;SUR;0;27;27;1
2018-05-30 12:30:00;SUR;0;28;28;1
2018-05-30 13:00:00;SUR;0;30;30;1
2018-05-30 13:30:00;SUR;0;30;30;1
2018-05-30 14:00:00;SUR;0;35;35;1
2018-05-30 14:30:00;SUR;0;24;24;1
2018-05-30 15:00:00;CONFLICTIVA;13;10;23;2
2018-05-30 15:30:00;NORTE;29;0;29;1
2018-05-30 16:00:00;NORTE;23;0;23;1
2018-05-30 16:30:00;NORTE;35;0;35;1
2018-05-30 17:00:00;NORTE;30;0;30;1
2018-05-30 17:30:00;NORTE;30;0;30;1
2018-05-30 18:00:00;NORTE;34;0;34;1
2018-05-30 18:30:00;NORTE;35;0;35;1
2018-05-30 19:00:00;NORTE;33;0;33;1
2018-05-30 19:30:00;NORTE;22;0;22;1
2018-05-30 20:00:00;NORTE;31;0;31;1
2018-05-30 20:30:00;NORTE;25;0;25;1
2018-05-30 21:00:00;NORTE;14;0;14;1
2018-05-30 21:30:00;NORTE;19;0;19;1
2018-05-30 22:00:00;NORTE;12;0;12;1
2018-05-30 22:30:00;NORTE;6;0;6;1
2018-05-30 23:00:00;NORTE;1;0;1;1
2018-05-30 23:30:00;NORTE;2;0;2;1
2018-05-31 00:00:00;NORTE;1;0;1;1
2018-05-31 00:30:00;NORTE;2;0;2;1
2018-05-31 01:00:00;NORTE;1;0;1;1
2018-05-31 02:00:00;NORTE;3;0;3;1
2018-05-31 02:30:00;NORTE;1;0;1;1
2018-05-31 03:00:00;NORTE;2;0;2;1
2018-05-31 03:30:00;NORTE;5;0;5;1
2018-05-31 04:00:00;NORTE;13;0;13;1
2018-05-31 04:30:00;NORTE;14;0;14;1
2018-05-31 05:00:00;NORTE;18;0;18;1
2018-05-31 05:30:00;NORTE;34;0;34;1
2018-05-31 06:00:00;NORTE;27;0;27;1
2018-05-31 06:30:00;NORTE;24;0;24;1
2018-05-31 07:00:00;NORTE;33;0;33;1
2018-05-31 07:30:00;NORTE;29;0;29;1
2018-05-31 08:00:00;NORTE;34;0;34;1
2018-05-31 08:30:00;NORTE;37;0;37;1
2018-05-31 09:00:00;NORTE;23;0;23;1
2018-05-31 09:30:00;NORTE;27;0;27;1
2018-05-31 10:00:00;NORTE;36;0;36;1
2018-05-31 10:30:00;NORTE;31;0;31;1
2018-05-31 11:00:00;NORTE;31;0;31;1
2018-05-31 11:30:00;NORTE;24;0;24;1
2018-05-31 12:00:00;CONFLICTIVA;12;7;19;2
2018-05-31 12:30:00;SUR;0;37;37;1
2018-05-31 13:00:00;SUR;0;33;33;1
2018-05-31 13:30:00;SUR;0;26;26;1
2018-05-31 14:00:00;SUR;0;36;36;1
2018-05-31 14:30:00;SUR;1;34;35;1
2018-05-31 15:00:00;SUR;0;25;25;1
2018-05-31 15:30:00;SUR;0;22;22;1
2018-05-31 16:00:00;SUR;0;17;17;1
2018-05-31 16:30:00;SUR;0;28;28;1
2018-05-31 17:00:00;SUR;0;21;21;1
2018-05-31 17:30:00;SUR;0;23;23;1
2018-05-31 18:00:00;SUR;0;26;26;1
2018-05-31 18:30:00;SUR;0;27;27;1
2018-05-31 19:00:00;SUR;0;32;32;1
2018-05-31 19:30:00;SUR;0;26;26;1
2018-05-31 20:00:00;SUR;0;31;31;1
2018-05-31 20:30:00;SUR;1;20;21;1
2018-05-31 21:00:00;NORTE;15;0;15;1
2018-05-31 21:30:00;NORTE;15;0;15;1
2018-05-31 22:00:00;NORTE;18;0;18;1
2018-05-31 22:30:00;NORTE;7;0;7;1
2018-05-31 23:00:00;NORTE;10;0;10;1
2018-05-31 23:30:00;NORTE;2;0;2;1
2018-06-01 00:00:00;NORTE;4;0;4;1
2018-06-01 00:30:00;NORTE;1;0;1;1
2018-06-01 01:00:00;NORTE;1;0;1;1
2018-06-01 01:30:00;NORTE;2;0;2;1
2018-06-01 02:00:00;NORTE;1;0;1;1
2018-06-01 02:30:00;NORTE;3;0;3;1
2018-06-01 03:00:00;NORTE;5;0;5;1
2018-06-01 03:30:00;NORTE;3;0;3;1
2018-06-01 04:00:00;NORTE;8;0;8;1
2018-06-01 04:30:00;NORTE;15;0;15;1
2018-06-01 05:00:00;NORTE;14;0;14;1
2018-06-01 05:30:00;NORTE;34;0;34;1
2018-06-01 06:00:00;NORTE;25;0;25;1
2018-06-01 06:30:00;NORTE;25;0;25;1
2018-06-01 07:00:00;NORTE;35;0;35;1
2018-06-01 07:30:00;NORTE;34;0;34;1
2018-06-01 08:00:00;NORTE;34;0;34;1
2018-06-01 08:30:00;NORTE;35;0;35;1
2018-06-01 09:00:00;NORTE;30;0;30;1
2018-06-01 09:30:00;NORTE;34;0;34;1
2018-06-01 10:00:00;NORTE;34;0;34;1
2018-06-01 10:30:00;NORTE;34;0;34;1
2018-06-01 11:00:00;CONFLICTIVA;8;17;25;2
2018-06-01 11:30:00;SUR;0;26;26;1
2018-06-01 12:00:00;SUR;0;25;25;1
2018-06-01 12:30:00;SUR;0;31;31;1
2018-06-01 13:00:00;SUR;0;25;25;1
2018-06-01 13:30:00;SUR;0;30;30;1
2018-06-01 14:00:00;SUR;0;28;28;1
2018-06-01 14:30:00;SUR;0;26;26;1
2018-06-01 15:00:00;SUR;0;27;27;1
2018-06-01 15:30:00;SUR;0;24;24;1
2018-06-01 16:00:00;SUR;0;21;21;1
2018-06-01 16:30:00;SUR;0;16;16;1
2018-06-01 17:00:00;SUR;0;24;24;1
2018-06-01 17:30:00;SUR;2;19;21;1
2018-06-01 18:00:00;NORTE;43;0;43;1
2018-06-01 18:30:00;NORTE;30;0;30;1
2018-06-01 19:00:00;NORTE;34;0;34;1
2018-06-01 19:30:00;NORTE;28;0;28;1
2018-06-01 20:00:00;NORTE;26;0;26;1
2018-06-01 20:30:00;NORTE;12;0;12;1
2018-06-01 20:40:00;NORTE;14;0;14;1
2018-06-01 21:00:00;NORTE;9;0;9;1
2018-06-01 21:22:00;SUR;0;1;1;1
2018-06-01 21:30:00;CONFLICTIVA;3;1;4;2
2018-06-01 21:50:00;NORTE;6;0;6;1
2018-06-01 22:00:00;NORTE;24;0;24;1
2018-06-01 22:30:00;NORTE;10;0;10;1
2018-06-01 23:00:00;NORTE;5;0;5;1
2018-06-01 23:30:00;NORTE;4;0;4;1
2018-06-02 00:00:00;NORTE;5;0;5;1
2018-06-02 00:30:00;NORTE;2;0;2;1
2018-06-02 01:00:00;NORTE;3;0;3;1
2018-06-02 01:30:00;NORTE;1;0;1;1
2018-06-02 02:00:00;NORTE;2;0;2;1
2018-06-02 02:30:00;NORTE;4;0;4;1
2018-06-02 03:00:00;NORTE;1;0;1;1
2018-06-02 03:30:00;NORTE;1;0;1;1
2018-06-02 04:00:00;NORTE;9;0;9;1
2018-06-02 04:30:00;NORTE;14;0;14;1
2018-06-02 05:00:00;NORTE;13;0;13;1
2018-06-02 05:30:00;NORTE;28;0;28;1
2018-06-02 06:00:00;NORTE;20;0;20;1
2018-06-02 06:21:00;NORTE;6;0;6;1
2018-06-02 06:30:00;NORTE;9;0;9;1
2018-06-02 06:44:00;NORTE;17;0;17;1
2018-06-02 07:00:00;NORTE;31;0;31;1
2018-06-02 07:30:00;NORTE;29;0;29;1
2018-06-02 08:00:00;NORTE;29;0;29;1
2018-06-02 08:30:00;NORTE;30;0;30;1
2018-06-02 09:00:00;NORTE;35;0;35;1
2018-06-02 09:30:00;NORTE;23;0;23;1
2018-06-02 10:00:00;NORTE;37;0;37;1
2018-06-02 10:30:00;NORTE;35;0;35;1
2018-06-02 11:00:00;NORTE;19;0;19;1
2018-06-02 11:30:00;NORTE;23;0;23;1
2018-06-02 12:00:00;NORTE;30;0;30;1
2018-06-02 12:30:00;NORTE;24;0;24;1
2018-06-02 13:00:00;NORTE;33;0;33;1
2018-06-02 13:30:00;NORTE;34;0;34;1
2018-06-02 14:00:00;NORTE;35;0;35;1
2018-06-02 14:30:00;NORTE;23;0;23;1
2018-06-02 15:00:00;NORTE;29;0;29;1
2018-06-02 15:30:00;NORTE;14;0;14;1
2018-06-02 16:00:00;CONFLICTIVA;10;2;12;2
2018-06-02 16:30:00;SUR;0;33;33;1
2018-06-02 17:00:00;SUR;0;16;16;1
2018-06-02 17:30:00;SUR;0;8;8;1
2018-06-02 17:51:00;SUR;0;4;4;1
2018-06-02 18:00:00;SUR;0;19;19;1
2018-06-02 18:30:00;SUR;0;27;27;1
2018-06-02 19:00:00;SUR;0;27;27;1
2018-06-02 19:30:00;SUR;0;24;24;1
2018-06-02 20:00:00;SUR;0;17;17;1
2018-06-02 20:30:00;SUR;1;19;20;1
2018-06-02 21:00:00;NORTE;19;0;19;1
2018-06-02 21:30:00;NORTE;11;0;11;1
2018-06-02 22:00:00;NORTE;17;0;17;1
2018-06-02 22:30:00;NORTE;5;0;5;1
2018-06-02 23:00:00;NORTE;2;0;2;1
2018-06-02 23:30:00;NORTE;2;0;2;1
2018-06-03 00:00:00;NORTE;1;0;1;1
2018-06-03 00:30:00;NORTE;1;0;1;1
2018-06-03 01:00:00;NORTE;2;0;2;1
2018-06-03 01:30:00;NORTE;1;0;1;1
2018-06-03 02:00:00;NORTE;2;0;2;1
2018-06-03 02:30:00;NORTE;2;0;2;1
2018-06-03 03:00:00;NORTE;2;0;2;1
2018-06-03 03:30:00;NORTE;1;0;1;1
2018-06-03 04:00:00;NORTE;9;0;9;1
2018-06-03 04:30:00;NORTE;8;0;8;1
2018-06-03 05:00:00;NORTE;14;0;14;1
2018-06-03 05:30:00;NORTE;28;0;28;1
2018-06-03 06:00:00;NORTE;12;0;12;1
2018-06-03 06:30:00;NORTE;25;0;25;1
2018-06-03 07:00:00;NORTE;35;0;35;1
2018-06-03 07:30:00;NORTE;27;0;27;1
2018-06-03 08:00:00;NORTE;38;0;38;1
2018-06-03 08:30:00;NORTE;28;0;28;1
2018-06-03 09:00:00;NORTE;25;0;25;1
2018-06-03 09:30:00;NORTE;33;0;33;1
2018-06-03 10:00:00;NORTE;29;0;29;1
2018-06-03 10:30:00;NORTE;37;0;37;1
2018-06-03 11:00:00;CONFLICTIVA;5;18;23;2
2018-06-03 11:30:00;SUR;0;33;33;1
2018-06-03 12:00:00;SUR;0;25;25;1
2018-06-03 12:30:00;SUR;0;27;27;1
2018-06-03 13:00:00;SUR;0;30;30;1
2018-06-03 13:30:00;SUR;0;24;24;1
2018-06-03 14:00:00;SUR;0;44;44;1
2018-06-03 14:30:00;SUR;0;34;34;1
2018-06-03 15:00:00;SUR;0;13;13;1
2018-06-03 15:14:00;SUR;0;12;12;1
2018-06-03 15:30:00;SUR;0;23;23;1
2018-06-03 16:00:00;SUR;0;20;20;1
2018-06-03 16:30:00;NORTE;31;0;31;1
2018-06-03 17:00:00;NORTE;26;0;26;1
2018-06-03 17:30:00;CONFLICTIVA;3;26;29;2
2018-06-03 18:00:00;SUR;0;25;25;1
2018-06-03 18:30:00;SUR;0;24;24;1
2018-06-03 19:00:00;SUR;0;32;32;1
2018-06-03 19:30:00;SUR;0;23;23;1
2018-06-03 20:00:00;SUR;0;29;29;1
2018-06-03 20:30:00;SUR;0;28;28;1
2018-06-03 21:00:00;SUR;0;22;22;1
2018-06-03 21:30:00;SUR;0;18;18;1
2018-06-03 22:00:00;SUR;0;12;12;1
2018-06-03 22:30:00;SUR;0;13;13;1
2018-06-03 23:00:00;SUR;0;5;5;1
2018-06-03 23:30:00;SUR;0;5;5;1
2018-06-04 00:00:00;SUR;0;3;3;1
2018-06-04 00:30:00;SUR;0;1;1;1
2018-06-04 01:00:00;SUR;0;1;1;1
2018-06-04 02:00:00;SUR;0;1;1;1
2018-06-04 02:30:00;SUR;0;3;3;1
2018-06-04 03:00:00;SUR;0;1;1;1
2018-06-04 03:30:00;SUR;0;2;2;1
2018-06-04 04:00:00;SUR;0;8;8;1
2018-06-04 04:30:00;SUR;0;13;13;1
2018-06-04 05:00:00;SUR;0;17;17;1
2018-06-04 05:30:00;SUR;2;31;33;1
2018-06-04 06:00:00;NORTE;16;0;16;1
2018-06-04 06:30:00;NORTE;34;0;34;1
2018-06-04 07:00:00;NORTE;33;0;33;1
2018-06-04 07:30:00;NORTE;28;0;28;1
2018-06-04 08:00:00;CONFLICTIVA;7;19;26;2
2018-06-04 08:30:00;SUR;0;42;42;1
2018-06-04 09:00:00;SUR;0;25;25;1
2018-06-04 09:30:00;SUR;0;34;34;1
2018-06-04 10:00:00;SUR;0;32;32;1
2018-06-04 10:30:00;SUR;0;28;28;1
2018-06-04 11:00:00;SUR;0;29;29;1
2018-06-04 11:30:00;SUR;0;29;29;1
2018-06-04 12:00:00;SUR;0;22;22;1
2018-06-04 12:30:00;SUR;0;27;27;1
2018-06-04 13:00:00;SUR;0;28;28;1
2018-06-04 13:30:00;SUR;0;33;33;1
2018-06-04 14:00:00;SUR;0;32;32;1
2018-06-04 14:30:00;SUR;0;40;40;1
2018-06-04 15:00:00;SUR;0;27;27;1
2018-06-04 15:30:00;SUR;0;20;20;1
2018-06-04 16:00:00;SUR;1;25;26;1
2018-06-04 16:30:00;SUR;0;33;33;1
2018-06-04 17:00:00;SUR;0;20;20;1
2018-06-04 17:30:00;SUR;0;19;19;1
2018-06-04 18:00:00;SUR;0;37;37;1
2018-06-04 18:30:00;SUR;0;29;29;1
2018-06-04 19:00:00;SUR;0;31;31;1
2018-06-04 19:30:00;SUR;0;22;22;1
2018-06-04 20:00:00;SUR;0;28;28;1
2018-06-04 20:30:00;SUR;0;21;21;1
2018-06-04 21:00:00;SUR;0;18;18;1
2018-06-04 21:30:00;SUR;0;15;15;1
2018-06-04 22:00:00;SUR;0;17;17;1
2018-06-04 22:30:00;SUR;0;5;5;1
2018-06-04 23:00:00;SUR;0;3;3;1
2018-06-04 23:30:00;SUR;0;2;2;1
2018-06-05 00:00:00;SUR;0;1;1;1
2018-06-05 00:30:00;SUR;0;1;1;1
2018-06-05 01:00:00;SUR;0;1;1;1
2018-06-05 01:30:00;SUR;0;1;1;1
2018-06-05 02:00:00;SUR;0;1;1;1
2018-06-05 02:30:00;SUR;0;8;8;1
2018-06-05 03:00:00;SUR;0;1;1;1
2018-06-05 03:30:00;SUR;0;7;7;1
2018-06-05 04:00:00;SUR;0;10;10;1
2018-06-05 04:30:00;NORTE;14;1;15;1
2018-06-05 05:00:00;NORTE;17;0;17;1
2018-06-05 05:30:00;NORTE;36;0;36;1
2018-06-05 06:00:00;NORTE;24;0;24;1
2018-06-05 06:30:00;NORTE;24;0;24;1
2018-06-05 07:00:00;NORTE;36;0;36;1
2018-06-05 07:30:00;NORTE;21;0;21;1
2018-06-05 08:00:00;NORTE;37;0;37;1
2018-06-05 08:30:00;NORTE;33;0;33;1
2018-06-05 09:00:00;NORTE;26;0;26;1
2018-06-05 09:30:00;NORTE;31;0;31;1
2018-06-05 10:00:00;NORTE;35;0;35;1
2018-06-05 10:30:00;NORTE;31;0;31;1
2018-06-05 11:00:00;NORTE;32;0;32;1
2018-06-05 11:30:00;NORTE;31;0;31;1
2018-06-05 12:00:00;NORTE;27;0;27;1
2018-06-05 12:30:00;NORTE;34;0;34;1
2018-06-05 13:00:00;NORTE;32;0;32;1
2018-06-05 13:30:00;NORTE;28;0;28;1
2018-06-05 14:00:00;NORTE;32;0;32;1
2018-06-05 14:30:00;NORTE;38;0;38;1
2018-06-05 15:00:00;NORTE;22;0;22;1
2018-06-05 15:30:00;NORTE;25;0;25;1
2018-06-05 16:00:00;NORTE;19;0;19;1
2018-06-05 16:30:00;NORTE;31;0;31;1
2018-06-05 17:00:00;NORTE;22;0;22;1
2018-06-05 17:30:00;NORTE;29;0;29;1
2018-06-05 18:00:00;NORTE;21;0;21;1
2018-06-05 18:30:00;NORTE;28;0;28;1
2018-06-05 19:00:00;NORTE;13;0;13;1
2018-06-05 19:30:00;NORTE;28;0;28;1
2018-06-05 20:00:00;NORTE;24;0;24;1
2018-06-05 20:30:00;NORTE;27;0;27;1
2018-06-05 21:00:00;NORTE;17;0;17;1
2018-06-05 21:30:00;NORTE;17;0;17;1
2018-06-05 22:00:00;NORTE;14;0;14;1
2018-06-05 22:30:00;NORTE;6;0;6;1
2018-06-05 23:00:00;NORTE;2;0;2;1
2018-06-05 23:30:00;NORTE;2;0;2;1
2018-06-06 00:00:00;NORTE;2;0;2;1
2018-06-06 01:00:00;NORTE;1;0;1;1
2018-06-06 01:30:00;NORTE;1;0;1;1
2018-06-06 02:30:00;NORTE;5;0;5;1
2018-06-06 03:00:00;NORTE;4;0;4;1
2018-06-06 03:30:00;NORTE;8;0;8;1
2018-06-06 04:00:00;NORTE;11;0;11;1
2018-06-06 04:30:00;NORTE;14;0;14;1
2018-06-06 05:00:00;NORTE;14;0;14;1
2018-06-06 05:30:00;NORTE;41;0;41;1
2018-06-06 06:00:00;NORTE;28;0;28;1
2018-06-06 06:30:00;NORTE;25;0;25;1
2018-06-06 07:00:00;NORTE;35;0;35;1
2018-06-06 07:30:00;NORTE;27;0;27;1
2018-06-06 08:00:00;NORTE;37;0;37;1
2018-06-06 08:30:00;NORTE;17;0;17;1
2018-06-06 08:41:00;NORTE;19;0;19;1
2018-06-06 09:00:00;NORTE;32;0;32;1
2018-06-06 09:30:00;NORTE;28;0;28;1
2018-06-06 10:00:00;NORTE;35;0;35;1
2018-06-06 10:30:00;NORTE;32;0;32;1
2018-06-06 11:00:00;NORTE;37;0;37;1
2018-06-06 11:30:00;NORTE;25;0;25;1
2018-06-06 12:00:00;NORTE;25;0;25;1
2018-06-06 12:30:00;NORTE;34;0;34;1
2018-06-06 13:00:00;NORTE;30;0;30;1
2018-06-06 13:30:00;NORTE;27;0;27;1
2018-06-06 14:00:00;NORTE;32;0;32;1
2018-06-06 14:30:00;NORTE;31;0;31;1
2018-06-06 15:00:00;NORTE;23;0;23;1
2018-06-06 15:30:00;NORTE;19;0;19;1
2018-06-06 16:00:00;NORTE;25;0;25;1
2018-06-06 16:30:00;NORTE;30;0;30;1
2018-06-06 17:00:00;NORTE;30;0;30;1
2018-06-06 17:30:00;NORTE;29;0;29;1
2018-06-06 18:00:00;NORTE;39;0;39;1
2018-06-06 18:30:00;NORTE;36;0;36;1
2018-06-06 19:00:00;NORTE;32;0;32;1
2018-06-06 19:30:00;NORTE;29;0;29;1
2018-06-06 20:00:00;NORTE;30;0;30;1
2018-06-06 20:30:00;NORTE;31;0;31;1
2018-06-06 21:00:00;NORTE;19;1;20;1
2018-06-06 21:30:00;NORTE;13;0;13;1
2018-06-06 22:00:00;NORTE;11;0;11;1
2018-06-06 22:30:00;NORTE;8;0;8;1
2018-06-06 23:00:00;NORTE;2;0;2;1
2018-06-06 23:30:00;NORTE;2;0;2;1
2018-06-07 00:00:00;NORTE;1;0;1;1
2018-06-07 00:30:00;NORTE;1;0;1;1
2018-06-07 01:30:00;NORTE;2;0;2;1
2018-06-07 02:00:00;NORTE;2;0;2;1
2018-06-07 02:30:00;NORTE;5;0;5;1
2018-06-07 03:00:00;NORTE;1;0;1;1
2018-06-07 03:30:00;NORTE;7;0;7;1
2018-06-07 04:00:00;NORTE;12;0;12;1
2018-06-07 04:30:00;NORTE;13;0;13;1
2018-06-07 05:00:00;NORTE;21;0;21;1
2018-06-07 05:30:00;NORTE;34;0;34;1
2018-06-07 06:00:00;NORTE;23;0;23;1
2018-06-07 06:30:00;NORTE;25;0;25;1
2018-06-07 07:00:00;NORTE;33;0;33;1
2018-06-07 07:30:00;NORTE;24;0;24;1
2018-06-07 08:00:00;NORTE;39;0;39;1
2018-06-07 08:30:00;NORTE;34;0;34;1
2018-06-07 09:00:00;NORTE;33;0;33;1
2018-06-07 09:30:00;NORTE;34;0;34;1
2018-06-07 10:00:00;NORTE;40;0;40;1
2018-06-07 10:30:00;NORTE;29;0;29;1
2018-06-07 11:00:00;SUR;1;28;29;1
2018-06-07 11:30:00;SUR;0;31;31;1
2018-06-07 12:00:00;SUR;0;28;28;1
2018-06-07 12:30:00;SUR;0;30;30;1
2018-06-07 13:00:00;SUR;0;38;38;1
2018-06-07 13:30:00;SUR;0;28;28;1
2018-06-07 14:00:00;SUR;0;34;34;1
2018-06-07 14:30:00;SUR;0;41;41;1
2018-06-07 15:00:00;SUR;0;21;21;1
2018-06-07 15:30:00;SUR;0;24;24;1
2018-06-07 16:00:00;SUR;0;29;29;1
2018-06-07 16:30:00;SUR;2;24;26;1
2018-06-07 17:00:00;NORTE;23;0;23;1
2018-06-07 17:30:00;NORTE;32;0;32;1
2018-06-07 18:00:00;NORTE;35;0;35;1
2018-06-07 18:30:00;NORTE;40;0;40;1
2018-06-07 19:00:00;NORTE;33;0;33;1
2018-06-07 19:30:00;NORTE;23;0;23;1
2018-06-07 20:00:00;NORTE;37;0;37;1
2018-06-07 20:30:00;NORTE;27;0;27;1
2018-06-07 21:00:00;NORTE;18;0;18;1
2018-06-07 21:30:00;NORTE;14;0;14;1
2018-06-07 22:00:00;NORTE;12;0;12;1
2018-06-07 22:30:00;NORTE;9;0;9;1
2018-06-07 23:00:00;NORTE;8;0;8;1
2018-06-07 23:30:00;NORTE;1;0;1;1
2018-06-08 00:00:00;NORTE;3;0;3;1
2018-06-08 00:30:00;NORTE;1;0;1;1
2018-06-08 01:00:00;NORTE;2;0;2;1
2018-06-08 01:30:00;NORTE;1;0;1;1
2018-06-08 02:00:00;NORTE;1;0;1;1
2018-06-08 02:30:00;NORTE;4;0;4;1
2018-06-08 03:00:00;NORTE;4;0;4;1
2018-06-08 03:30:00;NORTE;4;0;4;1
2018-06-08 04:00:00;NORTE;14;0;14;1
2018-06-08 04:30:00;CONFLICTIVA;2;6;8;2
2018-06-08 04:51:00;SUR;0;4;4;1
2018-06-08 05:00:00;SUR;0;18;18;1
2018-06-08 05:30:00;SUR;0;39;39;1
2018-06-08 06:00:00;SUR;0;24;24;1
2018-06-08 06:30:00;SUR;0;27;27;1
2018-06-08 07:00:00;SUR;0;38;38;1
2018-06-08 07:30:00;SUR;0;13;13;1
2018-06-08 08:00:00;SUR;0;32;32;1
2018-06-08 08:30:00;SUR;0;41;41;1
2018-06-08 09:00:00;SUR;0;22;22;1
2018-06-08 09:30:00;SUR;0;34;34;1
2018-06-08 10:00:00;SUR;0;35;35;1
2018-06-08 10:30:00;SUR;0;35;35;1
2018-06-08 11:00:00;SUR;0;25;25;1
2018-06-08 11:30:00;SUR;0;27;27;1
2018-06-08 12:00:00;SUR;0;22;22;1
2018-06-08 12:30:00;SUR;0;30;30;1
2018-06-08 13:00:00;SUR;0;33;33;1
2018-06-08 13:30:00;SUR;0;21;21;1
2018-06-08 13:49:00;SUR;0;11;11;1
2018-06-08 14:00:00;SUR;0;33;33;1
2018-06-08 14:30:00;SUR;0;34;34;1
2018-06-08 15:00:00;SUR;0;35;35;1
2018-06-08 15:30:00;SUR;0;33;33;1
2018-06-08 16:00:00;SUR;0;25;25;1
2018-06-08 16:30:00;SUR;0;25;25;1
2018-06-08 17:00:00;SUR;0;19;19;1
2018-06-08 17:30:00;SUR;0;26;26;1
2018-06-08 18:00:00;SUR;0;39;39;1
2018-06-08 18:30:00;SUR;0;31;31;1
2018-06-08 19:00:00;SUR;0;34;34;1
2018-06-08 19:30:00;SUR;0;22;22;1
2018-06-08 20:00:00;SUR;0;40;40;1
2018-06-08 20:30:00;SUR;0;27;27;1
2018-06-08 21:00:00;CONFLICTIVA;6;7;13;2
2018-06-08 21:30:00;NORTE;16;0;16;1
2018-06-08 22:00:00;NORTE;12;0;12;1
2018-06-08 22:30:00;NORTE;12;0;12;1
2018-06-08 23:00:00;NORTE;3;0;3;1
2018-06-08 23:30:00;NORTE;6;0;6;1
2018-06-09 00:00:00;NORTE;3;0;3;1
2018-06-09 00:30:00;NORTE;1;0;1;1
2018-06-09 01:00:00;NORTE;3;0;3;1
2018-06-09 01:30:00;NORTE;2;0;2;1
2018-06-09 02:00:00;NORTE;2;0;2;1
2018-06-09 02:30:00;NORTE;4;0;4;1
2018-06-09 03:30:00;NORTE;2;0;2;1
2018-06-09 04:00:00;NORTE;13;0;13;1
2018-06-09 04:30:00;NORTE;13;0;13;1
2018-06-09 05:00:00;NORTE;16;0;16;1
2018-06-09 05:30:00;NORTE;32;0;32;1
2018-06-09 06:00:00;NORTE;25;0;25;1
2018-06-09 06:30:00;NORTE;20;0;20;1
2018-06-09 07:00:00;NORTE;31;0;31;1
2018-06-09 07:30:00;NORTE;32;0;32;1
2018-06-09 08:00:00;NORTE;37;0;37;1
2018-06-09 08:30:00;NORTE;36;0;36;1
2018-06-09 09:00:00;CONFLICTIVA;9;14;23;2
2018-06-09 09:30:00;SUR;0;24;24;1
2018-06-09 10:00:00;SUR;0;35;35;1
2018-06-09 10:30:00;SUR;0;31;31;1
2018-06-09 11:00:00;SUR;0;27;27;1
2018-06-09 11:30:00;SUR;0;22;22;1
2018-06-09 12:00:00;SUR;0;20;20;1
2018-06-09 12:30:00;SUR;0;27;27;1
2018-06-09 13:00:00;SUR;0;22;22;1
2018-06-09 13:30:00;SUR;0;28;28;1
2018-06-09 14:00:00;SUR;0;32;32;1
2018-06-09 14:30:00;SUR;0;33;33;1
2018-06-09 15:00:00;CONFLICTIVA;17;2;19;2
2018-06-09 15:30:00;NORTE;18;0;18;1
2018-06-09 16:00:00;NORTE;26;0;26;1
2018-06-09 16:30:00;NORTE;28;0;28;1
2018-06-09 17:00:00;NORTE;18;0;18;1
2018-06-09 17:30:00;NORTE;24;0;24;1
2018-06-09 18:00:00;NORTE;27;0;27;1
2018-06-09 18:30:00;NORTE;25;0;25;1
2018-06-09 19:00:00;NORTE;24;0;24;1
2018-06-09 19:30:00;NORTE;20;0;20;1
2018-06-09 20:00:00;NORTE;13;0;13;1
2018-06-09 20:30:00;NORTE;14;0;14;1
2018-06-09 21:00:00;NORTE;10;0;10;1
2018-06-09 21:30:00;NORTE;10;0;10;1
2018-06-09 22:00:00;NORTE;17;0;17;1
2018-06-09 22:30:00;NORTE;10;0;10;1
2018-06-09 23:00:00;NORTE;7;0;7;1
2018-06-09 23:30:00;NORTE;4;0;4;1
2018-06-10 00:00:00;NORTE;2;0;2;1
2018-06-10 00:30:00;NORTE;3;0;3;1
2018-06-10 01:00:00;NORTE;5;0;5;1
2018-06-10 02:00:00;NORTE;1;0;1;1
2018-06-10 02:30:00;NORTE;5;0;5;1
2018-06-10 03:30:00;NORTE;2;0;2;1
2018-06-10 04:00:00;NORTE;11;0;11;1
2018-06-10 04:30:00;NORTE;6;0;6;1
2018-06-10 05:00:00;NORTE;17;0;17;1
2018-06-10 05:30:00;NORTE;24;0;24;1
2018-06-10 06:00:00;NORTE;16;0;16;1
2018-06-10 06:30:00;NORTE;21;0;21;1
2018-06-10 07:00:00;NORTE;26;0;26;1
2018-06-10 07:30:00;NORTE;23;0;23;1
2018-06-10 08:00:00;NORTE;31;0;31;1
2018-06-10 08:30:00;NORTE;38;0;38;1
2018-06-10 09:00:00;NORTE;25;0;25;1
2018-06-10 09:30:00;NORTE;31;0;31;1
2018-06-10 10:00:00;NORTE;33;0;33;1
2018-06-10 10:30:00;NORTE;33;0;33;1
2018-06-10 11:00:00;NORTE;30;0;30;1
2018-06-10 11:30:00;NORTE;23;0;23;1
2018-06-10 12:00:00;CONFLICTIVA;9;14;23;2
2018-06-10 12:30:00;SUR;0;9;9;1
2018-06-10 13:00:00;SUR;0;4;4;1
2018-06-10 13:30:00;SUR;0;35;35;1
2018-06-10 14:00:00;SUR;0;4;4;1
2018-06-10 17:00:00;SUR;0;18;18;1
2018-06-10 17:30:00;SUR;0;22;22;1
2018-06-10 18:00:00;CONFLICTIVA;17;10;27;2
2018-06-10 18:30:00;NORTE;29;0;29;1
2018-06-10 19:00:00;NORTE;28;0;28;1
2018-06-10 19:30:00;NORTE;31;0;31;1
2018-06-10 20:00:00;NORTE;28;0;28;1
2018-06-10 20:30:00;NORTE;41;0;41;1
2018-06-10 21:00:00;NORTE;21;0;21;1
2018-06-10 21:30:00;NORTE;18;0;18;1
2018-06-10 22:00:00;NORTE;19;0;19;1
2018-06-10 22:30:00;NORTE;16;0;16;1
2018-06-10 23:00:00;NORTE;6;0;6;1
2018-06-10 23:30:00;NORTE;4;0;4;1
2018-06-11 00:00:00;NORTE;6;0;6;1
2018-06-11 00:30:00;NORTE;3;0;3;1
2018-06-11 01:00:00;NORTE;3;0;3;1
2018-06-11 01:30:00;NORTE;3;0;3;1
2018-06-11 02:00:00;NORTE;1;0;1;1
2018-06-11 02:30:00;NORTE;5;0;5;1
2018-06-11 03:00:00;NORTE;1;0;1;1
2018-06-11 03:30:00;NORTE;6;0;6;1
2018-06-11 04:00:00;NORTE;9;0;9;1
2018-06-11 04:30:00;NORTE;11;0;11;1
2018-06-11 05:00:00;NORTE;20;0;20;1
2018-06-11 05:30:00;NORTE;38;0;38;1
2018-06-11 06:00:00;NORTE;29;0;29;1
2018-06-11 06:30:00;NORTE;23;0;23;1
2018-06-11 07:00:00;NORTE;34;0;34;1
2018-06-11 07:30:00;NORTE;28;0;28;1
2018-06-11 08:00:00;NORTE;33;0;33;1
2018-06-11 08:30:00;NORTE;40;0;40;1
2018-06-11 09:00:00;NORTE;32;0;32;1
2018-06-11 09:30:00;CONFLICTIVA;6;23;29;2
2018-06-11 10:00:00;SUR;0;37;37;1
2018-06-11 10:30:00;SUR;0;28;28;1
2018-06-11 11:00:00;SUR;0;27;27;1
2018-06-11 11:30:00;SUR;0;30;30;1
2018-06-11 12:00:00;SUR;0;21;21;1
2018-06-11 12:30:00;SUR;0;36;36;1
2018-06-11 13:00:00;SUR;0;37;37;1
2018-06-11 13:30:00;SUR;0;27;27;1
2018-06-11 14:00:00;SUR;0;37;37;1
2018-06-11 14:30:00;SUR;0;31;31;1
2018-06-11 15:00:00;SUR;0;33;33;1
2018-06-11 15:30:00;CONFLICTIVA;13;8;21;2
2018-06-11 16:00:00;NORTE;27;0;27;1
2018-06-11 16:30:00;NORTE;28;0;28;1
2018-06-11 17:00:00;NORTE;29;0;29;1
2018-06-11 17:30:00;NORTE;25;0;25;1
2018-06-11 18:00:00;NORTE;37;0;37;1
2018-06-11 18:30:00;NORTE;38;0;38;1
2018-06-11 19:00:00;NORTE;35;0;35;1
2018-06-11 19:30:00;NORTE;21;0;21;1
2018-06-11 20:00:00;NORTE;31;0;31;1
2018-06-11 20:30:00;NORTE;30;0;30;1
2018-06-11 21:00:00;NORTE;16;0;16;1
2018-06-11 21:30:00;NORTE;21;0;21;1
2018-06-11 22:00:00;NORTE;15;0;15;1
2018-06-11 22:30:00;NORTE;7;0;7;1
2018-06-11 23:00:00;NORTE;5;0;5;1
2018-06-11 23:30:00;NORTE;1;0;1;1
2018-06-12 00:00:00;NORTE;4;0;4;1
2018-06-12 00:30:00;NORTE;1;0;1;1
2018-06-12 01:00:00;NORTE;2;0;2;1
2018-06-12 02:00:00;NORTE;2;0;2;1
2018-06-12 02:30:00;NORTE;6;0;6;1
2018-06-12 03:00:00;NORTE;2;0;2;1
2018-06-12 03:30:00;NORTE;9;0;9;1
2018-06-12 04:00:00;NORTE;9;0;9;1
2018-06-12 04:30:00;NORTE;15;0;15;1
2018-06-12 05:00:00;NORTE;17;0;17;1
2018-06-12 05:30:00;NORTE;37;0;37;1
2018-06-12 06:00:00;NORTE;21;0;21;1
2018-06-12 06:30:00;NORTE;23;0;23;1
2018-06-12 07:00:00;NORTE;41;0;41;1
2018-06-12 07:30:00;NORTE;28;0;28;1
2018-06-12 08:00:00;NORTE;36;0;36;1
2018-06-12 08:30:00;NORTE;35;0;35;1
2018-06-12 09:00:00;NORTE;23;0;23;1
2018-06-12 09:30:00;NORTE;35;0;35;1
2018-06-12 10:00:00;NORTE;40;0;40;1
2018-06-12 10:30:00;NORTE;33;0;33;1
2018-06-12 11:00:00;NORTE;29;0;29;1
2018-06-12 11:30:00;NORTE;26;0;26;1
2018-06-12 12:00:00;NORTE;21;0;21;1
2018-06-12 12:30:00;NORTE;35;0;35;1
2018-06-12 13:00:00;NORTE;42;0;42;1
2018-06-12 13:30:00;CONFLICTIVA;6;22;28;2
2018-06-12 14:00:00;SUR;0;34;34;1
2018-06-12 14:30:00;SUR;0;32;32;1
2018-06-12 15:00:00;CONFLICTIVA;4;16;20;2
2018-06-12 15:30:00;NORTE;23;0;23;1
2018-06-12 16:00:00;NORTE;23;0;23;1
2018-06-12 16:30:00;NORTE;15;0;15;1
2018-06-12 17:00:00;NORTE;23;0;23;1
2018-06-12 17:30:00;NORTE;11;0;11;1
2018-06-12 18:00:00;NORTE;34;0;34;1
2018-06-12 18:30:00;NORTE;38;0;38;1
2018-06-12 19:00:00;NORTE;34;0;34;1
2018-06-12 19:30:00;NORTE;25;0;25;1
2018-06-12 20:00:00;NORTE;37;0;37;1
2018-06-12 20:30:00;NORTE;27;0;27;1
2018-06-12 21:00:00;NORTE;13;0;13;1
2018-06-12 21:30:00;NORTE;12;0;12;1
2018-06-12 22:00:00;NORTE;16;0;16;1
2018-06-12 22:30:00;NORTE;9;0;9;1
2018-06-12 23:00:00;NORTE;1;0;1;1
2018-06-12 23:30:00;NORTE;1;0;1;1
2018-06-13 00:00:00;NORTE;2;0;2;1
2018-06-13 01:00:00;NORTE;2;0;2;1
2018-06-13 02:00:00;NORTE;3;0;3;1
2018-06-13 02:30:00;NORTE;4;0;4;1
2018-06-13 03:00:00;NORTE;1;0;1;1
2018-06-13 03:30:00;NORTE;4;0;4;1
2018-06-13 04:00:00;NORTE;14;0;14;1
2018-06-13 04:30:00;NORTE;16;0;16;1
2018-06-13 05:00:00;NORTE;14;0;14;1
2018-06-13 05:30:00;NORTE;35;0;35;1
2018-06-13 06:00:00;NORTE;30;0;30;1
2018-06-13 06:30:00;NORTE;23;0;23;1
2018-06-13 07:00:00;NORTE;40;0;40;1
2018-06-13 07:30:00;NORTE;27;0;27;1
2018-06-13 08:00:00;NORTE;37;0;37;1
2018-06-13 08:30:00;NORTE;33;0;33;1
2018-06-13 09:00:00;NORTE;31;0;31;1
2018-06-13 09:30:00;NORTE;37;0;37;1
2018-06-13 10:00:00;NORTE;35;0;35;1
2018-06-13 10:30:00;NORTE;28;0;28;1
2018-06-13 11:00:00;NORTE;28;0;28;1
2018-06-13 11:30:00;NORTE;31;0;31;1
2018-06-13 12:00:00;NORTE;24;0;24;1
2018-06-13 12:30:00;NORTE;31;0;31;1
2018-06-13 13:00:00;NORTE;38;0;38;1
2018-06-13 13:30:00;NORTE;35;0;35;1
2018-06-13 14:00:00;NORTE;37;0;37;1
2018-06-13 14:30:00;NORTE;32;0;32;1
2018-06-13 15:00:00;NORTE;30;0;30;1
2018-06-13 15:30:00;NORTE;24;0;24;1
2018-06-13 16:00:00;NORTE;26;0;26;1
2018-06-13 16:30:00;NORTE;27;0;27;1
2018-06-13 17:00:00;NORTE;29;0;29;1
2018-06-13 17:30:00;NORTE;39;0;39;1
2018-06-13 18:00:00;NORTE;39;0;39;1
2018-06-13 18:30:00;NORTE;30;0;30;1
2018-06-13 19:00:00;NORTE;31;0;31;1
2018-06-13 19:30:00;NORTE;23;0;23;1
2018-06-13 20:00:00;NORTE;38;0;38;1
2018-06-13 20:30:00;NORTE;21;0;21;1
2018-06-13 21:00:00;NORTE;15;0;15;1
2018-06-13 21:30:00;NORTE;16;0;16;1
2018-06-13 22:00:00;NORTE;13;0;13;1
2018-06-13 22:30:00;NORTE;6;0;6;1
2018-06-13 23:30:00;NORTE;1;0;1;1
2018-06-14 00:00:00;NORTE;1;0;1;1
2018-06-14 00:30:00;NORTE;1;0;1;1
2018-06-14 01:00:00;NORTE;1;0;1;1
2018-06-14 01:30:00;NORTE;1;0;1;1
2018-06-14 02:00:00;NORTE;1;0;1;1
2018-06-14 02:30:00;NORTE;8;0;8;1
2018-06-14 03:00:00;NORTE;3;0;3;1
2018-06-14 03:30:00;NORTE;5;0;5;1
2018-06-14 04:00:00;NORTE;13;0;13;1
2018-06-14 04:30:00;NORTE;13;0;13;1
2018-06-14 05:00:00;NORTE;22;0;22;1
2018-06-14 05:30:00;NORTE;44;0;44;1
2018-06-14 06:00:00;NORTE;26;0;26;1
2018-06-14 06:30:00;NORTE;28;0;28;1
2018-06-14 07:00:00;NORTE;37;0;37;1
2018-06-14 07:30:00;NORTE;35;0;35;1
2018-06-14 08:00:00;NORTE;32;0;32;1
2018-06-14 08:30:00;NORTE;15;0;15;1
2018-06-14 12:30:00;NORTE;2;0;2;1
2018-06-14 13:00:00;NORTE;35;0;35;1
2018-06-14 13:30:00;NORTE;28;0;28;1
2018-06-14 14:00:00;NORTE;39;0;39;1
2018-06-14 14:30:00;NORTE;37;0;37;1
2018-06-14 15:00:00;NORTE;21;0;21;1
2018-06-14 15:30:00;NORTE;19;0;19;1
2018-06-14 16:00:00;NORTE;22;0;22;1
2018-06-14 16:30:00;NORTE;34;0;34;1
2018-06-14 17:00:00;NORTE;22;0;22;1
2018-06-14 17:30:00;NORTE;31;0;31;1
2018-06-14 18:00:00;NORTE;41;0;41;1
2018-06-14 18:30:00;NORTE;29;0;29;1
2018-06-14 19:00:00;NORTE;32;0;32;1
2018-06-14 19:30:00;NORTE;25;0;25;1
2018-06-14 20:00:00;NORTE;36;0;36;1
2018-06-14 20:30:00;NORTE;18;0;18;1
2018-06-14 21:00:00;NORTE;24;0;24;1
2018-06-14 21:30:00;NORTE;13;0;13;1
2018-06-14 22:00:00;NORTE;17;0;17;1
2018-06-14 22:30:00;NORTE;6;0;6;1
2018-06-14 23:00:00;NORTE;1;0;1;1
2018-06-14 23:30:00;NORTE;2;0;2;1
2018-06-15 00:00:00;NORTE;5;0;5;1
2018-06-15 01:00:00;NORTE;4;0;4;1
2018-06-15 01:30:00;NORTE;1;0;1;1
2018-06-15 02:00:00;NORTE;3;0;3;1
2018-06-15 02:30:00;NORTE;2;0;2;1
2018-06-15 03:00:00;NORTE;4;0;4;1
2018-06-15 03:30:00;NORTE;8;0;8;1
2018-06-15 04:00:00;NORTE;11;0;11;1
2018-06-15 04:30:00;NORTE;15;0;15;1
2018-06-15 05:00:00;NORTE;18;0;18;1
2018-06-15 05:30:00;NORTE;31;0;31;1
2018-06-15 06:00:00;NORTE;28;0;28;1
2018-06-15 06:30:00;NORTE;24;0;24;1
2018-06-15 07:00:00;NORTE;37;0;37;1
2018-06-15 07:30:00;NORTE;26;0;26;1
2018-06-15 08:00:00;NORTE;17;0;17;1
2018-06-15 11:30:00;NORTE;25;0;25;1
2018-06-15 12:00:00;NORTE;17;0;17;1
2018-06-15 12:30:00;NORTE;34;0;34;1
2018-06-15 13:00:00;NORTE;31;0;31;1
2018-06-15 13:30:00;NORTE;37;0;37;1
2018-06-15 14:00:00;NORTE;39;0;39;1
2018-06-15 14:30:00;NORTE;34;0;34;1
2018-06-15 15:00:00;NORTE;27;0;27;1
2018-06-15 15:30:00;NORTE;19;0;19;1
2018-06-15 16:00:00;NORTE;21;0;21;1
2018-06-15 16:30:00;NORTE;30;0;30;1
2018-06-15 17:00:00;NORTE;30;0;30;1
2018-06-15 17:30:00;NORTE;25;0;25;1
2018-06-15 18:00:00;NORTE;40;0;40;1
2018-06-15 18:30:00;NORTE;34;0;34;1
2018-06-15 19:00:00;NORTE;29;0;29;1
2018-06-15 19:30:00;NORTE;29;0;29;1
2018-06-15 20:00:00;NORTE;31;0;31;1
2018-06-15 20:30:00;NORTE;25;0;25;1
2018-06-15 21:00:00;NORTE;12;0;12;1
2018-06-15 21:30:00;NORTE;16;0;16;1
2018-06-15 22:00:00;NORTE;7;0;7;1
2018-06-15 22:30:00;NORTE;14;0;14;1
2018-06-15 23:00:00;NORTE;2;0;2;1
2018-06-15 23:30:00;NORTE;3;0;3;1
2018-06-16 00:00:00;NORTE;2;0;2;1
2018-06-16 00:30:00;NORTE;1;0;1;1
2018-06-16 01:00:00;NORTE;1;0;1;1
2018-06-16 01:30:00;NORTE;1;0;1;1
2018-06-16 02:00:00;NORTE;1;0;1;1
2018-06-16 02:30:00;NORTE;3;0;3;1
2018-06-16 03:00:00;NORTE;4;0;4;1
2018-06-16 03:30:00;NORTE;3;0;3;1
2018-06-16 04:00:00;NORTE;13;0;13;1
2018-06-16 04:30:00;NORTE;12;0;12;1
2018-06-16 05:00:00;NORTE;20;0;20;1
2018-06-16 05:30:00;NORTE;34;0;34;1
2018-06-16 06:00:00;NORTE;20;0;20;1
2018-06-16 06:30:00;NORTE;21;0;21;1
2018-06-16 07:00:00;NORTE;30;0;30;1
2018-06-16 07:30:00;NORTE;29;0;29;1
2018-06-16 08:00:00;NORTE;36;0;36;1
2018-06-16 08:30:00;NORTE;27;0;27;1
2018-06-16 09:00:00;NORTE;28;0;28;1
2018-06-16 09:30:00;NORTE;31;0;31;1
2018-06-16 10:00:00;NORTE;30;0;30;1
2018-06-16 10:30:00;NORTE;28;0;28;1
2018-06-16 11:00:00;NORTE;30;0;30;1
2018-06-16 11:30:00;NORTE;26;0;26;1
2018-06-16 12:00:00;NORTE;24;0;24;1
2018-06-16 12:30:00;NORTE;28;0;28;1
2018-06-16 13:00:00;NORTE;29;0;29;1
2018-06-16 13:30:00;NORTE;25;0;25;1
2018-06-16 14:00:00;NORTE;34;0;34;1
2018-06-16 14:30:00;NORTE;25;0;25;1
2018-06-16 15:00:00;NORTE;21;0;21;1
2018-06-16 15:30:00;NORTE;23;0;23;1
2018-06-16 16:00:00;NORTE;23;0;23;1
2018-06-16 16:30:00;NORTE;24;0;24;1
2018-06-16 17:00:00;NORTE;13;0;13;1
2018-06-16 17:30:00;NORTE;21;0;21;1
2018-06-16 18:00:00;NORTE;25;0;25;1
2018-06-16 18:30:00;NORTE;24;0;24;1
2018-06-16 19:00:00;NORTE;24;0;24;1
2018-06-16 19:30:00;NORTE;21;0;21;1
2018-06-16 20:00:00;NORTE;20;0;20;1
2018-06-16 20:30:00;NORTE;13;0;13;1
2018-06-16 21:00:00;NORTE;10;0;10;1
2018-06-16 21:30:00;NORTE;18;0;18;1
2018-06-16 22:00:00;NORTE;15;0;15;1
2018-06-16 22:30:00;NORTE;9;0;9;1
2018-06-16 23:00:00;NORTE;3;0;3;1
2018-06-16 23:30:00;NORTE;3;0;3;1
2018-06-17 00:00:00;NORTE;2;0;2;1
2018-06-17 00:30:00;NORTE;4;0;4;1
2018-06-17 01:00:00;NORTE;1;0;1;1
2018-06-17 01:30:00;NORTE;1;0;1;1
2018-06-17 02:00:00;NORTE;2;0;2;1
2018-06-17 02:30:00;NORTE;3;0;3;1
2018-06-17 03:00:00;NORTE;2;0;2;1
2018-06-17 03:30:00;NORTE;1;0;1;1
2018-06-17 04:00:00;NORTE;14;0;14;1
2018-06-17 04:30:00;NORTE;7;0;7;1
2018-06-17 05:00:00;NORTE;17;0;17;1
2018-06-17 05:30:00;NORTE;26;0;26;1
2018-06-17 06:00:00;NORTE;14;0;14;1
2018-06-17 06:30:00;NORTE;20;0;20;1
2018-06-17 07:00:00;NORTE;36;0;36;1
2018-06-17 07:30:00;NORTE;23;0;23;1
2018-06-17 08:00:00;NORTE;35;0;35;1
2018-06-17 08:30:00;NORTE;36;0;36;1
2018-06-17 09:00:00;NORTE;16;0;16;1
2018-06-17 09:30:00;NORTE;30;0;30;1
2018-06-17 10:00:00;NORTE;35;0;35;1
2018-06-17 10:30:00;NORTE;28;0;28;1
2018-06-17 11:00:00;NORTE;27;0;27;1
2018-06-17 11:30:00;NORTE;22;0;22;1
2018-06-17 12:00:00;NORTE;23;0;23;1
2018-06-17 12:30:00;NORTE;31;0;31;1
2018-06-17 13:00:00;NORTE;24;0;24;1
2018-06-17 13:30:00;NORTE;38;0;38;1
2018-06-17 14:00:00;NORTE;38;0;38;1
2018-06-17 14:30:00;NORTE;31;0;31;1
2018-06-17 15:00:00;NORTE;28;0;28;1
2018-06-17 15:30:00;NORTE;21;0;21;1
2018-06-17 16:00:00;NORTE;24;0;24;1
2018-06-17 16:30:00;NORTE;27;0;27;1
2018-06-17 17:00:00;NORTE;25;0;25;1
2018-06-17 17:30:00;NORTE;25;0;25;1
2018-06-17 18:00:00;NORTE;31;0;31;1
2018-06-17 18:30:00;NORTE;31;0;31;1
2018-06-17 19:00:00;NORTE;23;0;23;1
2018-06-17 19:30:00;NORTE;28;0;28;1
2018-06-17 20:00:00;NORTE;35;0;35;1
2018-06-17 20:30:00;NORTE;30;0;30;1
2018-06-17 21:00:00;NORTE;15;0;15;1
2018-06-17 21:30:00;NORTE;17;0;17;1
2018-06-17 22:00:00;NORTE;16;0;16;1
2018-06-17 22:30:00;NORTE;11;0;11;1
2018-06-17 23:00:00;NORTE;3;0;3;1
2018-06-17 23:30:00;NORTE;7;0;7;1
2018-06-18 00:00:00;NORTE;3;0;3;1
2018-06-18 00:30:00;NORTE;2;0;2;1
2018-06-18 01:00:00;NORTE;2;0;2;1
2018-06-18 02:00:00;NORTE;3;0;3;1
2018-06-18 02:30:00;NORTE;3;0;3;1
2018-06-18 03:00:00;NORTE;3;0;3;1
2018-06-18 03:30:00;NORTE;4;0;4;1
2018-06-18 04:00:00;NORTE;8;0;8;1
2018-06-18 04:30:00;NORTE;15;0;15;1
2018-06-18 05:00:00;NORTE;20;0;20;1
2018-06-18 05:30:00;NORTE;38;0;38;1
2018-06-18 06:00:00;NORTE;20;0;20;1
2018-06-18 06:30:00;NORTE;26;0;26;1
2018-06-18 07:00:00;NORTE;37;0;37;1
2018-06-18 07:30:00;NORTE;27;0;27;1
2018-06-18 08:00:00;NORTE;38;0;38;1
2018-06-18 08:30:00;NORTE;30;0;30;1
2018-06-18 09:00:00;NORTE;29;0;29;1
2018-06-18 09:30:00;NORTE;28;0;28;1
2018-06-18 10:00:00;NORTE;34;0;34;1
2018-06-18 10:30:00;NORTE;37;0;37;1
2018-06-18 11:00:00;NORTE;27;0;27;1
2018-06-18 11:30:00;NORTE;30;0;30;1
2018-06-18 12:00:00;NORTE;26;0;26;1
2018-06-18 12:30:00;NORTE;28;0;28;1
2018-06-18 13:00:00;NORTE;34;0;34;1
2018-06-18 13:30:00;NORTE;34;0;34;1
2018-06-18 14:00:00;NORTE;32;0;32;1
2018-06-18 14:30:00;NORTE;35;0;35;1
2018-06-18 15:00:00;NORTE;24;0;24;1
2018-06-18 15:30:00;NORTE;25;0;25;1
2018-06-18 16:00:00;NORTE;24;0;24;1
2018-06-18 16:30:00;NORTE;27;0;27;1
2018-06-18 17:00:00;NORTE;14;0;14;1
2018-06-18 17:30:00;NORTE;35;0;35;1
2018-06-18 18:00:00;NORTE;36;1;37;1
2018-06-18 18:30:00;NORTE;31;0;31;1
2018-06-18 19:00:00;NORTE;23;0;23;1
2018-06-18 19:30:00;NORTE;25;0;25;1
2018-06-18 20:00:00;NORTE;29;0;29;1
2018-06-18 20:30:00;NORTE;28;0;28;1
2018-06-18 21:00:00;NORTE;13;0;13;1
2018-06-18 21:30:00;NORTE;16;0;16;1
2018-06-18 22:00:00;NORTE;15;0;15;1
2018-06-18 22:30:00;NORTE;6;0;6;1
2018-06-18 23:00:00;NORTE;1;0;1;1
2018-06-19 00:30:00;NORTE;2;0;2;1
2018-06-19 01:00:00;NORTE;2;0;2;1
2018-06-19 02:00:00;NORTE;2;0;2;1
2018-06-19 02:30:00;NORTE;4;0;4;1
2018-06-19 03:00:00;NORTE;1;0;1;1
2018-06-19 03:30:00;NORTE;6;0;6;1
2018-06-19 04:00:00;NORTE;11;0;11;1
2018-06-19 04:30:00;NORTE;17;0;17;1
2018-06-19 05:00:00;NORTE;20;0;20;1
2018-06-19 05:30:00;NORTE;37;0;37;1
2018-06-19 06:00:00;NORTE;16;0;16;1
2018-06-19 06:30:00;NORTE;17;0;17;1
2018-06-19 07:00:00;NORTE;34;0;34;1
2018-06-19 07:30:00;NORTE;30;0;30;1
2018-06-19 08:00:00;NORTE;33;0;33;1
2018-06-19 08:30:00;NORTE;33;0;33;1
2018-06-19 09:00:00;NORTE;24;0;24;1
2018-06-19 09:30:00;NORTE;35;0;35;1
2018-06-19 10:00:00;NORTE;32;0;32;1
2018-06-19 10:30:00;NORTE;36;0;36;1
2018-06-19 11:00:00;NORTE;32;0;32;1
2018-06-19 11:30:00;NORTE;18;0;18;1
2018-06-19 12:00:00;NORTE;26;0;26;1
2018-06-19 12:30:00;NORTE;27;0;27;1
2018-06-19 13:00:00;NORTE;39;0;39;1
2018-06-19 13:30:00;NORTE;29;0;29;1
2018-06-19 14:00:00;NORTE;29;0;29;1
2018-06-19 14:30:00;NORTE;28;0;28;1
2018-06-19 15:00:00;NORTE;24;0;24;1
2018-06-19 15:30:00;NORTE;16;0;16;1
2018-06-19 16:00:00;NORTE;21;0;21;1
2018-06-19 16:30:00;NORTE;26;0;26;1
2018-06-19 17:00:00;NORTE;21;0;21;1
2018-06-19 17:30:00;NORTE;29;0;29;1
2018-06-19 18:00:00;NORTE;34;0;34;1
2018-06-19 18:30:00;NORTE;37;0;37;1
2018-06-19 19:00:00;NORTE;25;0;25;1
2018-06-19 19:30:00;NORTE;30;0;30;1
2018-06-19 20:00:00;NORTE;31;0;31;1
2018-06-19 20:30:00;NORTE;22;0;22;1
2018-06-19 21:00:00;NORTE;13;0;13;1
2018-06-19 21:30:00;NORTE;20;0;20;1
2018-06-19 22:00:00;NORTE;12;0;12;1
2018-06-19 22:30:00;NORTE;6;0;6;1
2018-06-19 23:00:00;NORTE;2;0;2;1
2018-06-19 23:30:00;NORTE;2;0;2;1
2018-06-20 00:00:00;NORTE;2;0;2;1
2018-06-20 00:30:00;NORTE;1;0;1;1
2018-06-20 01:30:00;NORTE;1;0;1;1
2018-06-20 02:00:00;NORTE;3;0;3;1
2018-06-20 02:30:00;NORTE;2;0;2;1
2018-06-20 03:00:00;NORTE;4;0;4;1
2018-06-20 03:30:00;NORTE;6;0;6;1
2018-06-20 04:00:00;NORTE;10;0;10;1
2018-06-20 04:30:00;NORTE;16;0;16;1
2018-06-20 05:00:00;NORTE;14;0;14;1
2018-06-20 05:30:00;NORTE;38;0;38;1
2018-06-20 06:00:00;NORTE;26;0;26;1
2018-06-20 06:30:00;NORTE;23;0;23;1
2018-06-20 07:00:00;NORTE;32;0;32;1
2018-06-20 07:30:00;NORTE;27;0;27;1
2018-06-20 08:00:00;NORTE;37;0;37;1
2018-06-20 08:30:00;NORTE;33;0;33;1
2018-06-20 09:00:00;NORTE;29;0;29;1
2018-06-20 09:30:00;NORTE;34;0;34;1
2018-06-20 10:00:00;NORTE;35;0;35;1
2018-06-20 10:30:00;NORTE;34;0;34;1
2018-06-20 11:00:00;NORTE;31;0;31;1
2018-06-20 11:30:00;NORTE;32;0;32;1
2018-06-20 12:00:00;NORTE;15;0;15;1
2018-06-20 12:30:00;NORTE;23;0;23;1
2018-06-20 13:00:00;NORTE;30;0;30;1
2018-06-20 13:30:00;NORTE;19;0;19;1
2018-06-20 14:00:00;NORTE;36;0;36;1
2018-06-20 14:30:00;NORTE;38;0;38;1
2018-06-20 15:00:00;NORTE;27;0;27;1
2018-06-20 15:30:00;NORTE;16;0;16;1
2018-06-20 16:00:00;NORTE;23;0;23;1
2018-06-20 16:30:00;NORTE;30;0;30;1
2018-06-20 17:00:00;NORTE;31;0;31;1
2018-06-20 17:30:00;NORTE;34;0;34;1
2018-06-20 18:00:00;NORTE;35;0;35;1
2018-06-20 18:30:00;NORTE;31;0;31;1
2018-06-20 19:00:00;NORTE;24;0;24;1
2018-06-20 19:30:00;NORTE;23;0;23;1
2018-06-20 20:00:00;NORTE;35;0;35;1
2018-06-20 20:30:00;NORTE;22;0;22;1
2018-06-20 21:00:00;NORTE;14;0;14;1
2018-06-20 21:30:00;NORTE;17;0;17;1
2018-06-20 22:00:00;NORTE;15;0;15;1
2018-06-20 22:30:00;NORTE;4;0;4;1
2018-06-20 23:00:00;NORTE;4;0;4;1
2018-06-21 00:00:00;SUR;0;2;2;1
2018-06-21 00:30:00;SUR;0;2;2;1
2018-06-21 01:00:00;SUR;0;1;1;1
2018-06-21 01:30:00;NORTE;1;0;1;1
2018-06-21 02:00:00;NORTE;3;0;3;1
2018-06-21 02:30:00;NORTE;4;0;4;1
2018-06-21 03:00:00;NORTE;1;0;1;1
2018-06-21 03:30:00;NORTE;9;0;9;1
2018-06-21 04:00:00;NORTE;9;0;9;1
2018-06-21 04:30:00;NORTE;13;0;13;1
2018-06-21 05:00:00;NORTE;17;0;17;1
2018-06-21 05:30:00;NORTE;42;0;42;1
2018-06-21 06:00:00;NORTE;26;0;26;1
2018-06-21 06:30:00;NORTE;25;0;25;1
2018-06-21 07:00:00;NORTE;35;0;35;1
2018-06-21 07:30:00;NORTE;29;0;29;1
2018-06-21 08:00:00;NORTE;36;0;36;1
2018-06-21 08:30:00;NORTE;34;0;34;1
2018-06-21 09:00:00;NORTE;25;0;25;1
2018-06-21 09:30:00;NORTE;35;0;35;1
2018-06-21 10:00:00;NORTE;33;0;33;1
2018-06-21 10:30:00;NORTE;33;0;33;1
2018-06-21 11:00:00;NORTE;31;0;31;1
2018-06-21 11:30:00;NORTE;20;0;20;1
2018-06-21 12:00:00;NORTE;26;0;26;1
2018-06-21 12:30:00;NORTE;33;0;33;1
2018-06-21 13:00:00;NORTE;35;0;35;1
2018-06-21 13:30:00;NORTE;34;0;34;1
2018-06-21 14:00:00;NORTE;32;0;32;1
2018-06-21 14:30:00;NORTE;34;0;34;1
2018-06-21 15:00:00;NORTE;32;0;32;1
2018-06-21 15:30:00;NORTE;20;0;20;1
2018-06-21 16:00:00;NORTE;21;0;21;1
2018-06-21 16:30:00;NORTE;29;0;29;1
2018-06-21 17:00:00;NORTE;21;0;21;1
2018-06-21 17:30:00;NORTE;30;0;30;1
2018-06-21 18:00:00;NORTE;36;0;36;1
2018-06-21 18:30:00;NORTE;31;0;31;1
2018-06-21 19:00:00;NORTE;20;0;20;1
2018-06-21 19:30:00;NORTE;34;0;34;1
2018-06-21 20:00:00;NORTE;37;0;37;1
2018-06-21 20:30:00;NORTE;21;0;21;1
2018-06-21 21:00:00;NORTE;26;0;26;1
2018-06-21 21:30:00;NORTE;13;0;13;1
2018-06-21 22:00:00;NORTE;11;0;11;1
2018-06-21 22:30:00;NORTE;5;0;5;1
2018-06-21 23:00:00;NORTE;7;0;7;1
2018-06-21 23:30:00;NORTE;2;0;2;1
2018-06-22 00:00:00;NORTE;2;0;2;1
2018-06-22 01:00:00;NORTE;2;0;2;1
2018-06-22 02:00:00;NORTE;3;0;3;1
2018-06-22 02:30:00;NORTE;3;0;3;1
2018-06-22 03:00:00;NORTE;4;0;4;1
2018-06-22 03:30:00;NORTE;6;0;6;1
2018-06-22 04:00:00;NORTE;10;0;10;1
2018-06-22 04:30:00;NORTE;10;0;10;1
2018-06-22 05:00:00;NORTE;15;0;15;1
2018-06-22 05:30:00;NORTE;37;0;37;1
2018-06-22 06:00:00;NORTE;24;0;24;1
2018-06-22 06:30:00;NORTE;27;0;27;1
2018-06-22 07:00:00;NORTE;33;0;33;1
2018-06-22 07:30:00;NORTE;31;0;31;1
2018-06-22 08:00:00;NORTE;36;0;36;1
2018-06-22 08:30:00;NORTE;30;0;30;1
2018-06-22 09:00:00;NORTE;31;0;31;1
2018-06-22 09:30:00;NORTE;35;0;35;1
2018-06-22 10:00:00;NORTE;29;0;29;1
2018-06-22 10:30:00;NORTE;27;0;27;1
2018-06-22 11:00:00;NORTE;27;0;27;1
2018-06-22 11:30:00;NORTE;22;0;22;1
2018-06-22 12:00:00;NORTE;19;0;19;1
2018-06-22 12:30:00;NORTE;20;0;20;1
2018-06-22 13:00:00;NORTE;16;0;16;1
2018-06-22 13:30:00;NORTE;16;0;16;1
2018-06-22 14:00:00;NORTE;28;0;28;1
2018-06-22 14:30:00;NORTE;24;0;24;1
2018-06-22 15:00:00;NORTE;12;0;12;1
2018-06-22 15:30:00;NORTE;16;0;16;1
2018-06-22 16:00:00;NORTE;16;0;16;1
2018-06-22 16:30:00;NORTE;14;0;14;1
2018-06-22 17:00:00;NORTE;7;0;7;1
2018-06-22 17:30:00;NORTE;16;0;16;1
2018-06-22 18:00:00;NORTE;24;0;24;1
2018-06-22 18:30:00;NORTE;20;0;20;1
2018-06-22 19:00:00;NORTE;16;0;16;1
2018-06-22 19:30:00;NORTE;20;0;20;1
2018-06-22 20:00:00;NORTE;14;0;14;1
2018-06-22 20:30:00;NORTE;19;0;19;1
2018-06-22 21:00:00;NORTE;10;0;10;1
2018-06-22 21:30:00;NORTE;11;0;11;1
2018-06-22 22:00:00;NORTE;15;0;15;1
2018-06-22 22:30:00;NORTE;5;0;5;1
2018-06-22 23:00:00;NORTE;4;0;4;1
2018-06-22 23:30:00;NORTE;1;0;1;1
2018-06-23 00:00:00;NORTE;2;0;2;1
2018-06-23 01:00:00;NORTE;1;0;1;1
2018-06-23 01:30:00;NORTE;1;0;1;1
2018-06-23 02:00:00;NORTE;2;0;2;1
2018-06-23 02:30:00;NORTE;4;0;4;1
2018-06-23 03:00:00;NORTE;3;0;3;1
2018-06-23 03:30:00;NORTE;3;0;3;1
2018-06-23 04:00:00;NORTE;11;0;11;1
2018-06-23 04:30:00;NORTE;12;0;12;1
2018-06-23 05:00:00;NORTE;12;0;12;1
2018-06-23 05:30:00;NORTE;38;0;38;1
2018-06-23 06:00:00;NORTE;16;0;16;1
2018-06-23 06:30:00;NORTE;27;0;27;1
2018-06-23 07:00:00;NORTE;33;0;33;1
2018-06-23 07:30:00;NORTE;22;0;22;1
2018-06-23 08:00:00;NORTE;37;0;37;1
2018-06-23 08:30:00;NORTE;26;0;26;1
2018-06-23 09:00:00;NORTE;18;0;18;1
2018-06-23 09:30:00;NORTE;29;0;29;1
2018-06-23 10:00:00;NORTE;21;0;21;1
2018-06-23 10:30:00;NORTE;26;0;26;1
2018-06-23 11:00:00;NORTE;20;0;20;1
2018-06-23 11:30:00;NORTE;16;0;16;1
2018-06-23 12:00:00;NORTE;18;0;18;1
2018-06-23 12:30:00;NORTE;21;0;21;1
2018-06-23 13:00:00;NORTE;18;0;18;1
2018-06-23 13:30:00;NORTE;16;0;16;1
2018-06-23 14:00:00;NORTE;32;0;32;1
2018-06-23 14:30:00;NORTE;27;0;27;1
2018-06-23 15:00:00;NORTE;17;0;17;1
2018-06-23 15:30:00;NORTE;15;0;15;1
2018-06-23 16:00:00;NORTE;21;0;21;1
2018-06-23 16:30:00;NORTE;14;0;14;1
2018-06-23 17:00:00;NORTE;12;0;12;1
2018-06-23 17:30:00;NORTE;19;0;19;1
2018-06-23 18:00:00;NORTE;20;0;20;1
2018-06-23 18:30:00;NORTE;25;0;25;1
2018-06-23 19:00:00;NORTE;16;0;16;1
2018-06-23 19:30:00;NORTE;23;0;23;1
2018-06-23 20:00:00;NORTE;23;0;23;1
2018-06-23 20:30:00;NORTE;13;0;13;1
2018-06-23 21:00:00;NORTE;18;0;18;1
2018-06-23 21:30:00;NORTE;14;0;14;1
2018-06-23 22:00:00;NORTE;13;0;13;1
2018-06-23 22:30:00;NORTE;8;0;8;1
2018-06-23 23:00:00;NORTE;5;0;5;1
2018-06-23 23:30:00;NORTE;3;0;3;1
2018-06-24 00:00:00;NORTE;2;0;2;1
2018-06-24 00:30:00;NORTE;3;0;3;1
2018-06-24 01:00:00;NORTE;2;0;2;1
2018-06-24 01:30:00;NORTE;1;0;1;1
2018-06-24 02:00:00;NORTE;3;0;3;1
2018-06-24 02:30:00;NORTE;3;0;3;1
2018-06-24 03:00:00;NORTE;1;0;1;1
2018-06-24 03:30:00;NORTE;4;0;4;1
2018-06-24 04:00:00;NORTE;8;0;8;1
2018-06-24 04:30:00;NORTE;9;0;9;1
2018-06-24 05:00:00;NORTE;13;0;13;1
2018-06-24 05:30:00;NORTE;30;0;30;1
2018-06-24 06:00:00;NORTE;16;0;16;1
2018-06-24 06:30:00;NORTE;18;0;18;1
2018-06-24 07:00:00;NORTE;36;0;36;1
2018-06-24 07:30:00;NORTE;23;0;23;1
2018-06-24 08:00:00;NORTE;31;0;31;1
2018-06-24 08:30:00;NORTE;30;0;30;1
2018-06-24 09:00:00;NORTE;19;0;19;1
2018-06-24 09:30:00;NORTE;33;0;33;1
2018-06-24 10:00:00;NORTE;34;0;34;1
2018-06-24 10:30:00;NORTE;33;0;33;1
2018-06-24 11:00:00;NORTE;24;0;24;1
2018-06-24 11:30:00;NORTE;19;0;19;1
2018-06-24 12:00:00;NORTE;22;0;22;1
2018-06-24 12:30:00;NORTE;20;0;20;1
2018-06-24 13:00:00;NORTE;13;0;13;1
2018-06-24 13:30:00;NORTE;13;0;13;1
2018-06-24 14:00:00;NORTE;18;0;18;1
2018-06-24 14:30:00;NORTE;22;0;22;1
2018-06-24 15:00:00;NORTE;33;0;33;1
2018-06-24 15:30:00;NORTE;23;0;23;1
2018-06-24 16:00:00;NORTE;16;0;16;1
2018-06-24 16:30:00;NORTE;22;0;22;1
2018-06-24 17:00:00;NORTE;12;0;12;1
2018-06-24 17:30:00;NORTE;21;0;21;1
2018-06-24 18:00:00;NORTE;14;0;14;1
2018-06-24 18:30:00;NORTE;28;0;28;1
2018-06-24 19:00:00;NORTE;21;0;21;1
2018-06-24 19:30:00;NORTE;20;0;20;1
2018-06-24 20:00:00;NORTE;33;0;33;1
2018-06-24 20:30:00;NORTE;16;0;16;1
2018-06-24 21:00:00;NORTE;20;0;20;1
2018-06-24 21:30:00;NORTE;19;0;19;1
2018-06-24 22:00:00;NORTE;13;0;13;1
2018-06-24 22:30:00;NORTE;17;0;17;1
2018-06-24 23:00:00;NORTE;6;0;6;1
2018-06-24 23:30:00;NORTE;3;0;3;1
2018-06-25 00:00:00;NORTE;3;0;3;1
2018-06-25 00:30:00;NORTE;2;0;2;1
2018-06-25 01:00:00;NORTE;3;0;3;1
2018-06-25 01:30:00;NORTE;1;0;1;1
2018-06-25 02:00:00;NORTE;5;0;5;1
2018-06-25 02:30:00;NORTE;4;0;4;1
2018-06-25 03:00:00;NORTE;1;0;1;1
2018-06-25 03:30:00;NORTE;4;0;4;1
2018-06-25 04:00:00;NORTE;12;0;12;1
2018-06-25 04:30:00;NORTE;9;0;9;1
2018-06-25 05:00:00;NORTE;17;0;17;1
2018-06-25 05:30:00;NORTE;42;0;42;1
2018-06-25 06:00:00;NORTE;19;0;19;1
2018-06-25 06:30:00;NORTE;23;0;23;1
2018-06-25 07:00:00;NORTE;30;0;30;1
2018-06-25 07:30:00;NORTE;24;0;24;1
2018-06-25 08:00:00;NORTE;34;0;34;1
2018-06-25 08:30:00;NORTE;28;0;28;1
2018-06-25 09:00:00;NORTE;22;0;22;1
2018-06-25 09:30:00;NORTE;39;0;39;1
2018-06-25 10:00:00;NORTE;34;0;34;1
2018-06-25 10:30:00;NORTE;30;0;30;1
2018-06-25 11:00:00;NORTE;36;0;36;1
2018-06-25 11:30:00;NORTE;20;0;20;1
2018-06-25 12:00:00;NORTE;26;0;26;1
2018-06-25 12:30:00;NORTE;28;0;28;1
2018-06-25 13:00:00;NORTE;38;0;38;1
2018-06-25 13:30:00;NORTE;33;0;33;1
2018-06-25 14:00:00;NORTE;33;0;33;1
2018-06-25 14:30:00;NORTE;34;0;34;1
2018-06-25 15:00:00;NORTE;33;0;33;1
2018-06-25 15:30:00;NORTE;23;0;23;1
2018-06-25 16:00:00;NORTE;22;0;22;1
2018-06-25 16:30:00;NORTE;25;0;25;1
2018-06-25 17:00:00;NORTE;18;0;18;1
2018-06-25 17:30:00;NORTE;30;0;30;1
2018-06-25 18:00:00;NORTE;36;0;36;1
2018-06-25 18:30:00;NORTE;32;0;32;1
2018-06-25 19:00:00;NORTE;31;0;31;1
2018-06-25 19:30:00;NORTE;29;0;29;1
2018-06-25 20:00:00;NORTE;26;0;26;1
2018-06-25 20:30:00;NORTE;26;0;26;1
2018-06-25 21:00:00;NORTE;17;0;17;1
2018-06-25 21:30:00;NORTE;17;0;17;1
2018-06-25 22:00:00;NORTE;18;0;18;1
2018-06-25 22:30:00;NORTE;8;0;8;1
2018-06-25 23:00:00;NORTE;2;0;2;1
2018-06-25 23:30:00;NORTE;1;0;1;1
2018-06-26 00:00:00;NORTE;1;0;1;1
2018-06-26 01:00:00;NORTE;1;0;1;1
2018-06-26 01:30:00;NORTE;1;0;1;1
2018-06-26 02:00:00;NORTE;4;0;4;1
2018-06-26 02:30:00;NORTE;2;0;2;1
2018-06-26 03:00:00;NORTE;4;0;4;1
2018-06-26 03:30:00;NORTE;7;0;7;1
2018-06-26 04:00:00;NORTE;13;0;13;1
2018-06-26 04:30:00;NORTE;11;0;11;1
2018-06-26 05:00:00;NORTE;17;0;17;1
2018-06-26 05:30:00;NORTE;39;0;39;1
2018-06-26 06:00:00;NORTE;18;0;18;1
2018-06-26 06:30:00;NORTE;25;0;25;1
2018-06-26 07:00:00;NORTE;33;0;33;1
2018-06-26 07:30:00;SUR;0;18;18;1
2018-06-26 08:00:00;SUR;0;31;31;1
2018-06-26 08:30:00;SUR;0;30;30;1
2018-06-26 09:00:00;SUR;0;23;23;1
2018-06-26 09:30:00;SUR;0;26;26;1
2018-06-26 10:00:00;SUR;0;33;33;1
2018-06-26 10:30:00;SUR;0;31;31;1
2018-06-26 11:00:00;SUR;0;30;30;1
2018-06-26 11:30:00;SUR;0;36;36;1
2018-06-26 12:00:00;SUR;0;21;21;1
2018-06-26 12:30:00;SUR;0;30;30;1
2018-06-26 13:00:00;SUR;0;29;29;1
2018-06-26 13:30:00;SUR;0;22;22;1
2018-06-26 14:00:00;SUR;0;31;31;1
2018-06-26 14:30:00;SUR;0;37;37;1
2018-06-26 15:00:00;SUR;0;25;25;1
2018-06-26 15:30:00;SUR;0;21;21;1
2018-06-26 16:00:00;SUR;0;16;16;1
2018-06-26 16:30:00;SUR;0;27;27;1
2018-06-26 17:00:00;SUR;0;30;30;1
2018-06-26 17:30:00;SUR;0;20;20;1
2018-06-26 18:00:00;SUR;0;28;28;1
2018-06-26 18:30:00;SUR;0;30;30;1
2018-06-26 19:00:00;SUR;0;28;28;1
2018-06-26 19:30:00;SUR;0;29;29;1
2018-06-26 20:00:00;SUR;0;25;25;1
2018-06-26 20:30:00;SUR;0;21;21;1
2018-06-26 21:00:00;SUR;0;23;23;1
2018-06-26 21:30:00;SUR;0;15;15;1
2018-06-26 22:00:00;CONFLICTIVA;7;8;15;2
2018-06-26 22:30:00;NORTE;6;0;6;1
2018-06-26 23:00:00;NORTE;8;0;8;1
2018-06-26 23:30:00;NORTE;3;0;3;1
2018-06-27 00:00:00;NORTE;5;0;5;1
2018-06-27 00:30:00;NORTE;2;0;2;1
2018-06-27 01:00:00;NORTE;2;0;2;1
2018-06-27 01:30:00;NORTE;2;0;2;1
2018-06-27 02:00:00;NORTE;3;0;3;1
2018-06-27 02:30:00;NORTE;2;0;2;1
2018-06-27 03:00:00;NORTE;3;0;3;1
2018-06-27 03:30:00;NORTE;6;0;6;1
2018-06-27 04:00:00;NORTE;11;0;11;1
2018-06-27 04:30:00;NORTE;12;0;12;1
2018-06-27 05:00:00;NORTE;13;0;13;1
2018-06-27 05:30:00;NORTE;43;0;43;1
2018-06-27 06:00:00;NORTE;23;0;23;1
2018-06-27 06:30:00;NORTE;18;0;18;1
2018-06-27 07:00:00;NORTE;39;0;39;1
2018-06-27 07:30:00;NORTE;36;0;36;1
2018-06-27 08:00:00;NORTE;28;0;28;1
2018-06-27 08:30:00;NORTE;22;0;22;1
2018-06-27 09:00:00;NORTE;26;0;26;1
2018-06-27 09:30:00;NORTE;18;0;18;1
2018-06-27 10:00:00;NORTE;30;0;30;1
2018-06-27 10:30:00;NORTE;23;0;23;1
2018-06-27 11:00:00;NORTE;20;0;20;1
2018-06-27 11:30:00;NORTE;15;0;15;1
2018-06-27 12:00:00;SUR;0;1;1;1
2018-06-27 12:30:00;SUR;0;20;20;1
2018-06-27 13:00:00;SUR;0;26;26;1
2018-06-27 13:30:00;SUR;0;4;4;1
2018-06-27 14:00:00;SUR;0;23;23;1
2018-06-27 14:30:00;SUR;0;38;38;1
2018-06-27 15:00:00;SUR;0;34;34;1
2018-06-27 15:30:00;SUR;0;21;21;1
2018-06-27 16:00:00;SUR;0;23;23;1
2018-06-27 16:30:00;CONFLICTIVA;12;6;18;2
2018-06-27 17:00:00;NORTE;30;0;30;1
2018-06-27 17:30:00;NORTE;22;0;22;1
2018-06-27 18:00:00;NORTE;41;0;41;1
2018-06-27 18:30:00;NORTE;30;0;30;1
2018-06-27 19:00:00;NORTE;29;0;29;1
2018-06-27 19:30:00;NORTE;26;0;26;1
2018-06-27 20:00:00;NORTE;34;0;34;1
2018-06-27 20:30:00;NORTE;26;0;26;1
2018-06-27 21:00:00;NORTE;17;0;17;1
2018-06-27 21:30:00;NORTE;16;0;16;1
2018-06-27 22:00:00;NORTE;16;0;16;1
2018-06-27 22:30:00;NORTE;13;0;13;1
2018-06-27 23:00:00;NORTE;3;0;3;1
2018-06-27 23:30:00;NORTE;1;0;1;1
2018-06-28 00:00:00;NORTE;3;0;3;1
2018-06-28 00:30:00;NORTE;1;0;1;1
2018-06-28 01:00:00;NORTE;1;0;1;1
2018-06-28 01:30:00;NORTE;1;0;1;1
2018-06-28 02:00:00;NORTE;2;0;2;1
2018-06-28 02:30:00;NORTE;4;0;4;1
2018-06-28 03:00:00;NORTE;4;0;4;1
2018-06-28 03:30:00;NORTE;5;0;5;1
2018-06-28 04:00:00;NORTE;14;0;14;1
2018-06-28 04:30:00;NORTE;10;0;10;1
2018-06-28 05:00:00;NORTE;16;0;16;1
2018-06-28 05:30:00;NORTE;40;0;40;1
2018-06-28 06:00:00;NORTE;26;0;26;1
2018-06-28 06:30:00;NORTE;22;0;22;1
2018-06-28 07:00:00;NORTE;25;0;25;1
2018-06-28 07:30:00;NORTE;27;0;27;1
2018-06-28 08:00:00;NORTE;33;0;33;1
2018-06-28 08:30:00;NORTE;38;0;38;1
2018-06-28 09:00:00;NORTE;24;0;24;1
2018-06-28 09:30:00;NORTE;25;0;25;1
2018-06-28 10:00:00;NORTE;34;0;34;1
2018-06-28 10:30:00;NORTE;36;0;36;1
2018-06-28 11:00:00;NORTE;23;0;23;1
2018-06-28 11:30:00;NORTE;27;0;27;1
2018-06-28 12:00:00;NORTE;25;0;25;1
2018-06-28 12:30:00;NORTE;29;0;29;1
2018-06-28 13:00:00;NORTE;30;0;30;1
2018-06-28 13:30:00;NORTE;35;0;35;1
2018-06-28 14:00:00;NORTE;30;0;30;1
2018-06-28 14:30:00;NORTE;39;0;39;1
2018-06-28 15:00:00;NORTE;29;0;29;1
2018-06-28 15:30:00;NORTE;21;0;21;1
2018-06-28 16:00:00;NORTE;20;0;20;1
2018-06-28 16:30:00;NORTE;33;0;33;1
2018-06-28 17:00:00;CONFLICTIVA;12;11;23;2
2018-06-28 17:30:00;SUR;0;21;21;1
2018-06-28 18:00:00;SUR;0;33;33;1
2018-06-28 18:30:00;SUR;0;31;31;1
2018-06-28 19:00:00;SUR;0;31;31;1
2018-06-28 19:30:00;SUR;0;24;24;1
2018-06-28 20:00:00;SUR;0;22;22;1
2018-06-28 20:30:00;SUR;0;34;34;1
2018-06-28 21:00:00;SUR;0;19;19;1
2018-06-28 21:30:00;NORTE;18;0;18;1
2018-06-28 22:00:00;NORTE;15;0;15;1
2018-06-28 22:30:00;NORTE;18;0;18;1
2018-06-28 23:00:00;NORTE;7;0;7;1
2018-06-29 00:00:00;NORTE;3;0;3;1
2018-06-29 01:00:00;NORTE;2;0;2;1
2018-06-29 02:00:00;NORTE;5;0;5;1
2018-06-29 02:30:00;NORTE;2;0;2;1
2018-06-29 03:00:00;NORTE;3;0;3;1
2018-06-29 03:30:00;NORTE;6;0;6;1
2018-06-29 04:00:00;NORTE;11;0;11;1
2018-06-29 04:30:00;NORTE;10;0;10;1
2018-06-29 05:00:00;NORTE;11;0;11;1
2018-06-29 05:30:00;NORTE;37;0;37;1
2018-06-29 06:00:00;NORTE;27;0;27;1
2018-06-29 06:30:00;NORTE;21;0;21;1
2018-06-29 07:00:00;NORTE;33;0;33;1
2018-06-29 07:30:00;NORTE;36;0;36;1
2018-06-29 08:00:00;NORTE;33;0;33;1
2018-06-29 08:30:00;NORTE;35;0;35;1
2018-06-29 09:00:00;NORTE;29;0;29;1
2018-06-29 09:30:00;NORTE;29;0;29;1
2018-06-29 10:00:00;NORTE;33;0;33;1
2018-06-29 10:30:00;NORTE;35;0;35;1
2018-06-29 11:00:00;NORTE;31;0;31;1
2018-06-29 11:30:00;CONFLICTIVA;3;18;21;2
2018-06-29 12:00:00;SUR;0;27;27;1
2018-06-29 12:30:00;SUR;0;31;31;1
2018-06-29 13:00:00;SUR;0;30;30;1
2018-06-29 13:30:00;SUR;0;29;29;1
2018-06-29 14:00:00;SUR;0;27;27;1
2018-06-29 14:30:00;SUR;0;29;29;1
2018-06-29 15:00:00;SUR;0;37;37;1
2018-06-29 15:30:00;SUR;0;27;27;1
2018-06-29 16:00:00;SUR;0;25;25;1
2018-06-29 16:30:00;SUR;0;25;25;1
2018-06-29 17:00:00;SUR;0;20;20;1
2018-06-29 17:30:00;SUR;0;20;20;1
2018-06-29 18:00:00;SUR;0;22;22;1
2018-06-29 18:30:00;NORTE;28;1;29;1
2018-06-29 19:00:00;NORTE;32;0;32;1
2018-06-29 19:30:00;NORTE;28;0;28;1
2018-06-29 20:00:00;NORTE;26;0;26;1
2018-06-29 20:30:00;NORTE;31;0;31;1
2018-06-29 21:00:00;NORTE;25;0;25;1
2018-06-29 21:30:00;NORTE;12;0;12;1
2018-06-29 22:00:00;NORTE;17;0;17;1
2018-06-29 22:30:00;NORTE;18;0;18;1
2018-06-29 23:00:00;NORTE;8;0;8;1
2018-06-29 23:30:00;NORTE;2;0;2;1
2018-06-30 00:00:00;NORTE;2;0;2;1
2018-06-30 01:00:00;NORTE;3;0;3;1
2018-06-30 01:30:00;NORTE;1;0;1;1
2018-06-30 02:00:00;NORTE;1;0;1;1
2018-06-30 02:30:00;NORTE;7;0;7;1
2018-06-30 03:00:00;NORTE;1;0;1;1
2018-06-30 03:30:00;NORTE;6;0;6;1
2018-06-30 04:00:00;NORTE;8;0;8;1
2018-06-30 04:30:00;NORTE;14;0;14;1
2018-06-30 05:00:00;NORTE;9;0;9;1
2018-06-30 05:30:00;NORTE;33;0;33;1
2018-06-30 06:00:00;NORTE;20;0;20;1
2018-06-30 06:30:00;NORTE;22;0;22;1
2018-06-30 07:00:00;NORTE;35;0;35;1
2018-06-30 07:30:00;NORTE;29;0;29;1
2018-06-30 08:00:00;NORTE;29;0;29;1
2018-06-30 08:30:00;NORTE;27;0;27;1
2018-06-30 09:00:00;NORTE;22;0;22;1
2018-06-30 09:30:00;NORTE;29;0;29;1
2018-06-30 10:00:00;NORTE;31;0;31;1
2018-06-30 10:30:00;NORTE;30;0;30;1
2018-06-30 11:00:00;NORTE;11;0;11;1
2018-06-30 11:08:00;NORTE;10;0;10;1
2018-06-30 11:18:00;NORTE;7;0;7;1
2018-06-30 11:30:00;NORTE;12;0;12;1
2018-06-30 11:47:00;NORTE;11;0;11;1
2018-06-30 12:00:00;NORTE;17;0;17;1
2018-06-30 12:30:00;NORTE;27;0;27;1
2018-06-30 13:00:00;NORTE;24;0;24;1
2018-06-30 13:30:00;NORTE;31;0;31;1
2018-06-30 14:00:00;NORTE;35;0;35;1
2018-06-30 14:30:00;CONFLICTIVA;23;3;26;2
2018-06-30 15:00:00;SUR;0;32;32;1
2018-06-30 15:30:00;SUR;0;18;18;1
2018-06-30 16:00:00;SUR;0;18;18;1
2018-06-30 16:30:00;SUR;0;18;18;1
2018-06-30 17:00:00;SUR;0;20;20;1
2018-06-30 17:30:00;SUR;0;18;18;1
2018-06-30 18:00:00;SUR;0;31;31;1
2018-06-30 18:30:00;SUR;0;22;22;1
2018-06-30 19:00:00;SUR;0;21;21;1
2018-06-30 19:30:00;CONFLICTIVA;9;8;17;2
2018-06-30 20:00:00;NORTE;23;0;23;1
2018-06-30 20:30:00;NORTE;20;0;20;1
2018-06-30 21:00:00;NORTE;9;0;9;1
2018-06-30 21:30:00;NORTE;12;0;12;1
2018-06-30 22:00:00;NORTE;17;0;17;1
2018-06-30 22:30:00;NORTE;8;0;8;1
2018-06-30 23:00:00;NORTE;7;0;7;1
2018-06-30 23:30:00;NORTE;7;0;7;1
2018-07-01 00:00:00;NORTE;1;0;1;1
2018-07-01 00:30:00;NORTE;2;0;2;1
2018-07-01 01:00:00;NORTE;2;0;2;1
2018-07-01 01:30:00;NORTE;1;0;1;1
2018-07-01 02:00:00;NORTE;4;0;4;1
2018-07-01 02:30:00;NORTE;3;0;3;1
2018-07-01 03:30:00;NORTE;5;0;5;1
2018-07-01 04:00:00;NORTE;5;0;5;1
2018-07-01 04:30:00;NORTE;14;0;14;1
2018-07-01 05:00:00;NORTE;14;0;14;1
2018-07-01 05:30:00;NORTE;28;0;28;1
2018-07-01 06:00:00;NORTE;17;0;17;1
2018-07-01 06:30:00;NORTE;21;0;21;1
2018-07-01 07:00:00;NORTE;25;0;25;1
2018-07-01 07:30:00;NORTE;35;0;35;1
2018-07-01 08:00:00;NORTE;28;0;28;1
2018-07-01 08:30:00;NORTE;32;0;32;1
2018-07-01 09:00:00;CONFLICTIVA;9;9;18;2
2018-07-01 09:30:00;SUR;0;26;26;1
2018-07-01 10:00:00;SUR;0;37;37;1
2018-07-01 10:30:00;SUR;0;29;29;1
2018-07-01 11:00:00;SUR;0;25;25;1
2018-07-01 11:30:00;SUR;0;19;19;1
2018-07-01 12:00:00;SUR;0;29;29;1
2018-07-01 12:30:00;SUR;0;19;19;1
2018-07-01 13:00:00;SUR;0;24;24;1
2018-07-01 13:30:00;SUR;0;27;27;1
2018-07-01 14:00:00;SUR;0;35;35;1
2018-07-01 14:30:00;SUR;0;30;30;1
2018-07-01 15:00:00;SUR;0;28;28;1
2018-07-01 15:30:00;SUR;0;21;21;1
2018-07-01 16:00:00;SUR;0;15;15;1
2018-07-01 16:30:00;SUR;0;27;27;1
2018-07-01 17:00:00;SUR;0;15;15;1
2018-07-01 17:30:00;SUR;0;26;26;1
2018-07-01 18:00:00;SUR;0;27;27;1
2018-07-01 18:30:00;SUR;0;29;29;1
2018-07-01 19:00:00;SUR;0;28;28;1
2018-07-01 19:30:00;SUR;0;30;30;1
2018-07-01 20:00:00;SUR;0;27;27;1
2018-07-01 20:30:00;SUR;0;32;32;1
2018-07-01 21:00:00;SUR;0;15;15;1
2018-07-01 21:30:00;SUR;0;16;16;1
2018-07-01 22:00:00;SUR;0;20;20;1
2018-07-01 22:30:00;SUR;0;10;10;1
2018-07-01 23:00:00;CONFLICTIVA;6;4;10;2
2018-07-01 23:30:00;NORTE;5;0;5;1
2018-07-02 00:00:00;NORTE;4;0;4;1
2018-07-02 00:30:00;NORTE;2;0;2;1
2018-07-02 01:00:00;NORTE;2;0;2;1
2018-07-02 01:30:00;NORTE;3;0;3;1
2018-07-02 02:00:00;NORTE;2;0;2;1
2018-07-02 02:30:00;NORTE;2;0;2;1
2018-07-02 03:00:00;NORTE;3;0;3;1
2018-07-02 03:30:00;NORTE;5;0;5;1
2018-07-02 04:00:00;NORTE;10;0;10;1
2018-07-02 04:30:00;NORTE;14;0;14;1
2018-07-02 05:00:00;NORTE;16;0;16;1
2018-07-02 05:30:00;NORTE;36;0;36;1
2018-07-02 06:00:00;NORTE;19;0;19;1
2018-07-02 06:30:00;NORTE;22;0;22;1
2018-07-02 07:00:00;NORTE;39;0;39;1
2018-07-02 07:30:00;NORTE;33;0;33;1
2018-07-02 08:00:00;NORTE;35;0;35;1
2018-07-02 08:30:00;NORTE;37;0;37;1
2018-07-02 09:00:00;NORTE;28;0;28;1
2018-07-02 09:30:00;NORTE;33;0;33;1
2018-07-02 10:00:00;NORTE;32;0;32;1
2018-07-02 10:30:00;NORTE;34;0;34;1
2018-07-02 11:00:00;CONFLICTIVA;9;12;21;2
2018-07-02 11:30:00;SUR;0;26;26;1
2018-07-02 12:00:00;SUR;0;29;29;1
2018-07-02 12:30:00;SUR;0;27;27;1
2018-07-02 13:00:00;SUR;0;28;28;1
2018-07-02 13:30:00;SUR;0;31;31;1
2018-07-02 14:00:00;SUR;0;24;24;1
2018-07-02 14:30:00;SUR;0;34;34;1
2018-07-02 15:00:00;SUR;0;32;32;1
2018-07-02 15:30:00;SUR;1;18;19;1
2018-07-02 16:00:00;SUR;0;13;13;1
2018-07-02 16:30:00;SUR;0;31;31;1
2018-07-02 17:00:00;SUR;0;25;25;1
2018-07-02 17:30:00;SUR;0;26;26;1
2018-07-02 18:00:00;SUR;0;29;29;1
2018-07-02 18:30:00;SUR;0;35;35;1
2018-07-02 19:00:00;SUR;0;23;23;1
2018-07-02 19:30:00;SUR;0;26;26;1
2018-07-02 20:00:00;SUR;0;34;34;1
2018-07-02 20:30:00;SUR;0;19;19;1
2018-07-02 21:00:00;SUR;0;14;14;1
2018-07-02 21:30:00;SUR;0;12;12;1
2018-07-02 22:00:00;SUR;0;13;13;1
2018-07-02 22:30:00;SUR;0;13;13;1
2018-07-02 23:00:00;SUR;0;4;4;1
2018-07-02 23:30:00;SUR;0;1;1;1
2018-07-03 00:00:00;SUR;0;2;2;1
2018-07-03 01:00:00;SUR;0;1;1;1
2018-07-03 01:30:00;SUR;0;2;2;1
2018-07-03 02:00:00;SUR;0;1;1;1
2018-07-03 02:30:00;SUR;0;5;5;1
2018-07-03 03:00:00;SUR;0;1;1;1
2018-07-03 03:30:00;SUR;0;9;9;1
2018-07-03 04:00:00;CONFLICTIVA;3;4;7;2
2018-07-03 04:30:00;NORTE;15;0;15;1
2018-07-03 05:00:00;NORTE;21;0;21;1
2018-07-03 05:30:00;NORTE;39;0;39;1
2018-07-03 06:00:00;NORTE;16;0;16;1
2018-07-03 06:30:00;NORTE;15;0;15;1
2018-07-03 07:00:00;NORTE;38;0;38;1
2018-07-03 07:30:00;NORTE;24;0;24;1
2018-07-03 08:00:00;NORTE;34;0;34;1
2018-07-03 08:30:00;NORTE;31;0;31;1
2018-07-03 09:00:00;NORTE;24;0;24;1
2018-07-03 09:30:00;NORTE;31;0;31;1
2018-07-03 10:00:00;NORTE;31;0;31;1
2018-07-03 10:30:00;NORTE;32;0;32;1
2018-07-03 11:00:00;CONFLICTIVA;4;16;20;2
2018-07-03 11:30:00;SUR;0;21;21;1
2018-07-03 12:00:00;SUR;0;23;23;1
2018-07-03 12:30:00;SUR;0;31;31;1
2018-07-03 13:00:00;SUR;0;22;22;1
2018-07-03 13:30:00;SUR;0;26;26;1
2018-07-03 14:00:00;SUR;0;37;37;1
2018-07-03 14:30:00;SUR;0;25;25;1
2018-07-03 15:00:00;SUR;0;33;33;1
2018-07-03 15:30:00;SUR;0;17;17;1
2018-07-03 16:00:00;SUR;0;20;20;1
2018-07-03 16:30:00;SUR;0;26;26;1
2018-07-03 17:00:00;SUR;0;21;21;1
2018-07-03 17:30:00;SUR;0;26;26;1
2018-07-03 18:00:00;SUR;0;25;25;1
2018-07-03 18:30:00;SUR;0;31;31;1
2018-07-03 19:00:00;CONFLICTIVA;9;16;25;2
2018-07-03 19:30:00;NORTE;26;0;26;1
2018-07-03 20:00:00;NORTE;36;0;36;1
2018-07-03 20:30:00;NORTE;32;0;32;1
2018-07-03 21:00:00;NORTE;13;0;13;1
2018-07-03 21:30:00;NORTE;22;0;22;1
2018-07-03 22:00:00;NORTE;14;0;14;1
2018-07-03 22:30:00;NORTE;9;0;9;1
2018-07-03 23:00:00;NORTE;2;0;2;1
2018-07-03 23:30:00;NORTE;1;0;1;1
2018-07-04 00:00:00;NORTE;2;0;2;1
2018-07-04 00:30:00;NORTE;1;0;1;1
2018-07-04 01:00:00;NORTE;3;0;3;1
2018-07-04 01:30:00;NORTE;1;0;1;1
2018-07-04 02:00:00;NORTE;5;0;5;1
2018-07-04 02:30:00;NORTE;1;0;1;1
2018-07-04 03:00:00;NORTE;3;0;3;1
2018-07-04 03:30:00;NORTE;7;0;7;1
2018-07-04 04:00:00;NORTE;15;0;15;1
2018-07-04 04:30:00;NORTE;13;0;13;1
2018-07-04 05:00:00;NORTE;18;0;18;1
2018-07-04 05:30:00;NORTE;45;0;45;1
2018-07-04 06:00:00;NORTE;15;0;15;1
2018-07-04 06:30:00;NORTE;25;0;25;1
2018-07-04 07:00:00;NORTE;38;0;38;1
2018-07-04 07:30:00;NORTE;34;0;34;1
2018-07-04 08:00:00;CONFLICTIVA;4;5;9;2
2018-07-04 08:30:00;SUR;0;1;1;1
2018-07-04 09:00:00;SUR;0;10;10;1
2018-07-04 09:30:00;SUR;0;38;38;1
2018-07-04 10:00:00;SUR;0;23;23;1
2018-07-04 10:30:00;SUR;0;22;22;1
2018-07-04 11:00:00;SUR;0;14;14;1
2018-07-04 11:30:00;SUR;0;12;12;1
2018-07-04 12:00:00;SUR;0;4;4;1
2018-07-04 12:30:00;SUR;0;7;7;1
2018-07-04 13:00:00;SUR;0;8;8;1
2018-07-04 13:30:00;SUR;0;4;4;1
2018-07-04 14:00:00;SUR;0;19;19;1
2018-07-04 14:30:00;SUR;0;40;40;1
2018-07-04 15:00:00;SUR;0;27;27;1
2018-07-04 15:30:00;SUR;0;21;21;1
2018-07-04 16:00:00;SUR;0;19;19;1
2018-07-04 16:30:00;SUR;0;29;29;1
2018-07-04 17:00:00;SUR;0;27;27;1
2018-07-04 17:30:00;SUR;0;26;26;1
2018-07-04 18:00:00;SUR;0;32;32;1
2018-07-04 18:30:00;SUR;0;27;27;1
2018-07-04 19:00:00;SUR;0;32;32;1
2018-07-04 19:30:00;SUR;0;31;31;1
2018-07-04 20:00:00;CONFLICTIVA;15;11;26;2
2018-07-04 20:30:00;NORTE;24;0;24;1
2018-07-04 21:00:00;NORTE;23;0;23;1
2018-07-04 21:30:00;NORTE;17;0;17;1
2018-07-04 22:00:00;NORTE;15;0;15;1
2018-07-04 22:30:00;NORTE;14;0;14;1
2018-07-04 23:00:00;NORTE;1;0;1;1
2018-07-04 23:30:00;NORTE;4;0;4;1
2018-07-05 00:00:00;NORTE;5;0;5;1
2018-07-05 00:30:00;NORTE;2;0;2;1
2018-07-05 01:00:00;NORTE;4;0;4;1
2018-07-05 01:30:00;NORTE;2;0;2;1
2018-07-05 02:00:00;NORTE;1;0;1;1
2018-07-05 02:30:00;NORTE;5;0;5;1
2018-07-05 03:30:00;NORTE;9;0;9;1
2018-07-05 04:00:00;NORTE;13;0;13;1
2018-07-05 04:30:00;NORTE;10;0;10;1
2018-07-05 05:00:00;NORTE;17;0;17;1
2018-07-05 05:30:00;NORTE;41;0;41;1
2018-07-05 06:00:00;NORTE;20;0;20;1
2018-07-05 06:30:00;NORTE;25;0;25;1
2018-07-05 07:00:00;NORTE;36;0;36;1
2018-07-05 07:30:00;NORTE;30;0;30;1
2018-07-05 08:00:00;NORTE;34;0;34;1
2018-07-05 08:30:00;NORTE;34;0;34;1
2018-07-05 09:00:00;NORTE;24;0;24;1
2018-07-05 09:30:00;NORTE;35;0;35;1
2018-07-05 10:00:00;NORTE;36;0;36;1
2018-07-05 10:30:00;NORTE;24;0;24;1
2018-07-05 11:00:00;NORTE;26;0;26;1
2018-07-05 11:30:00;NORTE;24;0;24;1
2018-07-05 12:00:00;NORTE;19;0;19;1
2018-07-05 12:30:00;NORTE;17;0;17;1
2018-07-05 13:00:00;NORTE;9;0;9;1
2018-07-05 13:30:00;NORTE;13;0;13;1
2018-07-05 14:00:00;NORTE;9;0;9;1
2018-07-05 15:00:00;NORTE;3;0;3;1
2018-07-05 16:00:00;NORTE;4;0;4;1
2018-07-05 16:30:00;NORTE;2;0;2;1
2018-07-05 17:00:00;NORTE;3;0;3;1
2018-07-05 18:00:00;NORTE;3;0;3;1
2018-07-05 18:30:00;NORTE;5;0;5;1
2018-07-05 19:00:00;NORTE;10;0;10;1
2018-07-05 20:00:00;NORTE;6;0;6;1
2018-07-05 20:30:00;NORTE;6;0;6;1
2018-07-05 21:00:00;NORTE;5;0;5;1
2018-07-05 21:30:00;NORTE;5;0;5;1
2018-07-05 22:00:00;NORTE;2;0;2;1
2018-07-05 22:30:00;NORTE;1;0;1;1
2018-07-05 23:00:00;NORTE;1;0;1;1
2018-07-06 02:30:00;NORTE;2;0;2;1
2018-07-06 03:30:00;NORTE;3;0;3;1
2018-07-06 04:00:00;NORTE;2;0;2;1
2018-07-06 04:30:00;NORTE;5;0;5;1
2018-07-06 05:30:00;NORTE;11;0;11;1
2018-07-06 06:00:00;NORTE;3;0;3;1
2018-07-06 07:00:00;NORTE;30;0;30;1
2018-07-06 07:30:00;NORTE;31;0;31;1
2018-07-06 08:00:00;NORTE;36;0;36;1
2018-07-06 08:30:00;NORTE;30;0;30;1
2018-07-06 09:00:00;NORTE;31;0;31;1
2018-07-06 09:30:00;NORTE;28;0;28;1
2018-07-06 10:00:00;NORTE;33;0;33;1
2018-07-06 10:30:00;NORTE;11;0;11;1
2018-07-06 11:30:00;NORTE;5;0;5;1
2018-07-06 12:00:00;NORTE;15;0;15;1
2018-07-06 12:30:00;NORTE;15;0;15;1
2018-07-06 13:00:00;NORTE;12;0;12;1
2018-07-06 13:30:00;NORTE;2;0;2;1
2018-07-06 14:00:00;NORTE;14;0;14;1
2018-07-06 14:30:00;NORTE;9;0;9;1
2018-07-06 15:00:00;NORTE;21;0;21;1
2018-07-06 15:30:00;NORTE;28;0;28;1
2018-07-06 16:00:00;NORTE;12;0;12;1
2018-07-06 16:30:00;NORTE;24;0;24;1
2018-07-06 17:00:00;NORTE;33;0;33;1
2018-07-06 17:30:00;NORTE;27;0;27;1
2018-07-06 18:00:00;NORTE;28;0;28;1
2018-07-06 18:30:00;NORTE;32;0;32;1
2018-07-06 19:00:00;NORTE;26;0;26;1
2018-07-06 19:30:00;NORTE;28;0;28;1
2018-07-06 20:00:00;NORTE;40;0;40;1
2018-07-06 20:30:00;NORTE;23;0;23;1
2018-07-06 21:00:00;NORTE;13;0;13;1
2018-07-06 21:30:00;NORTE;12;0;12;1
2018-07-06 22:00:00;NORTE;20;0;20;1
2018-07-06 22:30:00;NORTE;11;0;11;1
2018-07-06 23:00:00;NORTE;3;0;3;1
2018-07-06 23:30:00;NORTE;2;0;2;1
2018-07-07 00:00:00;NORTE;1;0;1;1
2018-07-07 00:30:00;NORTE;1;0;1;1
2018-07-07 01:00:00;NORTE;1;0;1;1
2018-07-07 01:30:00;NORTE;1;0;1;1
2018-07-07 02:00:00;NORTE;2;0;2;1
2018-07-07 02:30:00;NORTE;5;0;5;1
2018-07-07 03:30:00;NORTE;3;0;3;1
2018-07-07 04:00:00;NORTE;13;0;13;1
2018-07-07 04:30:00;NORTE;13;0;13;1
2018-07-07 05:00:00;NORTE;13;0;13;1
2018-07-07 05:30:00;NORTE;34;0;34;1
2018-07-07 06:00:00;NORTE;16;0;16;1
2018-07-07 06:30:00;NORTE;24;0;24;1
2018-07-07 07:00:00;NORTE;38;0;38;1
2018-07-07 07:30:00;NORTE;31;0;31;1
2018-07-07 08:00:00;NORTE;38;0;38;1
2018-07-07 08:30:00;NORTE;35;0;35;1
2018-07-07 09:00:00;NORTE;15;0;15;1
2018-07-07 09:30:00;NORTE;32;0;32;1
2018-07-07 10:00:00;NORTE;31;0;31;1
2018-07-07 10:30:00;NORTE;30;0;30;1
2018-07-07 11:00:00;CONFLICTIVA;10;7;17;2
2018-07-07 11:30:00;SUR;0;25;25;1
2018-07-07 12:00:00;SUR;0;29;29;1
2018-07-07 12:30:00;SUR;0;17;17;1
2018-07-07 13:00:00;SUR;0;31;31;1
2018-07-07 13:30:00;SUR;0;28;28;1
2018-07-07 14:00:00;SUR;0;31;31;1
2018-07-07 14:30:00;SUR;0;32;32;1
2018-07-07 15:00:00;SUR;0;20;20;1
2018-07-07 15:30:00;SUR;0;17;17;1
2018-07-07 16:00:00;SUR;0;17;17;1
2018-07-07 16:30:00;SUR;0;23;23;1
2018-07-07 17:00:00;SUR;0;22;22;1
2018-07-07 17:30:00;SUR;0;19;19;1
2018-07-07 18:00:00;SUR;2;21;23;1
2018-07-07 18:30:00;NORTE;26;0;26;1
2018-07-07 19:00:00;NORTE;18;0;18;1
2018-07-07 19:30:00;NORTE;26;0;26;1
2018-07-07 20:00:00;NORTE;21;0;21;1
2018-07-07 20:30:00;NORTE;17;0;17;1
2018-07-07 21:00:00;NORTE;12;0;12;1
2018-07-07 21:30:00;NORTE;13;0;13;1
2018-07-07 22:00:00;NORTE;17;0;17;1
2018-07-07 22:30:00;NORTE;19;0;19;1
2018-07-07 23:00:00;NORTE;7;0;7;1
2018-07-07 23:30:00;NORTE;1;0;1;1
2018-07-08 00:00:00;NORTE;4;0;4;1
2018-07-08 01:00:00;NORTE;2;0;2;1
2018-07-08 01:30:00;NORTE;2;0;2;1
2018-07-08 02:00:00;NORTE;1;0;1;1
2018-07-08 02:30:00;NORTE;5;0;5;1
2018-07-08 03:00:00;NORTE;3;0;3;1
2018-07-08 03:30:00;NORTE;2;0;2;1
2018-07-08 04:00:00;NORTE;14;0;14;1
2018-07-08 04:30:00;NORTE;6;0;6;1
2018-07-08 05:00:00;NORTE;18;0;18;1
2018-07-08 05:30:00;NORTE;28;0;28;1
2018-07-08 06:00:00;NORTE;18;0;18;1
2018-07-08 06:30:00;NORTE;13;0;13;1
2018-07-08 07:00:00;NORTE;32;0;32;1
2018-07-08 07:30:00;NORTE;31;0;31;1
2018-07-08 08:00:00;NORTE;32;0;32;1
2018-07-08 08:30:00;NORTE;31;0;31;1
2018-07-08 09:00:00;NORTE;18;0;18;1
2018-07-08 09:30:00;NORTE;32;0;32;1
2018-07-08 10:00:00;NORTE;32;0;32;1
2018-07-08 10:30:00;NORTE;28;0;28;1
2018-07-08 11:00:00;NORTE;30;0;30;1
2018-07-08 11:30:00;NORTE;26;0;26;1
2018-07-08 12:00:00;NORTE;27;0;27;1
2018-07-08 12:30:00;NORTE;29;0;29;1
2018-07-08 13:00:00;NORTE;29;0;29;1
2018-07-08 13:30:00;NORTE;42;0;42;1
2018-07-08 14:00:00;NORTE;29;0;29;1
2018-07-08 14:30:00;NORTE;31;0;31;1
2018-07-08 15:00:00;NORTE;27;0;27;1
2018-07-08 15:30:00;NORTE;18;0;18;1
2018-07-08 16:00:00;NORTE;11;0;11;1
2018-07-08 16:30:00;NORTE;27;0;27;1
2018-07-08 17:00:00;NORTE;13;0;13;1
2018-07-08 17:30:00;NORTE;30;0;30;1
2018-07-08 18:00:00;NORTE;35;0;35;1
2018-07-08 18:30:00;NORTE;30;0;30;1
2018-07-08 19:00:00;NORTE;33;0;33;1
2018-07-08 19:30:00;NORTE;27;0;27;1
2018-07-08 20:00:00;NORTE;33;0;33;1
2018-07-08 20:30:00;NORTE;28;0;28;1
2018-07-08 21:00:00;NORTE;12;0;12;1
2018-07-08 21:30:00;NORTE;16;0;16;1
2018-07-08 22:00:00;NORTE;20;0;20;1
2018-07-08 22:30:00;NORTE;16;0;16;1
2018-07-08 23:00:00;NORTE;7;0;7;1
2018-07-08 23:30:00;NORTE;3;0;3;1
2018-07-09 00:00:00;NORTE;4;0;4;1
2018-07-09 00:30:00;NORTE;2;0;2;1
2018-07-09 01:00:00;NORTE;2;0;2;1
2018-07-09 01:30:00;NORTE;2;0;2;1
2018-07-09 02:00:00;NORTE;4;0;4;1
2018-07-09 02:30:00;NORTE;4;0;4;1
2018-07-09 03:00:00;NORTE;2;0;2;1
2018-07-09 03:30:00;NORTE;4;0;4;1
2018-07-09 04:00:00;NORTE;9;0;9;1
2018-07-09 04:30:00;NORTE;13;0;13;1
2018-07-09 05:00:00;NORTE;18;0;18;1
2018-07-09 05:30:00;NORTE;44;0;44;1
2018-07-09 06:00:00;NORTE;17;0;17;1
2018-07-09 06:30:00;NORTE;27;1;28;1
2018-07-09 07:00:00;NORTE;41;0;41;1
2018-07-09 07:30:00;NORTE;22;0;22;1
2018-07-09 08:00:00;NORTE;38;0;38;1
2018-07-09 08:30:00;NORTE;30;0;30;1
2018-07-09 09:00:00;NORTE;22;0;22;1
2018-07-09 09:30:00;NORTE;33;0;33;1
2018-07-09 10:00:00;NORTE;36;0;36;1
2018-07-09 10:30:00;NORTE;31;0;31;1
2018-07-09 11:00:00;NORTE;27;0;27;1
2018-07-09 11:30:00;NORTE;30;0;30;1
2018-07-09 12:00:00;NORTE;23;0;23;1
2018-07-09 12:30:00;NORTE;30;0;30;1
2018-07-09 13:00:00;NORTE;32;0;32;1
2018-07-09 13:30:00;NORTE;30;0;30;1
2018-07-09 14:00:00;NORTE;36;0;36;1
2018-07-09 14:30:00;NORTE;32;0;32;1
2018-07-09 15:00:00;NORTE;33;0;33;1
2018-07-09 15:30:00;NORTE;18;0;18;1
2018-07-09 16:00:00;NORTE;20;0;20;1
2018-07-09 16:30:00;NORTE;31;0;31;1
2018-07-09 17:00:00;NORTE;24;0;24;1
2018-07-09 17:30:00;NORTE;23;0;23;1
2018-07-09 18:00:00;NORTE;32;0;32;1
2018-07-09 18:30:00;NORTE;35;0;35;1
2018-07-09 19:00:00;NORTE;25;0;25;1
2018-07-09 19:30:00;NORTE;27;0;27;1
2018-07-09 20:00:00;NORTE;31;0;31;1
2018-07-09 20:30:00;NORTE;24;0;24;1
2018-07-09 21:00:00;NORTE;17;0;17;1
2018-07-09 21:30:00;NORTE;21;0;21;1
2018-07-09 22:00:00;NORTE;15;0;15;1
2018-07-09 22:30:00;NORTE;8;0;8;1
2018-07-09 23:00:00;NORTE;5;0;5;1
2018-07-09 23:30:00;NORTE;1;0;1;1
2018-07-10 00:00:00;NORTE;1;0;1;1
2018-07-10 01:00:00;NORTE;2;0;2;1
2018-07-10 01:30:00;NORTE;2;0;2;1
2018-07-10 02:00:00;NORTE;1;0;1;1
2018-07-10 02:30:00;NORTE;4;0;4;1
2018-07-10 03:00:00;NORTE;3;0;3;1
2018-07-10 03:30:00;NORTE;4;0;4;1
2018-07-10 04:00:00;NORTE;15;0;15;1
2018-07-10 04:30:00;NORTE;11;0;11;1
2018-07-10 05:00:00;NORTE;14;0;14;1
2018-07-10 05:30:00;NORTE;40;0;40;1
2018-07-10 06:00:00;NORTE;23;0;23;1
2018-07-10 06:30:00;NORTE;20;0;20;1
2018-07-10 07:00:00;NORTE;37;0;37;1
2018-07-10 07:30:00;NORTE;27;0;27;1
2018-07-10 08:00:00;NORTE;36;0;36;1
2018-07-10 08:30:00;NORTE;35;0;35;1
2018-07-10 09:00:00;NORTE;21;0;21;1
2018-07-10 09:30:00;NORTE;28;0;28;1
2018-07-10 10:00:00;NORTE;34;0;34;1
2018-07-10 10:30:00;NORTE;44;0;44;1
2018-07-10 11:00:00;NORTE;30;0;30;1
2018-07-10 11:30:00;NORTE;26;0;26;1
2018-07-10 12:00:00;NORTE;26;0;26;1
2018-07-10 12:30:00;NORTE;27;0;27;1
2018-07-10 13:00:00;NORTE;37;0;37;1
2018-07-10 13:30:00;NORTE;23;0;23;1
2018-07-10 14:00:00;NORTE;31;0;31;1
2018-07-10 14:30:00;NORTE;34;0;34;1
2018-07-10 15:00:00;NORTE;31;0;31;1
2018-07-10 15:30:00;NORTE;23;0;23;1
2018-07-10 16:00:00;NORTE;23;0;23;1
2018-07-10 16:30:00;NORTE;29;0;29;1
2018-07-10 17:00:00;NORTE;24;0;24;1
2018-07-10 17:30:00;NORTE;25;0;25;1
2018-07-10 18:00:00;NORTE;35;0;35;1
2018-07-10 18:30:00;NORTE;33;0;33;1
2018-07-10 19:00:00;NORTE;29;0;29;1
2018-07-10 19:30:00;NORTE;25;0;25;1
2018-07-10 20:00:00;NORTE;31;0;31;1
2018-07-10 20:30:00;NORTE;22;0;22;1
2018-07-10 21:00:00;NORTE;11;0;11;1
2018-07-10 21:30:00;NORTE;17;0;17;1
2018-07-10 22:00:00;NORTE;17;0;17;1
2018-07-10 22:30:00;NORTE;9;0;9;1
2018-07-10 23:00:00;NORTE;3;0;3;1
2018-07-10 23:30:00;NORTE;1;0;1;1
2018-07-11 00:00:00;NORTE;2;0;2;1
2018-07-11 01:00:00;NORTE;1;0;1;1
2018-07-11 01:30:00;NORTE;1;0;1;1
2018-07-11 02:00:00;NORTE;3;0;3;1
2018-07-11 02:30:00;NORTE;5;0;5;1
2018-07-11 03:30:00;NORTE;8;0;8;1
2018-07-11 04:00:00;NORTE;12;0;12;1
2018-07-11 04:30:00;NORTE;12;0;12;1
2018-07-11 05:00:00;NORTE;18;0;18;1
2018-07-11 05:30:00;NORTE;42;0;42;1
2018-07-11 06:00:00;NORTE;22;0;22;1
2018-07-11 06:30:00;NORTE;22;0;22;1
2018-07-11 07:00:00;NORTE;35;0;35;1
2018-07-11 07:30:00;NORTE;32;0;32;1
2018-07-11 08:00:00;NORTE;39;0;39;1
2018-07-11 08:30:00;NORTE;38;0;38;1
2018-07-11 09:00:00;NORTE;28;1;29;1
2018-07-11 09:30:00;SUR;0;25;25;1
2018-07-11 10:00:00;SUR;0;36;36;1
2018-07-11 10:30:00;SUR;0;34;34;1
2018-07-11 11:00:00;SUR;0;26;26;1
2018-07-11 11:30:00;SUR;0;27;27;1
2018-07-11 12:00:00;SUR;0;24;24;1
2018-07-11 12:30:00;SUR;0;26;26;1
2018-07-11 13:00:00;SUR;0;23;23;1
2018-07-11 13:30:00;SUR;0;28;28;1
2018-07-11 14:00:00;SUR;0;22;22;1
2018-07-11 14:30:00;SUR;0;38;38;1
2018-07-11 15:00:00;SUR;0;26;26;1
2018-07-11 15:30:00;SUR;0;18;18;1
2018-07-11 16:00:00;SUR;0;21;21;1
2018-07-11 16:30:00;SUR;0;26;26;1
2018-07-11 17:00:00;SUR;0;25;25;1
2018-07-11 17:30:00;SUR;0;28;28;1
2018-07-11 18:00:00;CONFLICTIVA;25;3;28;2
2018-07-11 18:30:00;NORTE;34;0;34;1
2018-07-11 19:00:00;NORTE;29;0;29;1
2018-07-11 19:30:00;NORTE;28;0;28;1
2018-07-11 20:00:00;NORTE;35;0;35;1
2018-07-11 20:30:00;NORTE;29;0;29;1
2018-07-11 21:00:00;NORTE;15;0;15;1
2018-07-11 21:30:00;NORTE;16;0;16;1
2018-07-11 22:00:00;NORTE;18;0;18;1
2018-07-11 22:30:00;NORTE;6;0;6;1
2018-07-11 23:00:00;NORTE;3;0;3;1
2018-07-11 23:30:00;NORTE;1;0;1;1
2018-07-12 00:00:00;NORTE;3;0;3;1
2018-07-12 00:30:00;NORTE;1;0;1;1
2018-07-12 01:00:00;NORTE;1;0;1;1
2018-07-12 01:30:00;NORTE;1;0;1;1
2018-07-12 02:00:00;NORTE;4;0;4;1
2018-07-12 02:30:00;NORTE;2;0;2;1
2018-07-12 03:00:00;NORTE;4;0;4;1
2018-07-12 03:30:00;NORTE;8;0;8;1
2018-07-12 04:00:00;NORTE;13;0;13;1
2018-07-12 04:30:00;NORTE;14;0;14;1
2018-07-12 05:00:00;NORTE;19;0;19;1
2018-07-12 05:30:00;NORTE;37;0;37;1
2018-07-12 06:00:00;NORTE;16;0;16;1
2018-07-12 06:30:00;NORTE;26;0;26;1
2018-07-12 07:00:00;NORTE;31;0;31;1
2018-07-12 07:30:00;NORTE;31;0;31;1
2018-07-12 08:00:00;NORTE;32;0;32;1
2018-07-12 08:30:00;NORTE;35;0;35;1
2018-07-12 09:00:00;NORTE;29;0;29;1
2018-07-12 09:30:00;NORTE;28;0;28;1
2018-07-12 10:00:00;NORTE;39;0;39;1
2018-07-12 10:30:00;NORTE;30;0;30;1
2018-07-12 11:00:00;NORTE;28;0;28;1
2018-07-12 11:30:00;NORTE;31;0;31;1
2018-07-12 12:00:00;NORTE;26;0;26;1
2018-07-12 12:30:00;NORTE;29;0;29;1
2018-07-12 13:00:00;NORTE;41;0;41;1
2018-07-12 13:30:00;NORTE;33;0;33;1
2018-07-12 14:00:00;NORTE;31;0;31;1
2018-07-12 14:30:00;NORTE;37;0;37;1
2018-07-12 15:00:00;NORTE;31;0;31;1
2018-07-12 15:30:00;NORTE;21;0;21;1
2018-07-12 16:00:00;NORTE;15;0;15;1
2018-07-12 16:30:00;NORTE;28;0;28;1
2018-07-12 17:00:00;SUR;0;27;27;1
2018-07-12 17:30:00;SUR;0;22;22;1
2018-07-12 18:00:00;SUR;0;30;30;1
2018-07-12 18:30:00;SUR;0;29;29;1
2018-07-12 19:00:00;SUR;0;24;24;1
2018-07-12 19:30:00;SUR;0;23;23;1
2018-07-12 20:00:00;SUR;0;30;30;1
2018-07-12 20:30:00;SUR;0;26;26;1
2018-07-12 21:00:00;SUR;0;33;33;1
2018-07-12 21:30:00;CONFLICTIVA;14;3;17;2
2018-07-12 22:00:00;NORTE;15;0;15;1
2018-07-12 22:30:00;NORTE;16;0;16;1
2018-07-12 23:00:00;NORTE;7;0;7;1
2018-07-12 23:30:00;NORTE;2;0;2;1
2018-07-13 00:00:00;NORTE;2;0;2;1
2018-07-13 00:30:00;NORTE;1;0;1;1
2018-07-13 01:00:00;NORTE;2;0;2;1
2018-07-13 02:00:00;NORTE;4;0;4;1
2018-07-13 02:30:00;NORTE;2;0;2;1
2018-07-13 03:00:00;NORTE;5;0;5;1
2018-07-13 03:30:00;NORTE;10;0;10;1
2018-07-13 04:00:00;NORTE;10;0;10;1
2018-07-13 04:30:00;NORTE;11;0;11;1
2018-07-13 05:00:00;NORTE;18;0;18;1
2018-07-13 05:30:00;NORTE;40;0;40;1
2018-07-13 06:00:00;NORTE;24;0;24;1
2018-07-13 06:30:00;NORTE;24;0;24;1
2018-07-13 07:00:00;NORTE;34;0;34;1
2018-07-13 07:30:00;NORTE;29;0;29;1
2018-07-13 08:00:00;NORTE;25;0;25;1
2018-07-13 08:30:00;SUR;0;31;31;1
2018-07-13 09:00:00;SUR;0;30;30;1
2018-07-13 09:30:00;SUR;0;35;35;1
2018-07-13 10:00:00;SUR;0;36;36;1
2018-07-13 10:30:00;SUR;0;28;28;1
2018-07-13 11:00:00;SUR;0;26;26;1
2018-07-13 11:30:00;SUR;0;27;27;1
2018-07-13 12:00:00;SUR;0;27;27;1
2018-07-13 12:30:00;SUR;0;28;28;1
2018-07-13 13:00:00;SUR;0;31;31;1
2018-07-13 13:30:00;SUR;0;35;35;1
2018-07-13 14:00:00;SUR;0;33;33;1
2018-07-13 14:30:00;SUR;0;30;30;1
2018-07-13 15:00:00;SUR;0;28;28;1
2018-07-13 15:30:00;SUR;0;23;23;1
2018-07-13 16:00:00;SUR;0;22;22;1
2018-07-13 16:30:00;SUR;0;29;29;1
2018-07-13 17:00:00;SUR;0;22;22;1
2018-07-13 17:30:00;SUR;0;21;21;1
2018-07-13 18:00:00;SUR;0;34;34;1
2018-07-13 18:30:00;SUR;0;27;27;1
2018-07-13 19:00:00;SUR;0;34;34;1
2018-07-13 19:30:00;SUR;0;25;25;1
2018-07-13 20:00:00;SUR;0;35;35;1
2018-07-13 20:30:00;SUR;0;27;27;1
2018-07-13 21:00:00;SUR;0;15;15;1
2018-07-13 21:30:00;SUR;0;13;13;1
2018-07-13 22:00:00;CONFLICTIVA;10;6;16;2
2018-07-13 22:30:00;NORTE;15;0;15;1
2018-07-13 23:00:00;NORTE;4;0;4;1
2018-07-13 23:30:00;NORTE;2;0;2;1
2018-07-14 00:00:00;NORTE;4;0;4;1
2018-07-14 00:30:00;NORTE;1;0;1;1
2018-07-14 01:00:00;NORTE;1;0;1;1
2018-07-14 01:30:00;NORTE;1;0;1;1
2018-07-14 02:00:00;NORTE;3;0;3;1
2018-07-14 02:30:00;NORTE;3;0;3;1
2018-07-14 03:00:00;NORTE;3;0;3;1
2018-07-14 03:30:00;NORTE;4;0;4;1
2018-07-14 04:00:00;NORTE;10;0;10;1
2018-07-14 04:30:00;NORTE;12;1;13;1
2018-07-14 05:00:00;NORTE;16;0;16;1
2018-07-14 05:30:00;NORTE;33;0;33;1
2018-07-14 06:00:00;NORTE;17;0;17;1
2018-07-14 06:30:00;NORTE;20;0;20;1
2018-07-14 07:00:00;NORTE;32;0;32;1
2018-07-14 07:30:00;NORTE;32;0;32;1
2018-07-14 08:00:00;NORTE;31;0;31;1
2018-07-14 08:30:00;NORTE;35;0;35;1
2018-07-14 09:00:00;CONFLICTIVA;6;12;18;2
2018-07-14 09:30:00;SUR;0;30;30;1
2018-07-14 10:00:00;SUR;0;28;28;1
2018-07-14 10:30:00;SUR;0;29;29;1
2018-07-14 11:00:00;SUR;0;21;21;1
2018-07-14 11:30:00;SUR;0;30;30;1
2018-07-14 12:00:00;SUR;0;24;24;1
2018-07-14 12:30:00;SUR;0;28;28;1
2018-07-14 13:00:00;SUR;0;25;25;1
2018-07-14 13:30:00;SUR;0;26;26;1
2018-07-14 14:00:00;SUR;0;35;35;1
2018-07-14 14:30:00;SUR;0;20;20;1
2018-07-14 15:00:00;SUR;0;24;24;1
2018-07-14 15:30:00;SUR;0;18;18;1
2018-07-14 16:00:00;SUR;0;23;23;1
2018-07-14 16:30:00;SUR;0;27;27;1
2018-07-14 17:00:00;SUR;0;22;22;1
2018-07-14 17:30:00;SUR;0;18;18;1
2018-07-14 18:00:00;SUR;0;30;30;1
2018-07-14 18:30:00;SUR;0;27;27;1
2018-07-14 19:00:00;SUR;0;18;18;1
2018-07-14 19:30:00;SUR;0;25;25;1
2018-07-14 20:00:00;SUR;0;20;20;1
2018-07-14 20:30:00;SUR;0;17;17;1
2018-07-14 21:00:00;CONFLICTIVA;4;5;9;2
2018-07-14 21:30:00;NORTE;14;0;14;1
2018-07-14 22:00:00;NORTE;16;0;16;1
2018-07-14 22:30:00;NORTE;15;0;15;1
2018-07-14 23:00:00;NORTE;4;0;4;1
2018-07-14 23:30:00;NORTE;3;0;3;1
2018-07-15 00:00:00;NORTE;3;0;3;1
2018-07-15 00:30:00;NORTE;1;0;1;1
2018-07-15 01:00:00;NORTE;2;0;2;1
2018-07-15 01:30:00;NORTE;2;0;2;1
2018-07-15 02:00:00;NORTE;5;0;5;1
2018-07-15 02:30:00;NORTE;2;0;2;1
2018-07-15 03:00:00;NORTE;1;0;1;1
2018-07-15 03:30:00;NORTE;3;0;3;1
2018-07-15 04:00:00;NORTE;10;0;10;1
2018-07-15 04:30:00;NORTE;8;0;8;1
2018-07-15 05:00:00;NORTE;14;0;14;1
2018-07-15 05:30:00;NORTE;28;0;28;1
2018-07-15 06:00:00;NORTE;20;0;20;1
2018-07-15 06:30:00;NORTE;15;0;15;1
2018-07-15 07:00:00;NORTE;34;0;34;1
2018-07-15 07:30:00;NORTE;31;0;31;1
2018-07-15 08:00:00;NORTE;34;0;34;1
2018-07-15 08:30:00;CONFLICTIVA;23;3;26;2
2018-07-15 09:00:00;SUR;0;24;24;1
2018-07-15 09:30:00;SUR;0;30;30;1
2018-07-15 10:00:00;SUR;0;27;27;1
2018-07-15 10:30:00;SUR;0;31;31;1
2018-07-15 11:00:00;SUR;0;24;24;1
2018-07-15 11:30:00;SUR;0;28;28;1
2018-07-15 12:00:00;SUR;0;26;26;1
2018-07-15 12:30:00;SUR;0;28;28;1
2018-07-15 13:00:00;SUR;0;29;29;1
2018-07-15 13:30:00;SUR;0;35;35;1
2018-07-15 14:00:00;SUR;0;39;39;1
2018-07-15 14:30:00;SUR;0;31;31;1
2018-07-15 15:00:00;SUR;0;35;35;1
2018-07-15 15:30:00;SUR;0;17;17;1
2018-07-15 16:00:00;SUR;0;17;17;1
2018-07-15 16:30:00;SUR;0;27;27;1
2018-07-15 17:00:00;SUR;0;17;17;1
2018-07-15 17:30:00;SUR;0;22;22;1
2018-07-15 18:00:00;SUR;0;32;32;1
2018-07-15 18:30:00;SUR;0;28;28;1
2018-07-15 19:00:00;SUR;0;29;29;1
2018-07-15 19:30:00;SUR;0;36;36;1
2018-07-15 20:00:00;SUR;0;28;28;1
2018-07-15 20:30:00;SUR;0;32;32;1
2018-07-15 21:00:00;SUR;0;19;19;1
2018-07-15 21:30:00;SUR;0;20;20;1
2018-07-15 22:00:00;SUR;0;23;23;1
2018-07-15 22:30:00;SUR;0;18;18;1
2018-07-15 23:01:02;SUR;0;1;1;1
2018-07-15 23:03:11;SUR;0;1;1;1
2018-07-15 23:04:44;SUR;0;1;1;1
2018-07-15 23:08:03;SUR;0;1;1;1
2018-07-15 23:12:51;SUR;0;1;1;1
2018-07-15 23:15:34;SUR;0;1;1;1
2018-07-15 23:17:57;SUR;0;1;1;1
2018-07-15 23:30:00;SUR;0;5;5;1
2018-07-16 00:00:00;SUR;0;1;1;1
2018-07-16 00:30:00;SUR;0;5;5;1
2018-07-16 01:00:00;NORTE;2;0;2;1
2018-07-16 01:30:00;NORTE;2;0;2;1
2018-07-16 02:00:00;NORTE;4;0;4;1
2018-07-16 02:30:00;NORTE;4;0;4;1
2018-07-16 03:00:00;NORTE;2;0;2;1
2018-07-16 03:30:00;NORTE;5;0;5;1
2018-07-16 04:00:00;NORTE;10;0;10;1
2018-07-16 04:30:00;NORTE;12;0;12;1
2018-07-16 05:00:00;NORTE;20;0;20;1
2018-07-16 05:30:00;NORTE;41;0;41;1
2018-07-16 06:00:00;NORTE;18;0;18;1
2018-07-16 06:30:00;NORTE;26;0;26;1
2018-07-16 07:00:00;NORTE;34;0;34;1
2018-07-16 07:30:00;NORTE;29;0;29;1
2018-07-16 08:00:00;NORTE;34;0;34;1
2018-07-16 08:30:00;NORTE;35;0;35;1
2018-07-16 09:00:00;NORTE;23;0;23;1
2018-07-16 09:30:00;NORTE;35;0;35;1
2018-07-16 10:00:00;NORTE;39;0;39;1
2018-07-16 10:30:00;NORTE;33;0;33;1
2018-07-16 11:00:00;NORTE;33;0;33;1
2018-07-16 11:30:00;NORTE;28;0;28;1
2018-07-16 12:00:00;NORTE;25;0;25;1
2018-07-16 12:30:00;NORTE;35;0;35;1
2018-07-16 13:00:00;NORTE;33;0;33;1
2018-07-16 13:30:00;NORTE;25;0;25;1
2018-07-16 14:00:00;NORTE;38;0;38;1
2018-07-16 14:30:00;NORTE;37;0;37;1
2018-07-16 15:00:00;NORTE;23;0;23;1
2018-07-16 15:30:00;NORTE;27;0;27;1
2018-07-16 16:00:00;NORTE;18;0;18;1
2018-07-16 16:30:00;NORTE;34;0;34;1
2018-07-16 17:00:00;NORTE;16;0;16;1
2018-07-16 17:30:00;NORTE;25;0;25;1
2018-07-16 18:00:00;NORTE;31;0;31;1
2018-07-16 18:30:00;NORTE;33;0;33;1
2018-07-16 19:00:00;NORTE;32;0;32;1
2018-07-16 19:30:00;NORTE;27;0;27;1
2018-07-16 20:00:00;NORTE;36;0;36;1
2018-07-16 20:30:00;NORTE;23;0;23;1
2018-07-16 21:00:00;NORTE;16;0;16;1
2018-07-16 21:30:00;NORTE;19;0;19;1
2018-07-16 22:00:00;NORTE;21;0;21;1
2018-07-16 22:30:00;NORTE;9;0;9;1
2018-07-16 23:00:00;NORTE;10;0;10;1
2018-07-16 23:30:00;NORTE;1;0;1;1
2018-07-17 00:00:00;NORTE;3;0;3;1
2018-07-17 00:30:00;NORTE;3;0;3;1
2018-07-17 01:00:00;NORTE;2;0;2;1
2018-07-17 01:30:00;NORTE;2;0;2;1
2018-07-17 02:00:00;NORTE;3;0;3;1
2018-07-17 02:30:00;NORTE;3;0;3;1
2018-07-17 03:00:00;NORTE;3;0;3;1
2018-07-17 03:30:00;NORTE;9;0;9;1
2018-07-17 04:00:00;NORTE;10;0;10;1
2018-07-17 04:30:00;NORTE;14;0;14;1
2018-07-17 05:00:00;NORTE;21;0;21;1
2018-07-17 05:30:00;NORTE;35;0;35;1
2018-07-17 06:00:00;NORTE;26;0;26;1
2018-07-17 06:30:00;NORTE;25;0;25;1
2018-07-17 07:00:00;NORTE;37;0;37;1
2018-07-17 07:30:00;NORTE;31;0;31;1
2018-07-17 08:00:00;NORTE;17;0;17;1
2018-07-17 08:30:00;NORTE;34;0;34;1
2018-07-17 09:00:00;NORTE;14;0;14;1
2018-07-17 09:30:00;NORTE;30;0;30;1
2018-07-17 10:00:00;NORTE;35;0;35;1
2018-07-17 10:30:00;NORTE;37;0;37;1
2018-07-17 11:00:00;NORTE;38;0;38;1
2018-07-17 11:30:00;NORTE;28;0;28;1
2018-07-17 12:00:00;NORTE;30;0;30;1
2018-07-17 12:30:00;NORTE;32;0;32;1
2018-07-17 13:00:00;NORTE;33;0;33;1
2018-07-17 13:30:00;NORTE;35;0;35;1
2018-07-17 14:00:00;NORTE;29;0;29;1
2018-07-17 14:30:00;NORTE;45;0;45;1
2018-07-17 15:00:00;NORTE;23;0;23;1
2018-07-17 15:30:00;NORTE;23;0;23;1
2018-07-17 16:00:00;NORTE;18;0;18;1
2018-07-17 16:30:00;NORTE;32;0;32;1
2018-07-17 17:00:00;NORTE;24;0;24;1
2018-07-17 17:30:00;NORTE;27;0;27;1
2018-07-17 18:00:00;NORTE;36;0;36;1
2018-07-17 18:30:00;NORTE;34;0;34;1
2018-07-17 19:00:00;NORTE;34;0;34;1
2018-07-17 19:30:00;NORTE;30;0;30;1
2018-07-17 20:00:00;NORTE;34;0;34;1
2018-07-17 20:30:00;NORTE;35;0;35;1
2018-07-17 21:00:00;NORTE;16;0;16;1
2018-07-17 21:30:00;NORTE;18;0;18;1
2018-07-17 22:00:00;NORTE;18;0;18;1
2018-07-17 22:30:00;NORTE;13;0;13;1
2018-07-17 23:00:00;CONFLICTIVA;1;1;2;2
2018-07-17 23:30:00;SUR;0;1;1;1
2018-07-18 00:00:00;SUR;0;2;2;1
2018-07-18 01:00:00;SUR;0;2;2;1
2018-07-18 02:00:00;SUR;0;2;2;1
2018-07-18 02:30:00;SUR;0;4;4;1
2018-07-18 03:00:00;SUR;0;2;2;1
2018-07-18 03:30:00;SUR;0;9;9;1
2018-07-18 04:00:00;CONFLICTIVA;4;5;9;2
2018-07-18 04:30:00;NORTE;18;0;18;1
2018-07-18 05:00:00;NORTE;16;0;16;1
2018-07-18 05:30:00;NORTE;47;0;47;1
2018-07-18 06:00:00;NORTE;21;0;21;1
2018-07-18 06:30:00;NORTE;23;0;23;1
2018-07-18 07:00:00;NORTE;36;0;36;1
2018-07-18 07:30:00;NORTE;14;0;14;1
2018-07-18 10:00:00;NORTE;16;0;16;1
2018-07-18 10:30:00;NORTE;26;0;26;1
2018-07-18 11:00:00;NORTE;42;0;42;1
2018-07-18 11:30:00;CONFLICTIVA;10;15;25;2
2018-07-18 12:00:00;SUR;0;30;30;1
2018-07-18 12:30:00;SUR;0;31;31;1
2018-07-18 13:00:00;SUR;0;34;34;1
2018-07-18 13:30:00;SUR;0;31;31;1
2018-07-18 14:00:00;SUR;0;29;29;1
2018-07-18 14:30:00;SUR;0;35;35;1
2018-07-18 15:00:00;SUR;0;33;33;1
2018-07-18 15:30:00;SUR;0;21;21;1
2018-07-18 16:00:00;SUR;0;22;22;1
2018-07-18 16:30:00;SUR;0;25;25;1
2018-07-18 17:00:00;SUR;0;26;26;1
2018-07-18 17:30:00;SUR;0;27;27;1
2018-07-18 18:00:00;SUR;0;33;33;1
2018-07-18 18:30:00;SUR;0;29;29;1
2018-07-18 19:00:00;SUR;0;31;31;1
2018-07-18 19:30:00;SUR;0;33;33;1
2018-07-18 20:00:00;SUR;0;33;33;1
2018-07-18 20:30:00;SUR;0;28;28;1
2018-07-18 21:00:00;CONFLICTIVA;12;4;16;2
2018-07-18 21:30:00;NORTE;20;0;20;1
2018-07-18 22:00:00;NORTE;13;0;13;1
2018-07-18 22:30:00;NORTE;13;0;13;1
2018-07-18 23:00:00;NORTE;5;0;5;1
2018-07-18 23:30:00;NORTE;4;0;4;1
2018-07-19 00:00:00;NORTE;4;0;4;1
2018-07-19 00:30:00;NORTE;1;0;1;1
2018-07-19 01:00:00;NORTE;1;0;1;1
2018-07-19 01:30:00;NORTE;3;0;3;1
2018-07-19 02:00:00;NORTE;3;0;3;1
2018-07-19 02:30:00;NORTE;3;0;3;1
2018-07-19 03:00:00;NORTE;4;0;4;1
2018-07-19 03:30:00;NORTE;9;0;9;1
2018-07-19 04:00:00;NORTE;11;0;11;1
2018-07-19 04:30:00;NORTE;11;0;11;1
2018-07-19 05:00:00;NORTE;26;0;26;1
2018-07-19 05:30:00;NORTE;36;0;36;1
2018-07-19 06:00:00;NORTE;28;0;28;1
2018-07-19 06:30:00;NORTE;22;0;22;1
2018-07-19 07:00:00;NORTE;38;0;38;1
2018-07-19 07:30:00;NORTE;28;0;28;1
2018-07-19 08:00:00;NORTE;33;0;33;1
2018-07-19 08:30:00;NORTE;37;0;37;1
2018-07-19 09:00:00;NORTE;36;0;36;1
2018-07-19 09:30:00;NORTE;29;0;29;1
2018-07-19 10:00:00;NORTE;44;0;44;1
2018-07-19 10:30:00;CONFLICTIVA;13;8;21;2
2018-07-19 11:00:00;SUR;0;33;33;1
2018-07-19 11:30:00;SUR;0;26;26;1
2018-07-19 12:00:00;SUR;0;22;22;1
2018-07-19 12:30:00;SUR;0;30;30;1
2018-07-19 13:00:00;SUR;0;38;38;1
2018-07-19 13:30:00;SUR;0;36;36;1
2018-07-19 14:00:00;SUR;0;28;28;1
2018-07-19 14:30:00;SUR;0;36;36;1
2018-07-19 15:00:00;SUR;0;36;36;1
2018-07-19 15:30:00;SUR;0;17;17;1
2018-07-19 16:00:00;SUR;0;4;4;1
2018-07-20 07:30:00;NORTE;18;0;18;1
2018-07-20 08:00:00;NORTE;30;0;30;1
2018-07-20 08:30:00;NORTE;33;0;33;1
2018-07-20 09:00:00;CONFLICTIVA;10;9;19;2
2018-07-20 09:30:00;SUR;0;30;30;1
2018-07-20 10:00:00;SUR;0;40;40;1
2018-07-20 10:30:00;SUR;0;31;31;1
2018-07-20 11:00:00;SUR;0;26;26;1
2018-07-20 11:30:00;SUR;0;20;20;1
2018-07-20 12:00:00;SUR;0;22;22;1
2018-07-20 12:30:00;SUR;0;33;33;1
2018-07-20 13:00:00;SUR;0;32;32;1
2018-07-20 13:30:00;SUR;1;38;39;1
2018-07-20 14:00:00;SUR;0;37;37;1
2018-07-20 14:30:00;SUR;0;33;33;1
2018-07-20 15:00:00;SUR;0;28;28;1
2018-07-20 15:30:00;SUR;0;15;15;1
2018-07-20 16:00:00;NORTE;22;0;22;1
2018-07-20 16:30:00;NORTE;32;0;32;1
2018-07-20 17:00:00;NORTE;24;0;24;1
2018-07-20 17:30:00;NORTE;21;0;21;1
2018-07-20 18:00:00;NORTE;27;0;27;1
2018-07-20 18:30:00;NORTE;30;0;30;1
2018-07-20 19:00:00;NORTE;35;0;35;1
2018-07-20 19:30:00;NORTE;29;0;29;1
2018-07-20 20:00:00;NORTE;28;0;28;1
2018-07-20 20:30:00;NORTE;30;0;30;1
2018-07-20 21:00:00;NORTE;17;0;17;1
2018-07-20 21:30:00;NORTE;14;0;14;1
2018-07-20 22:00:00;NORTE;10;0;10;1
2018-07-20 22:30:00;NORTE;14;0;14;1
2018-07-20 23:00:00;NORTE;5;0;5;1
2018-07-20 23:30:00;NORTE;2;0;2;1
2018-07-21 00:00:00;NORTE;4;0;4;1
2018-07-21 00:30:00;NORTE;2;0;2;1
2018-07-21 01:00:00;NORTE;1;0;1;1
2018-07-21 01:30:00;NORTE;1;0;1;1
2018-07-21 02:00:00;NORTE;2;0;2;1
2018-07-21 02:30:00;NORTE;1;0;1;1
2018-07-21 03:00:00;NORTE;1;0;1;1
2018-07-21 03:30:00;NORTE;3;0;3;1
2018-07-21 04:00:00;NORTE;16;0;16;1
2018-07-21 04:30:00;NORTE;15;0;15;1
2018-07-21 05:00:00;NORTE;20;0;20;1
2018-07-21 05:30:00;NORTE;27;0;27;1
2018-07-21 06:00:00;NORTE;20;0;20;1
2018-07-21 06:30:00;NORTE;18;0;18;1
2018-07-21 07:00:00;NORTE;40;0;40;1
2018-07-21 07:30:00;NORTE;24;0;24;1
2018-07-21 08:00:00;NORTE;35;0;35;1
2018-07-21 08:30:00;NORTE;33;0;33;1
2018-07-21 09:00:00;NORTE;23;0;23;1
2018-07-21 09:30:00;NORTE;28;0;28;1
2018-07-21 10:00:00;NORTE;29;0;29;1
2018-07-21 10:30:00;NORTE;34;0;34;1
2018-07-21 11:00:00;NORTE;25;0;25;1
2018-07-21 11:30:00;NORTE;25;0;25;1
2018-07-21 12:00:00;NORTE;30;0;30;1
2018-07-21 12:30:00;NORTE;28;0;28;1
2018-07-21 13:00:00;NORTE;24;0;24;1
2018-07-21 13:30:00;NORTE;36;0;36;1
2018-07-21 14:00:00;NORTE;30;0;30;1
2018-07-21 14:30:00;NORTE;33;0;33;1
2018-07-21 15:00:00;NORTE;25;0;25;1
2018-07-21 15:30:00;NORTE;22;0;22;1
2018-07-21 16:00:00;NORTE;11;0;11;1
2018-07-21 16:30:00;NORTE;29;0;29;1
2018-07-21 17:00:00;NORTE;15;0;15;1
2018-07-21 17:30:00;NORTE;23;0;23;1
2018-07-21 18:00:00;NORTE;27;0;27;1
2018-07-21 18:30:00;NORTE;23;0;23;1
2018-07-21 19:00:00;NORTE;27;0;27;1
2018-07-21 19:30:00;NORTE;18;0;18;1
2018-07-21 20:00:00;NORTE;25;0;25;1
2018-07-21 20:30:00;NORTE;19;0;19;1
2018-07-21 21:00:00;NORTE;12;0;12;1
2018-07-21 21:30:00;NORTE;15;0;15;1
2018-07-21 22:00:00;NORTE;5;0;5;1
2018-07-21 22:11:00;NORTE;3;0;3;1
2018-07-21 22:30:00;NORTE;1;0;1;1
2018-07-21 23:00:00;NORTE;5;0;5;1
2018-07-21 23:30:00;NORTE;2;0;2;1
2018-07-22 00:00:00;NORTE;2;0;2;1
2018-07-22 01:00:00;NORTE;3;0;3;1
2018-07-22 01:30:00;NORTE;1;0;1;1
2018-07-22 02:00:00;NORTE;2;0;2;1
2018-07-22 02:30:00;NORTE;2;0;2;1
2018-07-22 03:00:00;NORTE;2;0;2;1
2018-07-22 03:30:00;NORTE;4;0;4;1
2018-07-22 04:00:00;NORTE;11;0;11;1
2018-07-22 04:30:00;NORTE;12;0;12;1
2018-07-22 05:00:00;NORTE;15;0;15;1
2018-07-22 05:30:00;NORTE;28;0;28;1
2018-07-22 06:00:00;NORTE;17;0;17;1
2018-07-22 06:30:00;NORTE;19;0;19;1
2018-07-22 07:00:00;NORTE;38;0;38;1
2018-07-22 07:30:00;NORTE;31;0;31;1
2018-07-22 08:00:00;NORTE;30;0;30;1
2018-07-22 08:30:00;NORTE;33;0;33;1
2018-07-22 09:00:00;NORTE;19;0;19;1
2018-07-22 09:30:00;NORTE;32;0;32;1
2018-07-22 10:00:00;NORTE;35;0;35;1
2018-07-22 10:30:00;NORTE;31;0;31;1
2018-07-22 11:00:00;NORTE;25;0;25;1
2018-07-22 11:30:00;NORTE;35;0;35;1
2018-07-22 12:00:00;NORTE;25;0;25;1
2018-07-22 12:30:00;NORTE;31;0;31;1
2018-07-22 13:00:00;NORTE;39;0;39;1
2018-07-22 13:30:00;NORTE;34;0;34;1
2018-07-22 14:00:00;NORTE;38;0;38;1
2018-07-22 14:30:00;NORTE;42;0;42;1
2018-07-22 15:00:00;NORTE;27;0;27;1
2018-07-22 15:30:00;NORTE;19;0;19;1
2018-07-22 16:00:00;NORTE;17;0;17;1
2018-07-22 16:30:00;NORTE;24;0;24;1
2018-07-22 17:00:00;NORTE;18;0;18;1
2018-07-22 17:30:00;NORTE;25;0;25;1
2018-07-22 18:00:00;NORTE;34;0;34;1
2018-07-22 18:30:00;NORTE;30;0;30;1
2018-07-22 19:00:00;NORTE;23;0;23;1
2018-07-22 19:30:00;NORTE;34;0;34;1
2018-07-22 20:00:00;NORTE;35;0;35;1
2018-07-22 20:30:00;NORTE;26;0;26;1
2018-07-22 21:00:00;NORTE;26;0;26;1
2018-07-22 21:30:00;NORTE;15;0;15;1
2018-07-22 22:00:00;NORTE;18;0;18;1
2018-07-22 22:30:00;NORTE;15;0;15;1
2018-07-22 23:00:00;NORTE;6;0;6;1
2018-07-22 23:30:00;NORTE;4;0;4;1
2018-07-23 00:00:00;NORTE;4;0;4;1
2018-07-23 01:00:00;NORTE;2;0;2;1
2018-07-23 01:30:00;NORTE;1;0;1;1
2018-07-23 02:00:00;NORTE;4;0;4;1
2018-07-23 02:30:00;NORTE;4;0;4;1
2018-07-23 03:00:00;NORTE;2;0;2;1
2018-07-23 03:30:00;NORTE;4;0;4;1
2018-07-23 04:00:36;NORTE;1;0;1;1
2018-07-23 04:02:49;NORTE;1;0;1;1
2018-07-23 04:04:40;NORTE;1;0;1;1
2018-07-23 04:12:28;NORTE;1;0;1;1
2018-07-23 04:15:32;NORTE;1;0;1;1
2018-07-23 04:17:13;NORTE;1;0;1;1
2018-07-23 04:21:09;NORTE;1;0;1;1
2018-07-23 04:24:01;NORTE;1;0;1;1
2018-07-23 04:28:27;NORTE;1;0;1;1
2018-07-23 04:30:00;NORTE;16;0;16;1
2018-07-23 05:00:00;NORTE;18;0;18;1
2018-07-23 05:30:00;NORTE;41;0;41;1
2018-07-23 06:00:00;NORTE;16;0;16;1
2018-07-23 06:30:00;NORTE;29;0;29;1
2018-07-23 07:00:00;NORTE;39;0;39;1
2018-07-23 07:30:00;NORTE;27;0;27;1
2018-07-23 08:00:00;NORTE;36;0;36;1
2018-07-23 08:30:00;NORTE;31;0;31;1
2018-07-23 09:00:00;NORTE;19;0;19;1
2018-07-23 09:30:00;NORTE;29;0;29;1
2018-07-23 10:00:00;NORTE;38;0;38;1
2018-07-23 10:30:00;NORTE;29;0;29;1
2018-07-23 11:00:00;NORTE;29;0;29;1
2018-07-23 11:30:00;SUR;0;26;26;1
2018-07-23 12:00:00;SUR;0;33;33;1
2018-07-23 12:30:00;SUR;0;31;31;1
2018-07-23 13:00:00;SUR;0;33;33;1
2018-07-23 13:30:00;SUR;0;32;32;1
2018-07-23 14:00:00;SUR;0;33;33;1
2018-07-23 14:30:00;SUR;0;30;30;1
2018-07-23 15:00:00;SUR;0;32;32;1
2018-07-23 15:30:00;SUR;0;2;2;1
2018-07-23 16:00:00;SUR;0;16;16;1
2018-07-24 07:30:00;NORTE;27;0;27;1
2018-07-24 08:00:00;NORTE;32;0;32;1
2018-07-24 08:30:00;NORTE;30;0;30;1
2018-07-24 09:00:00;CONFLICTIVA;14;5;19;2
2018-07-24 09:30:00;SUR;0;28;28;1
2018-07-24 10:00:00;SUR;0;40;40;1
2018-07-24 10:30:00;SUR;0;21;21;1
2018-07-24 11:00:00;SUR;0;24;24;1
2018-07-24 11:30:00;SUR;0;32;32;1
2018-07-24 12:00:00;SUR;0;24;24;1
2018-07-24 12:30:00;SUR;0;24;24;1
2018-07-24 13:00:00;SUR;0;29;29;1
2018-07-24 13:30:00;SUR;0;34;34;1
2018-07-24 14:00:00;SUR;0;35;35;1
2018-07-24 14:30:00;SUR;0;29;29;1
2018-07-24 15:00:00;SUR;0;30;30;1
2018-07-24 15:30:00;SUR;0;19;19;1
2018-07-24 16:00:00;SUR;0;19;19;1
2018-07-24 16:30:00;SUR;0;28;28;1
2018-07-24 17:00:00;SUR;0;21;21;1
2018-07-24 17:30:00;SUR;0;26;26;1
2018-07-24 18:00:00;SUR;0;35;35;1
2018-07-24 18:30:00;SUR;0;26;26;1
2018-07-24 19:00:00;SUR;0;28;28;1
2018-07-24 19:30:00;SUR;0;31;31;1
2018-07-24 20:00:00;SUR;0;28;28;1
2018-07-24 20:30:00;SUR;0;23;23;1
2018-07-24 21:00:00;SUR;0;18;18;1
2018-07-24 21:30:00;SUR;0;14;14;1
2018-07-24 22:00:00;SUR;0;17;17;1
2018-07-24 22:30:00;SUR;0;7;7;1
2018-07-24 23:00:00;SUR;0;4;4;1
2018-07-24 23:30:00;SUR;0;1;1;1
2018-07-25 00:00:00;SUR;0;3;3;1
2018-07-25 00:30:00;SUR;0;1;1;1
2018-07-25 01:00:00;SUR;0;1;1;1
2018-07-25 01:30:00;NORTE;1;0;1;1
2018-07-25 02:00:00;NORTE;4;0;4;1
2018-07-25 02:30:00;NORTE;1;0;1;1
2018-07-25 03:00:00;NORTE;5;0;5;1
2018-07-25 03:30:00;NORTE;8;0;8;1
2018-07-25 04:00:00;NORTE;8;0;8;1
2018-07-25 04:30:00;NORTE;9;0;9;1
2018-07-25 05:00:00;NORTE;17;0;17;1
2018-07-25 05:30:00;NORTE;37;0;37;1
2018-07-25 06:00:00;NORTE;25;0;25;1
2018-07-25 06:30:00;NORTE;21;0;21;1
2018-07-25 07:00:00;NORTE;35;0;35;1
2018-07-25 07:30:00;NORTE;27;0;27;1
2018-07-25 08:00:00;NORTE;34;0;34;1
2018-07-25 08:30:00;NORTE;38;0;38;1
2018-07-25 09:00:00;NORTE;22;0;22;1
2018-07-25 09:30:00;NORTE;30;0;30;1
2018-07-25 10:00:00;NORTE;35;0;35;1
2018-07-25 10:30:00;NORTE;26;0;26;1
2018-07-25 11:00:00;NORTE;25;0;25;1
2018-07-25 11:30:00;NORTE;24;0;24;1
2018-07-25 12:00:00;CONFLICTIVA;11;8;19;2
2018-07-25 12:30:00;SUR;0;32;32;1
2018-07-25 13:00:00;SUR;0;31;31;1
2018-07-25 13:30:00;SUR;0;23;23;1
2018-07-25 14:00:00;SUR;0;12;12;1
2018-07-25 14:30:00;SUR;0;15;15;1
2018-07-25 15:00:00;SUR;0;7;7;1
2018-07-25 15:30:00;SUR;0;13;13;1
2018-07-25 16:00:00;SUR;0;19;19;1
2018-07-25 16:30:00;SUR;0;15;15;1
2018-07-25 17:00:00;SUR;0;21;21;1
2018-07-25 17:30:00;CONFLICTIVA;22;6;28;2
2018-07-25 18:00:00;NORTE;35;0;35;1
2018-07-25 18:30:00;NORTE;20;0;20;1
2018-07-25 19:00:00;NORTE;22;0;22;1
2018-07-25 19:30:00;NORTE;24;0;24;1
2018-07-25 20:00:00;NORTE;27;0;27;1
2018-07-25 20:30:00;NORTE;26;0;26;1
2018-07-25 21:00:00;NORTE;14;0;14;1
2018-07-25 21:30:00;NORTE;15;0;15;1
2018-07-25 22:00:00;NORTE;13;0;13;1
2018-07-25 22:30:00;NORTE;10;0;10;1
2018-07-25 23:00:00;NORTE;4;0;4;1
2018-07-26 00:00:00;NORTE;3;0;3;1
2018-07-26 00:30:00;NORTE;1;0;1;1
2018-07-26 01:00:00;NORTE;2;0;2;1
2018-07-26 01:30:00;NORTE;1;0;1;1
2018-07-26 02:00:00;NORTE;2;0;2;1
2018-07-26 02:30:00;NORTE;5;0;5;1
2018-07-26 03:00:00;NORTE;3;0;3;1
2018-07-26 03:30:00;NORTE;8;0;8;1
2018-07-26 04:00:00;NORTE;10;0;10;1
2018-07-26 04:30:00;NORTE;9;0;9;1
2018-07-26 05:00:00;NORTE;15;0;15;1
2018-07-26 05:30:00;NORTE;43;0;43;1
2018-07-26 06:00:00;NORTE;17;0;17;1
2018-07-26 06:30:00;NORTE;24;0;24;1
2018-07-26 07:00:00;NORTE;33;0;33;1
2018-07-26 07:30:00;NORTE;29;0;29;1
2018-07-26 08:00:00;NORTE;36;0;36;1
2018-07-26 08:30:00;NORTE;33;0;33;1
2018-07-26 09:00:00;NORTE;25;0;25;1
2018-07-26 09:30:00;NORTE;30;0;30;1
2018-07-26 10:00:00;NORTE;37;0;37;1
2018-07-26 10:30:00;NORTE;29;0;29;1
2018-07-26 11:00:00;NORTE;37;0;37;1
2018-07-26 11:30:00;NORTE;18;0;18;1
2018-07-26 12:00:00;CONFLICTIVA;2;17;19;2
2018-07-26 12:30:00;SUR;0;30;30;1
2018-07-26 13:00:00;SUR;0;36;36;1
2018-07-26 13:30:00;SUR;0;25;25;1
2018-07-26 14:00:00;SUR;0;38;38;1
2018-07-26 14:30:00;SUR;0;31;31;1
2018-07-26 15:00:00;SUR;0;19;19;1
2018-07-26 15:30:00;SUR;0;12;12;1
2018-07-26 16:00:00;SUR;0;23;23;1
2018-07-26 16:30:00;SUR;0;27;27;1
2018-07-26 17:00:00;SUR;0;23;23;1
2018-07-26 17:30:00;SUR;0;25;25;1
2018-07-26 18:00:00;SUR;0;33;33;1
2018-07-26 18:30:00;SUR;0;23;23;1
2018-07-26 19:00:00;SUR;0;22;22;1
2018-07-26 19:30:00;SUR;0;25;25;1
2018-07-26 20:00:00;SUR;0;27;27;1
2018-07-26 20:30:00;CONFLICTIVA;12;11;23;2
2018-07-26 21:00:00;NORTE;22;0;22;1
2018-07-26 21:30:00;NORTE;20;0;20;1
2018-07-26 22:00:00;NORTE;12;0;12;1
2018-07-26 22:30:00;NORTE;8;0;8;1
2018-07-26 23:00:00;NORTE;6;0;6;1
2018-07-26 23:30:00;NORTE;1;0;1;1
2018-07-27 00:00:00;NORTE;2;0;2;1
2018-07-27 00:30:00;NORTE;2;0;2;1
2018-07-27 01:00:00;NORTE;1;0;1;1
2018-07-27 01:30:00;NORTE;2;0;2;1
2018-07-27 02:00:00;NORTE;3;0;3;1
2018-07-27 02:30:00;NORTE;5;0;5;1
2018-07-27 03:00:00;NORTE;3;0;3;1
2018-07-27 03:30:00;NORTE;8;0;8;1
2018-07-27 04:00:00;NORTE;10;0;10;1
2018-07-27 04:30:00;NORTE;12;0;12;1
2018-07-27 05:00:00;NORTE;18;0;18;1
2018-07-27 05:30:00;NORTE;40;0;40;1
2018-07-27 06:00:00;NORTE;25;0;25;1
2018-07-27 06:30:00;NORTE;24;0;24;1
2018-07-27 07:00:00;NORTE;34;0;34;1
2018-07-27 07:30:00;NORTE;35;0;35;1
2018-07-27 08:00:00;NORTE;40;0;40;1
2018-07-27 08:30:00;NORTE;39;0;39;1
2018-07-27 09:00:00;NORTE;21;1;22;1
2018-07-27 09:30:00;CONFLICTIVA;13;9;22;2
2018-07-27 10:00:00;SUR;0;37;37;1
2018-07-27 10:30:00;SUR;0;32;32;1
2018-07-27 11:00:00;SUR;0;26;26;1
2018-07-27 11:30:00;SUR;0;29;29;1
2018-07-27 12:00:00;SUR;0;23;23;1
2018-07-27 12:30:00;SUR;0;31;31;1
2018-07-27 13:00:00;SUR;0;35;35;1
2018-07-27 13:30:00;SUR;0;34;34;1
2018-07-27 14:00:00;SUR;0;40;40;1
2018-07-27 14:30:00;SUR;0;26;26;1
2018-07-27 15:00:00;SUR;0;25;25;1
2018-07-27 15:30:00;SUR;0;18;18;1
2018-07-27 16:00:00;SUR;0;22;22;1
2018-07-27 16:30:00;SUR;0;24;24;1
2018-07-27 17:00:00;SUR;0;26;26;1
2018-07-27 17:30:00;SUR;0;21;21;1
2018-07-27 18:00:00;SUR;0;27;27;1
2018-07-27 18:30:00;SUR;0;28;28;1
2018-07-27 19:00:00;SUR;0;24;24;1
2018-07-27 19:30:00;SUR;0;36;36;1
2018-07-27 20:00:00;SUR;0;26;26;1
2018-07-27 20:30:00;SUR;0;26;26;1
2018-07-27 21:00:00;SUR;0;9;9;1
2018-07-27 21:30:00;SUR;0;15;15;1
2018-07-27 22:00:00;CONFLICTIVA;8;6;14;2
2018-07-27 22:30:00;NORTE;18;0;18;1
2018-07-27 23:00:00;NORTE;9;0;9;1
2018-07-27 23:30:00;NORTE;1;0;1;1
2018-07-28 00:00:00;NORTE;2;0;2;1
2018-07-28 00:30:00;NORTE;1;0;1;1
2018-07-28 01:00:00;NORTE;3;0;3;1
2018-07-28 01:30:00;NORTE;1;0;1;1
2018-07-28 02:00:00;NORTE;1;0;1;1
2018-07-28 02:30:00;NORTE;5;0;5;1
2018-07-28 03:00:00;NORTE;2;0;2;1
2018-07-28 03:30:00;NORTE;3;0;3;1
2018-07-28 04:00:00;NORTE;9;0;9;1
2018-07-28 04:30:00;NORTE;12;0;12;1
2018-07-28 05:00:00;NORTE;18;0;18;1
2018-07-28 05:30:00;NORTE;33;0;33;1
2018-07-28 06:00:00;NORTE;13;0;13;1
2018-07-28 06:30:00;NORTE;19;0;19;1
2018-07-28 07:00:00;NORTE;36;0;36;1
2018-07-28 07:30:00;NORTE;28;0;28;1
2018-07-28 08:00:00;NORTE;36;0;36;1
2018-07-28 08:30:00;NORTE;33;0;33;1
2018-07-28 09:00:00;NORTE;18;0;18;1
2018-07-28 09:30:00;NORTE;30;0;30;1
2018-07-28 10:00:00;CONFLICTIVA;10;12;22;2
2018-07-28 10:30:00;SUR;0;34;34;1
2018-07-28 11:00:00;SUR;0;25;25;1
2018-07-28 11:30:00;SUR;0;27;27;1
2018-07-28 12:00:00;SUR;0;33;33;1
2018-07-28 12:30:00;SUR;0;20;20;1
2018-07-28 13:00:00;SUR;0;30;30;1
2018-07-28 13:30:00;SUR;0;29;29;1
2018-07-28 14:00:00;SUR;0;32;32;1
2018-07-28 14:30:00;SUR;0;38;38;1
2018-07-28 15:00:00;SUR;0;20;20;1
2018-07-28 15:30:00;SUR;0;21;21;1
2018-07-28 16:00:00;SUR;0;23;23;1
2018-07-28 16:30:00;SUR;0;25;25;1
2018-07-28 17:00:00;SUR;0;14;14;1
2018-07-28 17:30:00;SUR;0;26;26;1
2018-07-28 18:00:00;SUR;0;25;25;1
2018-07-28 18:30:00;SUR;0;24;24;1
2018-07-28 19:00:00;SUR;0;28;28;1
2018-07-28 19:30:00;SUR;0;23;23;1
2018-07-28 20:00:00;SUR;0;15;15;1
2018-07-28 20:30:00;SUR;0;19;19;1
2018-07-28 21:00:00;SUR;0;19;19;1
2018-07-28 21:30:00;SUR;0;15;15;1
2018-07-28 22:00:00;SUR;0;15;15;1
2018-07-28 22:30:00;SUR;0;12;12;1
2018-07-28 23:00:00;SUR;0;10;10;1
2018-07-28 23:30:00;SUR;0;6;6;1
2018-07-29 00:00:00;NORTE;2;0;2;1
2018-07-29 00:30:00;NORTE;6;0;6;1
2018-07-29 01:00:00;NORTE;3;0;3;1
2018-07-29 02:00:00;NORTE;1;0;1;1
2018-07-29 02:30:00;NORTE;3;0;3;1
2018-07-29 03:00:00;NORTE;1;0;1;1
2018-07-29 03:30:00;NORTE;5;0;5;1
2018-07-29 04:00:00;NORTE;13;0;13;1
2018-07-29 04:30:00;NORTE;9;0;9;1
2018-07-29 05:00:00;NORTE;20;0;20;1
2018-07-29 05:30:00;NORTE;30;0;30;1
2018-07-29 06:00:00;NORTE;12;0;12;1
2018-07-29 06:30:00;NORTE;21;0;21;1
2018-07-29 07:00:00;NORTE;39;0;39;1
2018-07-29 07:30:00;NORTE;28;0;28;1
2018-07-29 08:00:00;NORTE;35;0;35;1
2018-07-29 08:30:00;CONFLICTIVA;7;16;23;2
2018-07-29 09:00:00;SUR;0;19;19;1
2018-07-29 09:30:00;SUR;0;30;30;1
2018-07-29 10:00:00;SUR;0;32;32;1
2018-07-29 10:30:00;SUR;0;37;37;1
2018-07-29 11:00:00;SUR;0;26;26;1
2018-07-29 11:30:00;SUR;0;25;25;1
2018-07-29 12:00:00;SUR;0;27;27;1
2018-07-29 12:30:00;SUR;0;28;28;1
2018-07-29 13:00:00;SUR;0;30;30;1
2018-07-29 13:30:00;SUR;0;36;36;1
2018-07-29 14:00:00;SUR;0;41;41;1
2018-07-29 14:30:00;SUR;0;31;31;1
2018-07-29 15:00:00;SUR;0;25;25;1
2018-07-29 15:30:00;SUR;0;21;21;1
2018-07-29 16:00:00;SUR;0;19;19;1
2018-07-29 16:30:00;SUR;0;27;27;1
2018-07-29 17:00:00;SUR;0;13;13;1
2018-07-29 17:30:00;SUR;0;21;21;1
2018-07-29 18:00:00;SUR;0;36;36;1
2018-07-29 18:30:00;SUR;0;28;28;1
2018-07-29 19:00:00;SUR;0;29;29;1
2018-07-29 19:30:00;SUR;0;26;26;1
2018-07-29 20:00:00;SUR;0;41;41;1
2018-07-29 20:30:00;SUR;0;25;25;1
2018-07-29 21:00:00;SUR;0;16;16;1
2018-07-29 21:30:00;SUR;0;19;19;1
2018-07-29 22:00:00;NORTE;18;0;18;1
2018-07-29 22:30:00;NORTE;24;0;24;1
2018-07-29 23:00:00;NORTE;6;0;6;1
2018-07-29 23:30:00;NORTE;4;0;4;1
2018-07-30 00:00:00;NORTE;2;0;2;1
2018-07-30 00:30:00;NORTE;3;0;3;1
2018-07-30 01:00:00;NORTE;2;0;2;1
2018-07-30 01:30:00;NORTE;1;0;1;1
2018-07-30 02:00:00;NORTE;2;0;2;1
2018-07-30 02:30:00;NORTE;3;0;3;1
2018-07-30 03:00:00;NORTE;4;0;4;1
2018-07-30 03:30:00;NORTE;5;0;5;1
2018-07-30 04:00:00;NORTE;8;0;8;1
2018-07-30 07:30:00;NORTE;25;0;25;1
2018-07-30 08:00:00;NORTE;28;0;28;1
2018-07-30 08:30:00;NORTE;36;0;36;1
2018-07-30 09:00:00;NORTE;24;0;24;1
2018-07-30 09:30:00;NORTE;34;0;34;1
2018-07-30 10:00:00;NORTE;34;0;34;1
2018-07-30 10:30:00;NORTE;32;0;32;1
2018-07-30 11:00:00;NORTE;29;0;29;1
2018-07-30 11:30:00;NORTE;34;0;34;1
2018-07-30 12:00:00;CONFLICTIVA;12;8;20;2
2018-07-30 12:30:00;SUR;0;33;33;1
2018-07-30 13:00:00;SUR;0;33;33;1
2018-07-30 13:30:00;SUR;0;34;34;1
2018-07-30 14:00:00;SUR;0;34;34;1
2018-07-30 14:30:00;SUR;0;36;36;1
2018-07-30 15:00:00;SUR;0;20;20;1
2018-07-30 15:30:00;SUR;0;21;21;1
2018-07-30 16:00:00;SUR;0;18;18;1
2018-07-30 16:30:00;SUR;0;33;33;1
2018-07-30 17:00:00;SUR;0;25;25;1
2018-07-30 17:30:00;SUR;0;25;25;1
2018-07-30 18:00:00;SUR;0;29;29;1
2018-07-30 18:30:00;SUR;0;34;34;1
2018-07-30 19:00:00;SUR;0;19;19;1
2018-07-30 19:30:00;SUR;0;31;31;1
2018-07-30 20:00:00;SUR;0;28;28;1
2018-07-30 20:30:00;SUR;0;20;20;1
2018-07-30 21:00:00;CONFLICTIVA;9;9;18;2
2018-07-30 21:30:00;NORTE;22;0;22;1
2018-07-30 22:00:00;NORTE;16;0;16;1
2018-07-30 22:30:00;NORTE;10;0;10;1
2018-07-30 23:00:00;NORTE;3;0;3;1
2018-07-30 23:30:00;NORTE;1;0;1;1
2018-07-31 00:00:00;NORTE;1;0;1;1
2018-07-31 00:30:00;NORTE;3;0;3;1
2018-07-31 01:00:00;NORTE;1;0;1;1
2018-07-31 01:30:00;NORTE;2;0;2;1
2018-07-31 02:00:00;NORTE;4;0;4;1
2018-07-31 02:30:00;NORTE;5;0;5;1
2018-07-31 03:00:00;NORTE;2;0;2;1
2018-07-31 03:30:00;NORTE;10;0;10;1
2018-07-31 04:00:00;NORTE;12;0;12;1
2018-07-31 04:30:00;NORTE;12;0;12;1
2018-07-31 05:00:00;NORTE;17;0;17;1
2018-07-31 05:30:00;NORTE;40;0;40;1
2018-07-31 06:00:00;NORTE;16;0;16;1
2018-07-31 06:30:00;NORTE;25;0;25;1
2018-07-31 07:00:00;NORTE;37;0;37;1
2018-07-31 07:30:00;NORTE;29;0;29;1
2018-07-31 08:00:00;NORTE;37;0;37;1
2018-07-31 08:30:00;NORTE;28;0;28;1
2018-07-31 09:00:00;NORTE;23;0;23;1
2018-07-31 09:30:00;NORTE;31;0;31;1
2018-07-31 10:00:00;NORTE;32;0;32;1
2018-07-31 10:30:00;NORTE;33;0;33;1
2018-07-31 11:00:00;NORTE;24;0;24;1
2018-07-31 11:30:00;NORTE;30;0;30;1
2018-07-31 12:00:00;NORTE;29;0;29;1
2018-07-31 12:30:00;NORTE;34;0;34;1
2018-07-31 13:00:00;NORTE;30;0;30;1
2018-07-31 13:30:00;NORTE;25;0;25;1
2018-07-31 14:00:00;NORTE;35;0;35;1
2018-07-31 14:30:00;NORTE;35;0;35;1
2018-07-31 15:00:00;CONFLICTIVA;12;12;24;2
2018-07-31 15:30:00;SUR;0;19;19;1
2018-07-31 16:00:00;SUR;0;17;17;1
2018-07-31 16:30:00;SUR;0;26;26;1
2018-07-31 17:00:00;SUR;0;18;18;1
2018-07-31 17:30:00;SUR;0;26;26;1
2018-07-31 18:00:00;SUR;0;34;34;1
2018-07-31 18:30:00;SUR;0;28;28;1
2018-07-31 19:00:00;CONFLICTIVA;18;5;23;2
2018-07-31 19:30:00;NORTE;34;0;34;1
2018-07-31 20:00:00;NORTE;28;0;28;1
2018-07-31 20:30:00;NORTE;25;1;26;1
2018-07-31 21:00:00;NORTE;14;0;14;1
2018-07-31 21:30:00;NORTE;18;0;18;1
2018-07-31 22:00:00;NORTE;13;0;13;1
2018-07-31 22:30:00;NORTE;10;0;10;1
2018-07-31 23:00:00;NORTE;3;0;3;1
2018-07-31 23:30:00;NORTE;1;0;1;1
2018-08-01 00:00:00;NORTE;1;0;1;1
2018-08-01 00:30:00;NORTE;3;0;3;1
2018-08-01 01:30:00;NORTE;2;0;2;1
2018-08-01 02:00:00;NORTE;3;0;3;1
2018-08-01 02:30:00;NORTE;3;0;3;1
2018-08-01 03:00:00;NORTE;2;0;2;1
2018-08-01 03:30:00;NORTE;10;0;10;1
2018-08-01 04:00:00;NORTE;11;0;11;1
2018-08-01 04:30:00;NORTE;15;0;15;1
2018-08-01 05:00:00;NORTE;22;0;22;1
2018-08-01 05:30:00;NORTE;36;0;36;1
2018-08-01 06:00:00;NORTE;16;0;16;1
2018-08-01 06:30:00;NORTE;26;0;26;1
2018-08-01 07:00:00;NORTE;36;0;36;1
2018-08-01 07:30:00;NORTE;26;0;26;1
2018-08-01 08:00:00;NORTE;32;0;32;1
2018-08-01 08:30:00;NORTE;39;0;39;1
2018-08-01 09:00:00;NORTE;31;0;31;1
2018-08-01 09:30:00;NORTE;31;0;31;1
2018-08-01 10:00:00;NORTE;27;0;27;1
2018-08-01 10:30:00;NORTE;32;0;32;1
2018-08-01 11:00:00;NORTE;25;0;25;1
2018-08-01 11:30:00;NORTE;27;0;27;1
2018-08-01 12:00:00;NORTE;34;0;34;1
2018-08-01 12:30:00;NORTE;29;0;29;1
2018-08-01 13:00:00;NORTE;23;0;23;1
2018-08-01 13:30:00;NORTE;29;0;29;1
2018-08-01 14:00:00;NORTE;36;0;36;1
2018-08-01 14:30:00;NORTE;38;0;38;1
2018-08-01 15:00:00;NORTE;22;0;22;1
2018-08-01 15:30:00;NORTE;23;0;23;1
2018-08-01 16:00:00;NORTE;17;0;17;1
2018-08-01 16:30:00;NORTE;30;0;30;1
2018-08-01 17:00:00;NORTE;22;0;22;1
2018-08-01 17:30:00;NORTE;26;0;26;1
2018-08-01 18:00:00;NORTE;32;0;32;1
2018-08-01 18:30:00;NORTE;28;0;28;1
2018-08-01 19:00:00;NORTE;24;0;24;1
2018-08-01 19:30:00;NORTE;28;0;28;1
2018-08-01 20:00:00;NORTE;35;0;35;1
2018-08-01 20:30:00;NORTE;24;0;24;1
2018-08-01 21:00:00;NORTE;13;0;13;1
2018-08-01 21:30:00;NORTE;16;0;16;1
2018-08-01 22:00:00;NORTE;18;0;18;1
2018-08-01 22:30:00;NORTE;8;0;8;1
2018-08-01 23:00:00;NORTE;4;0;4;1
2018-08-01 23:30:00;NORTE;1;0;1;1
2018-08-02 00:00:00;NORTE;3;0;3;1
2018-08-02 00:30:00;NORTE;1;0;1;1
2018-08-02 01:00:00;NORTE;2;0;2;1
2018-08-02 02:00:00;NORTE;3;0;3;1
2018-08-02 02:30:00;NORTE;3;0;3;1
2018-08-02 03:00:00;NORTE;3;0;3;1
2018-08-02 03:30:00;NORTE;9;0;9;1
2018-08-02 04:00:00;NORTE;8;0;8;1
2018-08-02 04:30:00;NORTE;15;0;15;1
2018-08-02 05:00:00;NORTE;25;0;25;1
2018-08-02 05:30:00;NORTE;30;0;30;1
2018-08-02 06:00:00;NORTE;22;0;22;1
2018-08-02 06:30:00;NORTE;22;0;22;1
2018-08-02 07:00:00;NORTE;30;0;30;1
2018-08-02 07:30:00;NORTE;29;0;29;1
2018-08-02 08:00:00;NORTE;35;0;35;1
2018-08-02 08:30:00;NORTE;29;0;29;1
2018-08-02 09:00:00;NORTE;23;0;23;1
2018-08-02 09:30:00;NORTE;36;0;36;1
2018-08-02 10:00:00;NORTE;28;0;28;1
2018-08-02 10:30:00;NORTE;35;0;35;1
2018-08-02 11:00:00;NORTE;22;0;22;1
2018-08-02 11:30:00;NORTE;23;0;23;1
2018-08-02 12:00:00;NORTE;24;0;24;1
2018-08-02 12:30:00;NORTE;29;0;29;1
2018-08-02 13:00:00;NORTE;38;0;38;1
2018-08-02 13:30:00;NORTE;28;0;28;1
2018-08-02 14:00:00;NORTE;36;0;36;1
2018-08-02 14:30:00;NORTE;34;0;34;1
2018-08-02 15:00:00;NORTE;32;0;32;1
2018-08-02 15:30:00;NORTE;20;0;20;1
2018-08-02 16:00:00;NORTE;20;0;20;1
2018-08-02 16:30:00;NORTE;31;0;31;1
2018-08-02 17:00:00;NORTE;24;0;24;1
2018-08-02 17:30:00;NORTE;26;0;26;1
2018-08-02 18:00:00;NORTE;29;0;29;1
2018-08-02 18:30:00;NORTE;32;0;32;1
2018-08-02 19:00:00;NORTE;30;0;30;1
2018-08-02 19:30:00;NORTE;29;0;29;1
2018-08-02 20:00:00;NORTE;32;0;32;1
2018-08-02 20:30:00;NORTE;27;0;27;1
2018-08-02 21:00:00;NORTE;16;0;16;1
2018-08-02 21:30:00;NORTE;21;0;21;1
2018-08-02 22:00:00;NORTE;15;0;15;1
2018-08-02 22:30:00;NORTE;13;0;13;1
2018-08-02 23:00:00;NORTE;4;0;4;1
2018-08-02 23:30:00;NORTE;4;0;4;1
2018-08-03 00:00:00;NORTE;3;0;3;1
2018-08-03 01:00:00;NORTE;1;0;1;1
2018-08-03 01:30:00;NORTE;3;0;3;1
2018-08-03 02:00:00;NORTE;1;0;1;1
2018-08-03 02:30:00;NORTE;5;0;5;1
2018-08-03 03:00:00;NORTE;4;0;4;1
2018-08-03 03:30:00;NORTE;9;0;9;1
2018-08-03 04:00:00;NORTE;11;0;11;1
2018-08-03 04:30:00;NORTE;16;0;16;1
2018-08-03 05:00:00;NORTE;14;0;14;1
2018-08-03 05:30:00;NORTE;37;1;38;1
2018-08-03 06:00:00;NORTE;22;0;22;1
2018-08-03 06:30:00;NORTE;23;0;23;1
2018-08-03 07:00:00;NORTE;41;0;41;1
2018-08-03 07:30:00;NORTE;31;0;31;1
2018-08-03 08:00:00;NORTE;35;0;35;1
2018-08-03 08:30:00;NORTE;27;0;27;1
2018-08-03 09:00:00;NORTE;24;0;24;1
2018-08-03 09:30:00;NORTE;40;0;40;1
2018-08-03 10:00:00;NORTE;34;0;34;1
2018-08-03 10:30:00;NORTE;33;0;33;1
2018-08-03 11:00:00;NORTE;33;0;33;1
2018-08-03 11:30:00;NORTE;26;0;26;1
2018-08-03 12:00:00;NORTE;23;0;23;1
2018-08-03 12:30:00;NORTE;32;0;32;1
2018-08-03 13:00:00;NORTE;31;0;31;1
2018-08-03 13:30:00;NORTE;29;0;29;1
2018-08-03 14:00:00;NORTE;34;0;34;1
2018-08-03 14:30:00;NORTE;34;0;34;1
2018-08-03 15:00:00;NORTE;30;0;30;1
2018-08-03 15:30:00;NORTE;18;0;18;1
2018-08-03 16:00:00;NORTE;21;0;21;1
2018-08-03 16:30:00;NORTE;29;0;29;1
2018-08-03 17:00:00;NORTE;18;0;18;1
2018-08-03 17:30:00;NORTE;32;0;32;1
2018-08-03 18:00:00;NORTE;29;0;29;1
2018-08-03 18:30:00;NORTE;35;0;35;1
2018-08-03 19:00:00;NORTE;31;0;31;1
2018-08-03 19:30:00;NORTE;31;0;31;1
2018-08-03 20:00:00;NORTE;26;0;26;1
2018-08-03 20:30:00;NORTE;25;0;25;1
2018-08-03 21:00:00;NORTE;10;0;10;1
2018-08-03 21:30:00;NORTE;19;0;19;1
2018-08-03 22:00:00;NORTE;20;0;20;1
2018-08-03 22:30:00;NORTE;6;0;6;1
2018-08-03 23:00:00;NORTE;2;0;2;1
2018-08-03 23:30:00;NORTE;3;0;3;1
2018-08-04 00:00:00;NORTE;2;0;2;1
2018-08-04 00:30:00;NORTE;1;0;1;1
2018-08-04 01:00:00;NORTE;1;0;1;1
2018-08-04 01:30:00;NORTE;2;0;2;1
2018-08-04 02:00:00;NORTE;3;0;3;1
2018-08-04 02:30:00;NORTE;1;0;1;1
2018-08-04 03:00:00;NORTE;1;0;1;1
2018-08-04 03:30:00;NORTE;2;0;2;1
2018-08-04 04:00:00;NORTE;16;0;16;1
2018-08-04 04:30:00;NORTE;12;0;12;1
2018-08-04 05:00:00;NORTE;13;0;13;1
2018-08-04 05:30:00;NORTE;33;0;33;1
2018-08-04 06:00:00;NORTE;17;0;17;1
2018-08-04 06:30:00;NORTE;19;0;19;1
2018-08-04 07:00:00;NORTE;37;0;37;1
2018-08-04 07:30:00;NORTE;29;0;29;1
2018-08-04 08:00:00;NORTE;28;0;28;1
2018-08-04 08:30:00;NORTE;31;0;31;1
2018-08-04 09:00:00;NORTE;20;0;20;1
2018-08-04 09:30:00;NORTE;21;0;21;1
2018-08-04 10:00:00;NORTE;33;0;33;1
2018-08-04 10:30:00;NORTE;32;0;32;1
2018-08-04 11:00:00;NORTE;30;0;30;1
2018-08-04 11:30:00;NORTE;23;0;23;1
2018-08-04 12:00:00;NORTE;26;0;26;1
2018-08-04 12:30:00;NORTE;30;0;30;1
2018-08-04 13:00:00;NORTE;33;0;33;1
2018-08-04 13:30:00;NORTE;16;0;16;1
2018-08-04 14:00:00;NORTE;34;0;34;1
2018-08-04 14:30:00;NORTE;36;0;36;1
2018-08-04 15:00:00;NORTE;27;0;27;1
2018-08-04 15:30:00;NORTE;26;0;26;1
2018-08-04 16:00:00;NORTE;17;0;17;1
2018-08-04 16:30:00;NORTE;23;0;23;1
2018-08-04 17:00:00;NORTE;16;0;16;1
2018-08-04 17:30:00;NORTE;24;0;24;1
2018-08-04 18:00:00;NORTE;32;0;32;1
2018-08-04 18:30:00;NORTE;25;0;25;1
2018-08-04 19:00:00;NORTE;28;0;28;1
2018-08-04 19:30:00;NORTE;21;0;21;1
2018-08-04 20:00:00;NORTE;23;0;23;1
2018-08-04 20:30:00;NORTE;17;0;17;1
2018-08-04 21:00:00;NORTE;14;0;14;1
2018-08-04 21:30:00;NORTE;15;0;15;1
2018-08-04 22:00:00;NORTE;16;0;16;1
2018-08-04 22:30:00;NORTE;19;0;19;1
2018-08-04 23:00:00;NORTE;4;0;4;1
2018-08-04 23:30:00;NORTE;1;0;1;1
2018-08-05 00:00:00;NORTE;1;0;1;1
2018-08-05 00:30:00;NORTE;1;0;1;1
2018-08-05 01:00:00;NORTE;4;0;4;1
2018-08-05 01:30:00;NORTE;1;0;1;1
2018-08-05 02:30:00;NORTE;2;0;2;1
2018-08-05 03:00:00;NORTE;4;0;4;1
2018-08-05 03:30:00;NORTE;2;0;2;1
2018-08-05 04:00:00;NORTE;8;0;8;1
2018-08-05 04:30:00;NORTE;14;0;14;1
2018-08-05 05:00:00;NORTE;15;0;15;1
2018-08-05 05:30:00;NORTE;28;0;28;1
2018-08-05 06:00:00;NORTE;13;0;13;1
2018-08-05 06:30:00;NORTE;19;0;19;1
2018-08-05 07:00:00;NORTE;36;0;36;1
2018-08-05 07:30:00;NORTE;31;0;31;1
2018-08-05 08:00:00;NORTE;34;0;34;1
2018-08-05 08:30:00;NORTE;26;0;26;1
2018-08-05 09:00:00;NORTE;22;0;22;1
2018-08-05 09:30:00;NORTE;26;1;27;1
2018-08-05 10:00:00;NORTE;30;0;30;1
2018-08-05 10:30:00;NORTE;35;0;35;1
2018-08-05 11:00:00;NORTE;25;0;25;1
2018-08-05 11:30:00;NORTE;26;0;26;1
2018-08-05 12:00:00;NORTE;25;0;25;1
2018-08-05 12:30:00;NORTE;32;0;32;1
2018-08-05 13:00:00;NORTE;36;0;36;1
2018-08-05 13:30:00;NORTE;36;0;36;1
2018-08-05 14:00:00;NORTE;12;0;12;1
2018-08-05 16:00:00;NORTE;9;0;9;1
2018-08-05 16:30:00;NORTE;26;0;26;1
2018-08-05 17:00:00;NORTE;16;0;16;1
2018-08-05 17:30:00;NORTE;31;0;31;1
2018-08-05 18:00:00;NORTE;29;0;29;1
2018-08-05 18:30:00;NORTE;33;0;33;1
2018-08-05 19:00:00;NORTE;34;0;34;1
2018-08-05 19:30:00;NORTE;28;0;28;1
2018-08-05 20:00:00;NORTE;31;0;31;1
2018-08-05 20:30:00;NORTE;32;0;32;1
2018-08-05 21:00:00;NORTE;16;0;16;1
2018-08-05 21:30:00;NORTE;17;0;17;1
2018-08-05 22:00:00;NORTE;18;0;18;1
2018-08-05 22:30:00;NORTE;12;0;12;1
2018-08-05 23:00:00;NORTE;5;0;5;1
2018-08-05 23:30:00;NORTE;3;0;3;1
2018-08-06 00:00:00;NORTE;3;0;3;1
2018-08-06 00:30:00;NORTE;2;0;2;1
2018-08-06 01:00:00;NORTE;2;0;2;1
2018-08-06 01:30:00;NORTE;2;0;2;1
2018-08-06 02:00:00;NORTE;4;0;4;1
2018-08-06 02:30:00;NORTE;3;0;3;1
2018-08-06 03:00:00;NORTE;5;0;5;1
2018-08-06 03:30:00;NORTE;3;0;3;1
2018-08-06 04:00:00;NORTE;11;0;11;1
2018-08-06 04:30:00;NORTE;12;0;12;1
2018-08-06 05:00:00;NORTE;21;0;21;1
2018-08-06 05:30:00;NORTE;37;0;37;1
2018-08-06 06:00:00;NORTE;18;0;18;1
2018-08-06 06:30:00;NORTE;29;0;29;1
2018-08-06 07:00:00;NORTE;34;0;34;1
2018-08-06 07:30:00;NORTE;24;0;24;1
2018-08-06 08:00:00;NORTE;38;0;38;1
2018-08-06 08:30:00;NORTE;33;0;33;1
2018-08-06 09:00:00;NORTE;23;0;23;1
2018-08-06 09:30:00;NORTE;27;0;27;1
2018-08-06 10:00:00;NORTE;42;0;42;1
2018-08-06 10:30:00;NORTE;31;0;31;1
2018-08-06 11:00:00;NORTE;26;0;26;1
2018-08-06 11:30:00;NORTE;21;0;21;1
2018-08-06 12:00:00;NORTE;30;0;30;1
2018-08-06 12:30:00;NORTE;31;0;31;1
2018-08-06 13:00:00;NORTE;32;0;32;1
2018-08-06 13:30:00;NORTE;29;0;29;1
2018-08-06 14:00:00;NORTE;37;0;37;1
2018-08-06 14:30:00;NORTE;30;0;30;1
2018-08-06 15:00:00;NORTE;32;0;32;1
2018-08-06 15:30:00;NORTE;20;0;20;1
2018-08-06 16:00:00;NORTE;20;0;20;1
2018-08-06 16:30:00;NORTE;26;0;26;1
2018-08-06 17:00:00;NORTE;21;0;21;1
2018-08-06 17:30:00;NORTE;19;0;19;1
2018-08-06 18:00:00;CONFLICTIVA;14;10;24;2
2018-08-06 18:30:00;SUR;0;43;43;1
2018-08-06 19:00:00;SUR;0;25;25;1
2018-08-06 19:30:00;SUR;0;28;28;1
2018-08-06 20:00:00;SUR;0;26;26;1
2018-08-06 20:30:00;SUR;0;24;24;1
2018-08-06 21:00:00;SUR;1;10;11;1
2018-08-06 21:30:00;NORTE;21;0;21;1
2018-08-06 22:00:00;NORTE;19;0;19;1
2018-08-06 22:30:00;NORTE;9;0;9;1
2018-08-06 23:00:00;NORTE;4;0;4;1
2018-08-06 23:30:00;CONFLICTIVA;1;1;2;2
2018-08-07 00:00:00;NORTE;1;0;1;1
2018-08-07 00:30:00;NORTE;1;0;1;1
2018-08-07 01:00:00;NORTE;1;0;1;1
2018-08-07 01:30:00;NORTE;1;0;1;1
2018-08-07 02:00:00;NORTE;2;0;2;1
2018-08-07 02:30:00;NORTE;4;0;4;1
2018-08-07 03:00:00;NORTE;3;0;3;1
2018-08-07 03:30:00;NORTE;6;0;6;1
2018-08-07 04:00:00;NORTE;15;0;15;1
2018-08-07 04:30:00;NORTE;18;0;18;1
2018-08-07 05:00:00;NORTE;15;0;15;1
2018-08-07 05:30:00;NORTE;31;0;31;1
2018-08-07 06:00:00;NORTE;17;0;17;1
2018-08-07 06:30:00;NORTE;18;0;18;1
2018-08-07 07:00:00;NORTE;43;0;43;1
2018-08-07 07:30:00;NORTE;26;0;26;1
2018-08-07 08:00:00;NORTE;37;0;37;1
2018-08-07 08:30:00;NORTE;29;0;29;1
2018-08-07 09:00:00;CONFLICTIVA;7;10;17;2
2018-08-07 09:30:00;SUR;0;33;33;1
2018-08-07 10:00:00;SUR;0;31;31;1
2018-08-07 10:30:00;SUR;0;32;32;1
2018-08-07 11:00:00;SUR;0;26;26;1
2018-08-07 11:30:00;SUR;0;27;27;1
2018-08-07 12:00:00;SUR;0;25;25;1
2018-08-07 12:30:00;SUR;0;31;31;1
2018-08-07 13:00:00;SUR;0;28;28;1
2018-08-07 13:30:00;SUR;0;25;25;1
2018-08-07 14:00:00;SUR;0;33;33;1
2018-08-07 14:30:00;SUR;0;26;26;1
2018-08-07 15:00:00;SUR;0;30;30;1
2018-08-07 15:30:00;SUR;0;18;18;1
2018-08-07 16:00:00;SUR;0;18;18;1
2018-08-07 16:30:00;SUR;0;26;26;1
2018-08-07 17:00:00;SUR;0;22;22;1
2018-08-07 17:30:00;SUR;0;27;27;1
2018-08-07 18:00:00;SUR;0;32;32;1
2018-08-07 18:30:00;SUR;0;22;22;1
2018-08-07 19:00:00;CONFLICTIVA;8;18;26;2
2018-08-07 19:30:00;NORTE;26;1;27;1
2018-08-07 20:00:00;NORTE;36;0;36;1
2018-08-07 20:30:00;NORTE;24;0;24;1
2018-08-07 21:00:00;NORTE;19;0;19;1
2018-08-07 21:30:00;NORTE;15;0;15;1
2018-08-07 22:00:00;NORTE;16;0;16;1
2018-08-07 22:30:00;NORTE;10;0;10;1
2018-08-07 23:00:00;NORTE;5;0;5;1
2018-08-07 23:30:00;NORTE;4;0;4;1
2018-08-08 00:00:00;NORTE;1;0;1;1
2018-08-08 00:30:00;NORTE;2;0;2;1
2018-08-08 01:00:00;NORTE;1;0;1;1
2018-08-08 01:30:00;NORTE;1;0;1;1
2018-08-08 02:00:00;NORTE;4;0;4;1
2018-08-08 02:30:00;NORTE;2;0;2;1
2018-08-08 03:00:00;NORTE;3;0;3;1
2018-08-08 03:30:00;NORTE;7;0;7;1
2018-08-08 04:00:00;NORTE;14;0;14;1
2018-08-08 04:30:00;NORTE;15;0;15;1
2018-08-08 05:00:00;NORTE;16;0;16;1
2018-08-08 05:30:00;NORTE;40;0;40;1
2018-08-08 06:00:00;NORTE;20;0;20;1
2018-08-08 06:30:00;NORTE;18;0;18;1
2018-08-08 07:00:00;NORTE;41;0;41;1
2018-08-08 07:30:00;NORTE;29;0;29;1
2018-08-08 08:00:00;NORTE;35;0;35;1
2018-08-08 08:30:00;NORTE;36;0;36;1
2018-08-08 09:00:00;CONFLICTIVA;12;7;19;2
2018-08-08 09:30:00;SUR;0;31;31;1
2018-08-08 10:00:00;SUR;0;33;33;1
2018-08-08 10:30:00;SUR;0;30;30;1
2018-08-08 11:00:00;SUR;0;31;31;1
2018-08-08 11:30:00;SUR;0;26;26;1
2018-08-08 12:00:00;SUR;0;25;25;1
2018-08-08 12:30:00;SUR;0;24;24;1
2018-08-08 13:00:00;SUR;0;33;33;1
2018-08-08 13:30:00;SUR;0;30;30;1
2018-08-08 14:00:00;SUR;0;42;42;1
2018-08-08 14:30:00;SUR;0;35;35;1
2018-08-08 15:00:00;SUR;0;29;29;1
2018-08-08 15:30:00;SUR;0;15;15;1
2018-08-08 16:00:00;SUR;0;13;13;1
2018-08-08 16:30:00;SUR;0;27;27;1
2018-08-08 17:00:00;SUR;0;29;29;1
2018-08-08 17:30:00;SUR;0;30;30;1
2018-08-08 18:00:00;SUR;0;29;29;1
2018-08-08 18:30:00;SUR;0;27;27;1
2018-08-08 19:00:00;SUR;0;28;28;1
2018-08-08 19:30:00;CONFLICTIVA;14;13;27;2
2018-08-08 20:00:00;NORTE;28;0;28;1
2018-08-08 20:30:00;NORTE;27;0;27;1
2018-08-08 21:00:00;NORTE;14;0;14;1
2018-08-08 21:30:00;NORTE;14;0;14;1
2018-08-08 22:00:00;NORTE;23;0;23;1
2018-08-08 22:30:00;NORTE;9;0;9;1
2018-08-08 23:00:00;NORTE;1;0;1;1
2018-08-08 23:30:00;CONFLICTIVA;3;1;4;2
2018-08-09 00:00:00;NORTE;1;0;1;1
2018-08-09 00:30:00;NORTE;1;0;1;1
2018-08-09 01:00:00;NORTE;2;0;2;1
2018-08-09 02:00:00;NORTE;2;0;2;1
2018-08-09 02:46:16;NORTE;1;0;1;1
2018-08-09 02:52:13;NORTE;1;0;1;1
2018-08-09 02:57:19;NORTE;1;0;1;1
2018-08-09 02:59:55;NORTE;1;0;1;1
2018-08-09 03:00:00;NORTE;2;0;2;1
2018-08-09 03:30:00;NORTE;4;0;4;1
2018-08-09 04:00:00;NORTE;13;0;13;1
2018-08-09 04:30:00;NORTE;12;0;12;1
2018-08-09 05:00:00;NORTE;17;0;17;1
2018-08-09 05:30:00;NORTE;38;0;38;1
2018-08-09 06:00:00;NORTE;22;0;22;1
2018-08-09 06:30:00;NORTE;21;0;21;1
2018-08-09 07:00:00;NORTE;34;0;34;1
2018-08-09 07:30:00;NORTE;26;0;26;1
2018-08-09 08:00:00;NORTE;32;0;32;1
2018-08-09 08:30:00;NORTE;33;0;33;1
2018-08-09 09:00:00;NORTE;29;0;29;1
2018-08-09 09:30:00;NORTE;26;0;26;1
2018-08-09 10:00:00;NORTE;31;0;31;1
2018-08-09 10:30:00;NORTE;34;0;34;1
2018-08-09 11:00:00;NORTE;29;0;29;1
2018-08-09 11:30:00;NORTE;27;0;27;1
2018-08-09 12:00:00;NORTE;25;0;25;1
2018-08-09 12:30:00;NORTE;31;0;31;1
2018-08-09 13:00:00;NORTE;34;0;34;1
2018-08-09 13:30:00;NORTE;29;0;29;1
2018-08-09 14:00:00;NORTE;36;0;36;1
2018-08-09 14:30:00;NORTE;35;0;35;1
2018-08-09 15:00:00;NORTE;28;0;28;1
2018-08-09 15:30:00;NORTE;15;0;15;1
2018-08-09 16:00:00;NORTE;23;0;23;1
2018-08-09 16:30:00;NORTE;28;0;28;1
2018-08-09 17:00:00;NORTE;22;0;22;1
2018-08-09 17:30:00;NORTE;26;0;26;1
2018-08-09 18:00:00;NORTE;27;0;27;1
2018-08-09 18:30:00;NORTE;31;0;31;1
2018-08-09 19:00:00;NORTE;27;0;27;1
2018-08-09 19:30:00;NORTE;27;0;27;1
2018-08-09 20:00:00;NORTE;26;0;26;1
2018-08-09 20:30:00;NORTE;29;0;29;1
2018-08-09 21:00:00;NORTE;22;0;22;1
2018-08-09 21:30:00;NORTE;16;1;17;1
2018-08-09 22:00:00;NORTE;23;0;23;1
2018-08-09 22:30:00;NORTE;8;0;8;1
2018-08-09 23:00:00;NORTE;7;0;7;1
2018-08-09 23:30:00;NORTE;5;0;5;1
2018-08-10 00:00:00;CONFLICTIVA;4;1;5;2
2018-08-10 00:30:00;NORTE;2;0;2;1
2018-08-10 01:00:00;NORTE;4;0;4;1
2018-08-10 02:00:00;NORTE;2;0;2;1
2018-08-10 02:30:00;NORTE;4;0;4;1
2018-08-10 03:00:00;NORTE;7;0;7;1
2018-08-10 03:30:00;NORTE;11;0;11;1
2018-08-10 04:00:00;NORTE;11;0;11;1
2018-08-10 04:30:00;NORTE;10;0;10;1
2018-08-10 05:00:00;NORTE;15;1;16;1
2018-08-10 05:30:00;NORTE;39;0;39;1
2018-08-10 06:00:00;NORTE;20;1;21;1
2018-08-10 06:30:00;NORTE;23;0;23;1
2018-08-10 07:00:00;NORTE;41;0;41;1
2018-08-10 07:30:00;NORTE;28;1;29;1
2018-08-10 08:00:00;NORTE;32;0;32;1
2018-08-10 08:30:00;NORTE;34;0;34;1
2018-08-10 09:00:00;NORTE;24;0;24;1
2018-08-10 09:30:00;NORTE;36;0;36;1
2018-08-10 10:00:00;NORTE;36;0;36;1
2018-08-10 10:30:00;NORTE;31;0;31;1
2018-08-10 11:00:00;NORTE;31;0;31;1
2018-08-10 11:30:00;NORTE;30;1;31;1
2018-08-10 12:00:00;NORTE;26;0;26;1
2018-08-10 12:30:00;NORTE;35;0;35;1
2018-08-10 13:00:00;NORTE;39;0;39;1
2018-08-10 13:30:00;NORTE;36;0;36;1
2018-08-10 14:00:00;NORTE;37;0;37;1
2018-08-10 14:30:00;NORTE;30;1;31;1
2018-08-10 15:00:00;NORTE;25;0;25;1
2018-08-10 15:30:00;NORTE;17;0;17;1
2018-08-10 16:00:00;NORTE;23;0;23;1
2018-08-10 16:30:00;NORTE;28;0;28;1
2018-08-10 17:00:00;NORTE;22;0;22;1
2018-08-10 17:30:00;NORTE;28;0;28;1
2018-08-10 18:00:00;NORTE;34;0;34;1
2018-08-10 18:30:00;NORTE;28;0;28;1
2018-08-10 19:00:00;NORTE;28;0;28;1
2018-08-10 19:30:00;NORTE;31;0;31;1
2018-08-10 20:00:00;NORTE;35;0;35;1
2018-08-10 20:30:00;NORTE;18;0;18;1
2018-08-10 21:00:00;NORTE;17;0;17;1
2018-08-10 21:30:00;NORTE;4;0;4;1
2018-08-10 21:50:00;NORTE;5;0;5;1
2018-08-10 22:00:00;CONFLICTIVA;4;10;14;2
2018-08-10 22:30:00;SUR;0;3;3;1
2018-08-10 23:00:00;SUR;0;10;10;1
2018-08-10 23:30:00;SUR;0;2;2;1
2018-08-11 00:00:00;SUR;0;1;1;1
2018-08-11 00:30:00;SUR;0;3;3;1
2018-08-11 01:00:00;SUR;0;2;2;1
2018-08-11 01:30:00;SUR;0;1;1;1
2018-08-11 02:00:00;NORTE;1;0;1;1
2018-08-11 02:30:00;NORTE;4;0;4;1
2018-08-11 03:00:00;NORTE;1;0;1;1
2018-08-11 03:30:00;NORTE;3;0;3;1
2018-08-11 04:00:00;NORTE;12;0;12;1
2018-08-11 04:30:00;NORTE;11;0;11;1
2018-08-11 05:00:00;NORTE;13;0;13;1
2018-08-11 05:30:00;NORTE;33;0;33;1
2018-08-11 06:00:00;NORTE;14;0;14;1
2018-08-11 06:30:00;NORTE;17;0;17;1
2018-08-11 07:00:00;NORTE;40;0;40;1
2018-08-11 07:30:00;NORTE;30;0;30;1
2018-08-11 08:00:00;NORTE;35;0;35;1
2018-08-11 08:30:00;NORTE;28;0;28;1
2018-08-11 09:00:00;NORTE;20;0;20;1
2018-08-11 09:30:00;NORTE;24;0;24;1
2018-08-11 10:00:00;NORTE;30;0;30;1
2018-08-11 10:30:00;NORTE;35;0;35;1
2018-08-11 11:00:00;NORTE;29;0;29;1
2018-08-11 11:30:00;NORTE;26;0;26;1
2018-08-11 12:00:00;NORTE;33;0;33;1
2018-08-11 12:30:00;NORTE;33;0;33;1
2018-08-11 13:00:00;NORTE;29;0;29;1
2018-08-11 13:30:00;NORTE;35;0;35;1
2018-08-11 14:00:00;NORTE;26;0;26;1
2018-08-11 14:30:00;NORTE;28;0;28;1
2018-08-11 15:00:00;NORTE;27;0;27;1
2018-08-11 15:30:00;NORTE;22;0;22;1
2018-08-11 16:00:00;NORTE;19;0;19;1
2018-08-11 16:30:00;NORTE;28;0;28;1
2018-08-11 17:00:00;NORTE;16;0;16;1
2018-08-11 17:30:00;NORTE;19;0;19;1
2018-08-11 18:00:00;NORTE;34;0;34;1
2018-08-11 18:30:00;NORTE;23;0;23;1
2018-08-11 19:00:00;NORTE;21;0;21;1
2018-08-11 19:30:00;NORTE;32;0;32;1
2018-08-11 20:00:00;NORTE;27;0;27;1
2018-08-11 20:30:00;NORTE;16;0;16;1
2018-08-11 21:00:00;CONFLICTIVA;8;1;9;2
2018-08-11 21:30:00;NORTE;15;0;15;1
2018-08-11 22:00:00;NORTE;16;0;16;1
2018-08-11 22:30:00;NORTE;8;0;8;1
2018-08-11 23:00:00;NORTE;8;0;8;1
2018-08-11 23:30:00;NORTE;4;0;4;1
2018-08-12 00:00:00;NORTE;1;0;1;1
2018-08-12 00:30:00;NORTE;2;0;2;1
2018-08-12 01:00:00;NORTE;3;0;3;1
2018-08-12 02:00:00;NORTE;1;0;1;1
2018-08-12 02:30:00;NORTE;4;0;4;1
2018-08-12 03:00:00;NORTE;2;0;2;1
2018-08-12 03:30:00;NORTE;1;0;1;1
2018-08-12 04:00:00;NORTE;12;0;12;1
2018-08-12 04:30:00;NORTE;10;0;10;1
2018-08-12 05:00:00;NORTE;18;0;18;1
2018-08-12 05:30:00;NORTE;29;0;29;1
2018-08-12 06:00:00;NORTE;18;0;18;1
2018-08-12 06:30:00;NORTE;20;0;20;1
2018-08-12 07:00:00;NORTE;31;0;31;1
2018-08-12 07:30:00;NORTE;28;0;28;1
2018-08-12 08:00:00;NORTE;34;0;34;1
2018-08-12 08:30:00;NORTE;25;0;25;1
2018-08-12 09:00:00;NORTE;22;0;22;1
2018-08-12 09:30:00;NORTE;27;0;27;1
2018-08-12 10:00:00;NORTE;32;0;32;1
2018-08-12 10:30:00;NORTE;31;0;31;1
2018-08-12 11:00:00;NORTE;34;0;34;1
2018-08-12 11:30:00;NORTE;26;0;26;1
2018-08-12 12:00:00;NORTE;25;1;26;1
2018-08-12 12:30:00;SUR;0;29;29;1
2018-08-12 13:00:00;SUR;0;31;31;1
2018-08-12 13:30:00;SUR;0;29;29;1
2018-08-12 14:00:00;SUR;0;39;39;1
2018-08-12 14:30:00;SUR;0;32;32;1
2018-08-12 15:00:00;SUR;0;28;28;1
2018-08-12 15:30:00;SUR;0;15;15;1
2018-08-12 16:00:00;SUR;0;23;23;1
2018-08-12 16:30:00;SUR;0;22;22;1
2018-08-12 17:00:00;SUR;0;19;19;1
2018-08-12 17:30:00;SUR;0;20;20;1
2018-08-12 18:00:00;NORTE;36;0;36;1
2018-08-12 18:30:00;NORTE;31;0;31;1
2018-08-12 19:00:00;NORTE;33;0;33;1
2018-08-12 19:30:00;NORTE;29;0;29;1
2018-08-12 20:00:00;NORTE;33;0;33;1
2018-08-12 20:30:00;NORTE;34;0;34;1
2018-08-12 21:00:00;NORTE;14;0;14;1
2018-08-12 21:30:00;NORTE;22;0;22;1
2018-08-12 22:00:00;NORTE;16;0;16;1
2018-08-12 22:30:00;NORTE;14;0;14;1
2018-08-12 23:00:00;NORTE;11;0;11;1
2018-08-12 23:30:00;NORTE;3;0;3;1
2018-08-13 00:00:00;NORTE;3;0;3;1
2018-08-13 00:30:00;NORTE;3;0;3;1
2018-08-13 01:00:00;NORTE;2;0;2;1
2018-08-13 01:30:00;NORTE;1;0;1;1
2018-08-13 02:00:00;NORTE;3;0;3;1
2018-08-13 02:30:00;NORTE;4;0;4;1
2018-08-13 03:00:00;NORTE;3;0;3;1
2018-08-13 03:30:00;NORTE;5;0;5;1
2018-08-13 04:00:00;NORTE;10;0;10;1
2018-08-13 04:30:00;NORTE;14;0;14;1
2018-08-13 05:00:00;NORTE;16;0;16;1
2018-08-13 05:30:00;NORTE;36;0;36;1
2018-08-13 06:00:00;NORTE;15;0;15;1
2018-08-13 06:30:00;NORTE;28;0;28;1
2018-08-13 07:00:00;NORTE;35;0;35;1
2018-08-13 07:30:00;NORTE;31;0;31;1
2018-08-13 08:00:00;NORTE;33;0;33;1
2018-08-13 08:30:00;NORTE;25;0;25;1
2018-08-13 09:00:00;SUR;0;24;24;1
2018-08-13 09:30:00;SUR;0;30;30;1
2018-08-13 10:00:00;SUR;0;34;34;1
2018-08-13 10:30:00;SUR;0;24;24;1
2018-08-13 11:00:00;SUR;0;25;25;1
2018-08-13 11:30:00;SUR;0;25;25;1
2018-08-13 12:00:00;SUR;0;29;29;1
2018-08-13 12:30:00;SUR;0;28;28;1
2018-08-13 13:00:00;SUR;0;32;32;1
2018-08-13 13:30:00;SUR;0;27;27;1
2018-08-13 14:00:00;SUR;0;26;26;1
2018-08-13 14:30:00;SUR;0;34;34;1
2018-08-13 15:00:00;SUR;0;27;27;1
2018-08-13 15:30:00;SUR;0;22;22;1
2018-08-13 16:00:00;SUR;0;22;22;1
2018-08-13 16:30:00;SUR;0;27;27;1
2018-08-13 17:00:00;CONFLICTIVA;14;9;23;2
2018-08-13 17:30:00;NORTE;31;0;31;1
2018-08-13 18:00:00;NORTE;33;0;33;1
2018-08-13 18:30:00;NORTE;33;0;33;1
2018-08-13 19:00:00;NORTE;30;0;30;1
2018-08-13 19:30:00;NORTE;23;0;23;1
2018-08-13 20:00:00;NORTE;28;0;28;1
2018-08-13 20:30:00;NORTE;23;0;23;1
2018-08-13 21:00:00;NORTE;12;0;12;1
2018-08-13 21:30:00;NORTE;18;0;18;1
2018-08-13 22:00:00;NORTE;17;0;17;1
2018-08-13 22:30:00;NORTE;7;0;7;1
2018-08-13 23:00:00;NORTE;2;0;2;1
2018-08-14 00:00:00;NORTE;3;0;3;1
2018-08-14 00:30:00;NORTE;2;0;2;1
2018-08-14 01:00:00;NORTE;2;0;2;1
2018-08-14 01:30:00;NORTE;1;0;1;1
2018-08-14 02:00:00;NORTE;2;0;2;1
2018-08-14 02:30:00;NORTE;8;0;8;1
2018-08-14 03:00:00;NORTE;3;0;3;1
2018-08-14 03:30:00;NORTE;7;0;7;1
2018-08-14 04:00:00;NORTE;10;0;10;1
2018-08-14 04:30:00;NORTE;12;0;12;1
2018-08-14 05:00:00;NORTE;19;0;19;1
2018-08-14 05:30:00;NORTE;38;0;38;1
2018-08-14 06:00:00;NORTE;14;0;14;1
2018-08-14 06:30:00;NORTE;23;0;23;1
2018-08-14 07:00:00;NORTE;41;0;41;1
2018-08-14 07:30:00;NORTE;25;0;25;1
2018-08-14 08:00:00;NORTE;37;0;37;1
2018-08-14 08:30:00;NORTE;35;0;35;1
2018-08-14 09:00:00;NORTE;19;0;19;1
2018-08-14 09:30:00;NORTE;34;0;34;1
2018-08-14 10:00:00;NORTE;31;0;31;1
2018-08-14 10:30:00;NORTE;33;0;33;1
2018-08-14 11:00:00;NORTE;25;0;25;1
2018-08-14 11:30:00;NORTE;24;0;24;1
2018-08-14 12:00:00;NORTE;23;0;23;1
2018-08-14 12:30:00;NORTE;31;0;31;1
2018-08-14 13:00:00;NORTE;30;0;30;1
2018-08-14 13:30:00;NORTE;40;0;40;1
2018-08-14 14:00:00;NORTE;34;0;34;1
2018-08-14 14:30:00;NORTE;29;0;29;1
2018-08-14 15:00:00;NORTE;20;0;20;1
2018-08-14 15:30:00;NORTE;26;0;26;1
2018-08-14 16:00:00;NORTE;16;0;16;1
2018-08-14 16:30:00;NORTE;28;0;28;1
2018-08-14 17:00:00;NORTE;23;0;23;1
2018-08-14 17:30:00;NORTE;33;0;33;1
2018-08-14 18:00:00;NORTE;30;0;30;1
2018-08-14 18:30:00;NORTE;33;0;33;1
2018-08-14 19:00:00;NORTE;25;0;25;1
2018-08-14 19:30:00;NORTE;22;0;22;1
2018-08-14 20:00:00;NORTE;33;0;33;1
2018-08-14 20:30:00;NORTE;19;0;19;1
2018-08-14 21:00:00;NORTE;12;0;12;1
2018-08-14 21:30:00;NORTE;12;0;12;1
2018-08-14 22:00:00;NORTE;20;0;20;1
2018-08-14 22:30:00;NORTE;7;0;7;1
2018-08-14 23:00:00;NORTE;4;0;4;1
2018-08-14 23:30:00;NORTE;2;0;2;1
2018-08-15 00:00:00;NORTE;3;0;3;1
2018-08-15 01:00:00;NORTE;1;0;1;1
2018-08-15 01:30:00;NORTE;2;0;2;1
2018-08-15 02:00:00;NORTE;2;0;2;1
2018-08-15 02:30:00;NORTE;3;0;3;1
2018-08-15 03:00:00;NORTE;5;0;5;1
2018-08-15 03:30:00;NORTE;5;0;5;1
2018-08-15 04:00:00;NORTE;12;0;12;1
2018-08-15 04:30:00;NORTE;12;0;12;1
2018-08-15 05:00:00;NORTE;16;0;16;1
2018-08-15 05:30:00;NORTE;44;0;44;1
2018-08-15 06:00:00;NORTE;19;0;19;1
2018-08-15 06:30:00;NORTE;24;0;24;1
2018-08-15 07:00:00;NORTE;40;0;40;1
2018-08-15 07:30:00;NORTE;29;0;29;1
2018-08-15 08:00:00;NORTE;34;0;34;1
2018-08-15 08:30:00;NORTE;35;0;35;1
2018-08-15 09:00:00;NORTE;26;0;26;1
2018-08-15 09:30:00;NORTE;34;0;34;1
2018-08-15 10:00:00;NORTE;34;0;34;1
2018-08-15 10:30:00;NORTE;30;0;30;1
2018-08-15 11:00:00;NORTE;31;0;31;1
2018-08-15 11:30:00;NORTE;25;0;25;1
2018-08-15 12:00:00;NORTE;28;0;28;1
2018-08-15 12:30:00;NORTE;31;0;31;1
2018-08-15 13:00:00;NORTE;27;0;27;1
2018-08-15 13:30:00;NORTE;32;0;32;1
2018-08-15 14:00:00;NORTE;41;0;41;1
2018-08-15 14:30:00;NORTE;32;0;32;1
2018-08-15 15:00:00;NORTE;25;0;25;1
2018-08-15 15:30:00;NORTE;18;0;18;1
2018-08-15 16:00:00;NORTE;21;0;21;1
2018-08-15 16:30:00;NORTE;29;0;29;1
2018-08-15 17:00:00;NORTE;27;0;27;1
2018-08-15 17:30:00;NORTE;25;0;25;1
2018-08-15 18:00:00;NORTE;32;0;32;1
2018-08-15 18:30:00;NORTE;27;0;27;1
2018-08-15 19:00:00;NORTE;28;0;28;1
2018-08-15 19:30:00;NORTE;24;0;24;1
2018-08-15 20:00:00;NORTE;30;0;30;1
2018-08-15 20:30:00;NORTE;27;0;27;1
2018-08-15 21:00:00;NORTE;13;0;13;1
2018-08-15 21:30:00;NORTE;14;0;14;1
2018-08-15 22:00:00;NORTE;13;0;13;1
2018-08-15 22:30:00;NORTE;6;0;6;1
2018-08-15 23:00:00;NORTE;4;0;4;1
2018-08-15 23:30:00;NORTE;3;0;3;1
2018-08-16 00:00:00;NORTE;2;0;2;1
2018-08-16 00:30:00;NORTE;1;0;1;1
2018-08-16 01:00:00;NORTE;1;0;1;1
2018-08-16 01:30:00;NORTE;1;0;1;1
2018-08-16 02:00:00;NORTE;2;0;2;1
2018-08-16 02:30:00;NORTE;2;0;2;1
2018-08-16 03:00:00;NORTE;2;0;2;1
2018-08-16 03:30:00;NORTE;5;0;5;1
2018-08-16 04:00:00;NORTE;11;0;11;1
2018-08-16 04:30:00;NORTE;11;0;11;1
2018-08-16 05:00:00;NORTE;19;0;19;1
2018-08-16 05:30:00;NORTE;34;0;34;1
2018-08-16 06:00:00;NORTE;22;0;22;1
2018-08-16 06:30:00;NORTE;23;0;23;1
2018-08-16 07:00:00;NORTE;31;0;31;1
2018-08-16 07:30:00;NORTE;29;0;29;1
2018-08-16 08:00:00;CONFLICTIVA;8;20;28;2
2018-08-16 08:30:00;SUR;0;30;30;1
2018-08-16 09:00:00;SUR;0;21;21;1
2018-08-16 09:30:00;SUR;0;33;33;1
2018-08-16 10:00:00;SUR;0;30;30;1
2018-08-16 10:30:00;SUR;0;31;31;1
2018-08-16 11:00:00;SUR;0;28;28;1
2018-08-16 11:30:00;SUR;0;26;26;1
2018-08-16 12:00:00;SUR;0;25;25;1
2018-08-16 12:30:00;SUR;0;31;31;1
2018-08-16 13:00:00;SUR;0;30;30;1
2018-08-16 13:30:00;SUR;0;30;30;1
2018-08-16 14:00:00;SUR;0;37;37;1
2018-08-16 14:30:00;SUR;0;34;34;1
2018-08-16 15:00:00;SUR;0;24;24;1
2018-08-16 15:30:00;SUR;0;14;14;1
2018-08-16 16:00:00;SUR;0;24;24;1
2018-08-16 16:30:00;SUR;0;27;27;1
2018-08-16 17:00:00;SUR;0;23;23;1
2018-08-16 17:30:00;SUR;0;20;20;1
2018-08-16 18:00:00;SUR;0;39;39;1
2018-08-16 18:30:00;SUR;0;27;27;1
2018-08-16 19:00:00;SUR;0;21;21;1
2018-08-16 19:30:00;SUR;0;31;31;1
2018-08-16 20:00:00;SUR;0;25;25;1
2018-08-16 20:30:00;SUR;0;24;24;1
2018-08-16 21:00:00;SUR;0;22;22;1
2018-08-16 21:30:00;SUR;0;14;14;1
2018-08-16 22:00:00;CONFLICTIVA;7;5;12;2
2018-08-16 22:30:00;NORTE;11;0;11;1
2018-08-16 23:00:00;NORTE;3;0;3;1
2018-08-16 23:30:00;NORTE;1;0;1;1
2018-08-17 00:00:00;CONFLICTIVA;1;1;2;2
2018-08-17 00:30:00;SUR;0;1;1;1
2018-08-17 01:00:00;NORTE;1;0;1;1
2018-08-17 01:30:00;NORTE;2;0;2;1
2018-08-17 02:00:00;NORTE;3;0;3;1
2018-08-17 02:30:00;NORTE;4;0;4;1
2018-08-17 03:00:00;NORTE;3;0;3;1
2018-08-17 03:30:00;NORTE;7;0;7;1
2018-08-17 04:00:00;NORTE;13;0;13;1
2018-08-17 04:30:00;NORTE;13;0;13;1
2018-08-17 05:00:00;NORTE;19;0;19;1
2018-08-17 05:30:00;NORTE;36;0;36;1
2018-08-17 06:00:00;NORTE;21;0;21;1
2018-08-17 06:30:00;NORTE;19;0;19;1
2018-08-17 07:00:00;NORTE;44;0;44;1
2018-08-17 07:30:00;NORTE;25;0;25;1
2018-08-17 08:00:00;NORTE;38;0;38;1
2018-08-17 08:30:00;NORTE;29;0;29;1
2018-08-17 09:00:00;NORTE;26;0;26;1
2018-08-17 09:30:00;NORTE;30;0;30;1
2018-08-17 10:00:00;NORTE;37;0;37;1
2018-08-17 10:30:00;NORTE;30;0;30;1
2018-08-17 11:00:00;NORTE;28;0;28;1
2018-08-17 11:30:00;NORTE;25;0;25;1
2018-08-17 12:00:00;NORTE;25;0;25;1
2018-08-17 12:30:00;NORTE;27;0;27;1
2018-08-17 13:00:00;NORTE;32;0;32;1
2018-08-17 13:30:00;NORTE;28;0;28;1
2018-08-17 14:00:00;NORTE;34;0;34;1
2018-08-17 14:30:00;NORTE;29;0;29;1
2018-08-17 15:00:00;NORTE;35;0;35;1
2018-08-17 15:30:00;NORTE;22;0;22;1
2018-08-17 16:00:00;NORTE;18;0;18;1
2018-08-17 16:30:00;NORTE;21;0;21;1
2018-08-17 17:00:00;NORTE;23;0;23;1
2018-08-17 17:30:00;NORTE;20;0;20;1
2018-08-17 18:00:00;NORTE;27;0;27;1
2018-08-17 18:30:00;NORTE;32;0;32;1
2018-08-17 19:00:00;NORTE;30;0;30;1
2018-08-17 19:30:00;NORTE;25;0;25;1
2018-08-17 20:00:00;NORTE;31;0;31;1
2018-08-17 20:30:00;NORTE;27;0;27;1
2018-08-17 21:00:00;NORTE;13;0;13;1
2018-08-17 21:30:00;NORTE;17;0;17;1
2018-08-17 22:00:00;NORTE;16;0;16;1
2018-08-17 22:30:00;NORTE;8;0;8;1
2018-08-17 23:00:00;NORTE;7;0;7;1
2018-08-17 23:30:00;NORTE;4;0;4;1
2018-08-18 00:00:00;NORTE;1;0;1;1
2018-08-18 00:30:00;NORTE;2;0;2;1
2018-08-18 01:00:00;NORTE;1;0;1;1
2018-08-18 01:30:00;NORTE;1;0;1;1
2018-08-18 02:00:00;NORTE;1;0;1;1
2018-08-18 02:30:00;NORTE;4;0;4;1
2018-08-18 03:00:00;NORTE;2;0;2;1
2018-08-18 03:30:00;NORTE;4;0;4;1
2018-08-18 04:00:00;NORTE;14;0;14;1
2018-08-18 04:30:00;NORTE;15;0;15;1
2018-08-18 05:00:00;NORTE;14;0;14;1
2018-08-18 05:30:00;NORTE;28;0;28;1
2018-08-18 06:00:00;NORTE;17;0;17;1
2018-08-18 06:30:00;NORTE;15;0;15;1
2018-08-18 07:00:00;NORTE;43;0;43;1
2018-08-18 07:30:00;NORTE;27;0;27;1
2018-08-18 08:00:00;NORTE;36;0;36;1
2018-08-18 08:30:00;NORTE;25;0;25;1
2018-08-18 09:00:00;NORTE;15;0;15;1
2018-08-18 09:30:00;NORTE;25;0;25;1
2018-08-18 10:00:00;NORTE;35;0;35;1
2018-08-18 10:30:00;NORTE;28;0;28;1
2018-08-18 11:00:00;NORTE;24;0;24;1
2018-08-18 11:30:00;NORTE;21;0;21;1
2018-08-18 12:00:00;NORTE;29;0;29;1
2018-08-18 12:30:00;NORTE;36;0;36;1
2018-08-18 13:00:00;NORTE;26;0;26;1
2018-08-18 13:30:00;NORTE;26;0;26;1
2018-08-18 14:00:00;NORTE;31;0;31;1
2018-08-18 14:30:00;NORTE;31;0;31;1
2018-08-18 15:00:00;NORTE;25;0;25;1
2018-08-18 15:30:00;NORTE;20;0;20;1
2018-08-18 16:00:00;NORTE;19;0;19;1
2018-08-18 16:30:00;NORTE;21;0;21;1
2018-08-18 17:00:00;NORTE;17;0;17;1
2018-08-18 17:30:00;NORTE;26;0;26;1
2018-08-18 18:00:00;NORTE;32;0;32;1
2018-08-18 18:30:00;NORTE;25;0;25;1
2018-08-18 19:00:00;NORTE;28;0;28;1
2018-08-18 19:30:00;NORTE;25;0;25;1
2018-08-18 20:00:00;NORTE;24;0;24;1
2018-08-18 20:30:00;NORTE;12;0;12;1
2018-08-18 21:00:00;NORTE;11;0;11;1
2018-08-18 21:30:00;NORTE;17;0;17;1
2018-08-18 22:00:00;NORTE;18;0;18;1
2018-08-18 22:30:00;NORTE;11;0;11;1
2018-08-18 23:00:00;NORTE;4;0;4;1
2018-08-18 23:30:00;NORTE;1;0;1;1
2018-08-19 00:30:00;NORTE;4;0;4;1
2018-08-19 01:00:00;NORTE;1;0;1;1
2018-08-19 01:30:00;NORTE;1;0;1;1
2018-08-19 02:00:00;NORTE;4;0;4;1
2018-08-19 02:30:00;NORTE;1;0;1;1
2018-08-19 03:00:00;NORTE;4;0;4;1
2018-08-19 03:30:00;NORTE;2;0;2;1
2018-08-19 04:00:00;NORTE;12;0;12;1
2018-08-19 04:30:00;NORTE;13;0;13;1
2018-08-19 05:00:00;NORTE;17;0;17;1
2018-08-19 05:30:00;NORTE;31;0;31;1
2018-08-19 06:00:00;NORTE;13;0;13;1
2018-08-19 06:30:00;NORTE;18;0;18;1
2018-08-19 07:00:00;NORTE;37;0;37;1
2018-08-19 07:30:00;NORTE;24;0;24;1
2018-08-19 08:00:00;NORTE;36;0;36;1
2018-08-19 08:30:00;NORTE;31;0;31;1
2018-08-19 09:00:00;NORTE;25;0;25;1
2018-08-19 09:30:00;NORTE;31;0;31;1
2018-08-19 10:00:00;NORTE;32;0;32;1
2018-08-19 10:30:00;NORTE;34;0;34;1
2018-08-19 11:00:00;NORTE;25;0;25;1
2018-08-19 11:30:00;NORTE;22;0;22;1
2018-08-19 12:00:00;NORTE;28;0;28;1
2018-08-19 12:30:00;NORTE;36;0;36;1
2018-08-19 13:00:00;NORTE;38;0;38;1
2018-08-19 13:30:00;NORTE;35;0;35;1
2018-08-19 14:00:00;NORTE;48;0;48;1
2018-08-19 14:30:00;NORTE;33;0;33;1
2018-08-19 15:00:00;NORTE;22;0;22;1
2018-08-19 15:30:00;NORTE;23;0;23;1
2018-08-19 16:00:00;NORTE;20;0;20;1
2018-08-19 16:30:00;NORTE;23;0;23;1
2018-08-19 17:00:00;NORTE;19;0;19;1
2018-08-19 17:30:00;NORTE;22;0;22;1
2018-08-19 18:00:00;NORTE;37;0;37;1
2018-08-19 18:30:00;NORTE;30;0;30;1
2018-08-19 19:00:00;NORTE;32;0;32;1
2018-08-19 19:30:00;NORTE;30;0;30;1
2018-08-19 20:00:00;NORTE;33;0;33;1
2018-08-19 20:30:00;NORTE;26;0;26;1
2018-08-19 21:00:00;NORTE;14;0;14;1
2018-08-19 21:30:00;NORTE;16;0;16;1
2018-08-19 22:00:00;NORTE;18;0;18;1
2018-08-19 22:30:00;NORTE;11;0;11;1
2018-08-19 23:00:00;NORTE;4;0;4;1
2018-08-19 23:30:00;NORTE;4;0;4;1
2018-08-20 00:00:00;NORTE;2;0;2;1
2018-08-20 00:30:00;NORTE;1;0;1;1
2018-08-20 01:30:00;NORTE;2;0;2;1
2018-08-20 02:00:00;NORTE;5;0;5;1
2018-08-20 02:30:00;NORTE;3;0;3;1
2018-08-20 03:00:00;NORTE;1;0;1;1
2018-08-20 03:30:00;NORTE;4;0;4;1
2018-08-20 04:00:00;NORTE;11;0;11;1
2018-08-20 04:30:00;NORTE;10;0;10;1
2018-08-20 05:00:00;NORTE;23;0;23;1
2018-08-20 05:30:00;NORTE;34;0;34;1
2018-08-20 06:00:00;NORTE;20;0;20;1
2018-08-20 06:30:00;NORTE;30;0;30;1
2018-08-20 07:00:00;NORTE;35;0;35;1
2018-08-20 07:30:00;NORTE;27;0;27;1
2018-08-20 08:00:00;NORTE;38;0;38;1
2018-08-20 08:30:00;NORTE;27;0;27;1
2018-08-20 09:00:00;NORTE;21;0;21;1
2018-08-20 09:30:00;NORTE;29;0;29;1
2018-08-20 10:00:00;NORTE;36;0;36;1
2018-08-20 10:30:00;NORTE;38;0;38;1
2018-08-20 11:00:00;NORTE;31;0;31;1
2018-08-20 11:30:00;NORTE;23;0;23;1
2018-08-20 12:00:00;NORTE;25;0;25;1
2018-08-20 12:30:00;NORTE;35;0;35;1
2018-08-20 13:00:00;NORTE;34;0;34;1
2018-08-20 13:30:00;NORTE;35;0;35;1
2018-08-20 14:00:00;NORTE;38;0;38;1
2018-08-20 14:30:00;NORTE;30;0;30;1
2018-08-20 15:00:00;NORTE;27;0;27;1
2018-08-20 15:30:00;NORTE;20;0;20;1
2018-08-20 16:00:00;NORTE;21;0;21;1
2018-08-20 16:30:00;NORTE;36;0;36;1
2018-08-20 17:00:00;NORTE;26;0;26;1
2018-08-20 17:30:00;NORTE;25;0;25;1
2018-08-20 18:00:00;NORTE;35;0;35;1
2018-08-20 18:30:00;NORTE;36;0;36;1
2018-08-20 19:00:00;NORTE;37;0;37;1
2018-08-20 19:30:00;NORTE;24;0;24;1
2018-08-20 20:00:00;NORTE;25;0;25;1
2018-08-20 20:30:00;NORTE;28;0;28;1
2018-08-20 21:00:00;NORTE;13;0;13;1
2018-08-20 21:30:00;NORTE;19;0;19;1
2018-08-20 22:00:00;NORTE;12;0;12;1
2018-08-20 22:30:00;NORTE;6;0;6;1
2018-08-20 23:00:00;NORTE;2;0;2;1
2018-08-20 23:30:00;NORTE;1;0;1;1
2018-08-21 00:30:00;NORTE;1;0;1;1
2018-08-21 01:00:00;NORTE;2;0;2;1
2018-08-21 02:00:00;NORTE;5;0;5;1
2018-08-21 02:30:00;NORTE;4;0;4;1
2018-08-21 03:00:00;NORTE;3;0;3;1
2018-08-21 03:30:00;NORTE;8;0;8;1
2018-08-21 04:00:00;NORTE;13;0;13;1
2018-08-21 04:30:00;NORTE;13;0;13;1
2018-08-21 05:00:00;NORTE;22;0;22;1
2018-08-21 05:31:32;NORTE;1;0;1;1
2018-08-21 05:32:07;NORTE;1;0;1;1
2018-08-21 05:34:26;NORTE;1;0;1;1
2018-08-21 05:34:49;NORTE;1;0;1;1
2018-08-21 05:36:29;NORTE;1;0;1;1
2018-08-21 05:37:04;NORTE;1;0;1;1
2018-08-21 05:37:10;NORTE;1;0;1;1
2018-08-21 05:38:54;NORTE;1;0;1;1
2018-08-21 05:39:07;NORTE;1;0;1;1
2018-08-21 05:39:45;NORTE;1;0;1;1
2018-08-21 05:40:23;NORTE;1;0;1;1
2018-08-21 05:41:34;NORTE;1;0;1;1
2018-08-21 05:41:43;NORTE;1;0;1;1
2018-08-21 05:41:56;NORTE;1;0;1;1
2018-08-21 05:42:03;NORTE;1;0;1;1
2018-08-21 05:43:16;NORTE;1;0;1;1
2018-08-21 05:43:43;NORTE;1;0;1;1
2018-08-21 05:45:07;NORTE;1;0;1;1
2018-08-21 05:46:22;NORTE;1;0;1;1
2018-08-21 05:47:29;NORTE;1;0;1;1
2018-08-21 05:47:52;NORTE;1;0;1;1
2018-08-21 05:48:25;NORTE;1;0;1;1
2018-08-21 05:48:46;NORTE;1;0;1;1
2018-08-21 05:49:32;NORTE;1;0;1;1
2018-08-21 05:50:41;NORTE;1;0;1;1
2018-08-21 05:50:55;NORTE;1;0;1;1
2018-08-21 05:50:59;NORTE;1;0;1;1
2018-08-21 05:51:51;NORTE;1;0;1;1
2018-08-21 05:52:12;NORTE;1;0;1;1
2018-08-21 05:52:52;NORTE;1;0;1;1
2018-08-21 05:53:07;NORTE;1;0;1;1
2018-08-21 05:54:18;NORTE;1;0;1;1
2018-08-21 05:54:51;NORTE;1;0;1;1
2018-08-21 05:55:56;NORTE;1;0;1;1
2018-08-21 05:56:04;NORTE;1;0;1;1
2018-08-21 05:56:29;NORTE;1;0;1;1
2018-08-21 05:58:53;NORTE;1;0;1;1
2018-08-21 05:58:57;NORTE;1;0;1;1
2018-08-21 05:59:38;NORTE;1;0;1;1
2018-08-21 06:01:23;NORTE;1;0;1;1
2018-08-21 06:02:12;NORTE;1;0;1;1
2018-08-21 06:06:28;NORTE;1;0;1;1
2018-08-21 06:08:07;NORTE;1;0;1;1
2018-08-21 06:08:21;NORTE;1;0;1;1
2018-08-21 06:09:34;NORTE;1;0;1;1
2018-08-21 06:10:21;NORTE;1;0;1;1
2018-08-21 06:11:07;NORTE;1;0;1;1
2018-08-21 06:14:05;NORTE;1;0;1;1
2018-08-21 06:16:54;NORTE;1;0;1;1
2018-08-21 06:18:56;NORTE;1;0;1;1
2018-08-21 06:19:08;NORTE;1;0;1;1
2018-08-21 06:22:11;NORTE;1;0;1;1
2018-08-21 06:26:32;NORTE;1;0;1;1
2018-08-21 06:27:05;NORTE;1;0;1;1
2018-08-21 06:33:57;NORTE;1;0;1;1
2018-08-21 06:35:55;NORTE;1;0;1;1
2018-08-21 06:38:07;NORTE;1;0;1;1
2018-08-21 06:39:49;NORTE;1;0;1;1
2018-08-21 06:40:49;NORTE;1;0;1;1
2018-08-21 06:41:06;NORTE;1;0;1;1
2018-08-21 06:42:28;NORTE;1;0;1;1
2018-08-21 06:43:47;NORTE;1;0;1;1
2018-08-21 06:43:59;NORTE;1;0;1;1
2018-08-21 06:45:41;NORTE;1;0;1;1
2018-08-21 06:47:03;NORTE;1;0;1;1
2018-08-21 06:49:18;NORTE;1;0;1;1
2018-08-21 06:50:12;NORTE;1;0;1;1
2018-08-21 06:51:12;NORTE;1;0;1;1
2018-08-21 06:51:23;NORTE;1;0;1;1
2018-08-21 06:53:15;NORTE;1;0;1;1
2018-08-21 06:54:26;NORTE;1;0;1;1
2018-08-21 06:54:32;NORTE;1;0;1;1
2018-08-21 06:55:43;NORTE;1;0;1;1
2018-08-21 06:56:07;NORTE;1;0;1;1
2018-08-21 06:57:12;NORTE;1;0;1;1
2018-08-21 06:59:13;NORTE;1;0;1;1
2018-08-21 06:59:48;NORTE;1;0;1;1
2018-08-21 07:00:00;NORTE;33;0;33;1
2018-08-21 07:30:00;NORTE;33;0;33;1
2018-08-21 08:00:00;NORTE;32;0;32;1
2018-08-21 08:30:00;NORTE;32;0;32;1
2018-08-21 09:00:00;NORTE;22;0;22;1
2018-08-21 09:30:00;NORTE;36;0;36;1
2018-08-21 10:00:00;NORTE;28;0;28;1
2018-08-21 10:30:00;NORTE;28;0;28;1
2018-08-21 11:00:00;NORTE;31;0;31;1
2018-08-21 11:30:00;SUR;0;17;17;1
2018-08-21 12:00:00;SUR;0;24;24;1
2018-08-21 12:30:00;SUR;0;27;27;1
2018-08-21 13:00:00;SUR;0;29;29;1
2018-08-21 13:30:00;SUR;0;32;32;1
2018-08-21 14:00:00;SUR;0;30;30;1
2018-08-21 14:30:00;SUR;0;38;38;1
2018-08-21 15:00:00;CONFLICTIVA;8;18;26;2
2018-08-21 15:30:00;NORTE;22;0;22;1
2018-08-21 16:00:00;NORTE;25;0;25;1
2018-08-21 16:30:00;NORTE;27;0;27;1
2018-08-21 17:00:00;NORTE;28;0;28;1
2018-08-21 17:30:00;NORTE;29;0;29;1
2018-08-21 18:00:00;NORTE;33;0;33;1
2018-08-21 18:30:00;NORTE;33;0;33;1
2018-08-21 19:00:00;NORTE;28;0;28;1
2018-08-21 19:30:00;NORTE;24;0;24;1
2018-08-21 20:00:00;NORTE;33;0;33;1
2018-08-21 20:30:00;NORTE;24;0;24;1
2018-08-21 21:00:00;NORTE;11;0;11;1
2018-08-21 21:30:00;NORTE;14;0;14;1
2018-08-21 22:00:00;NORTE;15;0;15;1
2018-08-21 22:30:00;NORTE;4;0;4;1
2018-08-21 23:00:00;NORTE;4;0;4;1
2018-08-21 23:30:00;NORTE;2;0;2;1
2018-08-22 00:00:00;NORTE;1;0;1;1
2018-08-22 01:00:00;NORTE;1;0;1;1
2018-08-22 01:30:00;NORTE;1;0;1;1
2018-08-22 02:00:00;NORTE;4;0;4;1
2018-08-22 02:30:00;NORTE;3;0;3;1
2018-08-22 03:00:00;NORTE;2;0;2;1
2018-08-22 03:30:00;NORTE;9;0;9;1
2018-08-22 04:00:00;NORTE;13;0;13;1
2018-08-22 04:30:00;NORTE;15;0;15;1
2018-08-22 05:00:00;NORTE;20;0;20;1
2018-08-22 05:30:00;NORTE;40;0;40;1
2018-08-22 06:00:00;NORTE;21;0;21;1
2018-08-22 06:30:00;NORTE;27;0;27;1
2018-08-22 07:00:00;NORTE;35;0;35;1
2018-08-22 07:30:00;NORTE;29;0;29;1
2018-08-22 08:00:00;NORTE;34;0;34;1
2018-08-22 08:30:00;NORTE;38;0;38;1
2018-08-22 09:00:00;NORTE;27;0;27;1
2018-08-22 09:30:00;NORTE;32;0;32;1
2018-08-22 10:00:00;NORTE;30;0;30;1
2018-08-22 10:30:00;NORTE;36;0;36;1
2018-08-22 11:00:00;NORTE;25;0;25;1
2018-08-22 11:30:00;NORTE;27;0;27;1
2018-08-22 12:00:00;NORTE;26;0;26;1
2018-08-22 12:30:00;NORTE;37;0;37;1
2018-08-22 13:00:00;NORTE;32;0;32;1
2018-08-22 13:30:00;NORTE;28;0;28;1
2018-08-22 14:00:00;NORTE;38;0;38;1
2018-08-22 14:30:00;NORTE;36;0;36;1
2018-08-22 15:00:00;NORTE;27;0;27;1
2018-08-22 15:30:00;NORTE;16;0;16;1
2018-08-22 16:00:00;NORTE;20;0;20;1
2018-08-22 16:30:00;NORTE;27;0;27;1
2018-08-22 17:00:00;NORTE;29;0;29;1
2018-08-22 17:30:00;NORTE;26;0;26;1
2018-08-22 18:00:00;SUR;1;24;25;1
2018-08-22 18:30:00;SUR;0;36;36;1
2018-08-22 19:00:00;SUR;0;26;26;1
2018-08-22 19:30:00;SUR;0;27;27;1
2018-08-22 20:00:00;SUR;0;29;29;1
2018-08-22 20:30:00;SUR;0;17;17;1
2018-08-22 21:00:00;NORTE;14;0;14;1
2018-08-22 21:30:00;NORTE;18;0;18;1
2018-08-22 22:00:00;NORTE;18;0;18;1
2018-08-22 22:30:00;NORTE;8;0;8;1
2018-08-22 23:00:00;NORTE;6;0;6;1
2018-08-22 23:30:00;NORTE;3;0;3;1
2018-08-23 00:00:00;NORTE;3;0;3;1
2018-08-23 00:30:00;NORTE;2;0;2;1
2018-08-23 01:00:00;NORTE;1;0;1;1
2018-08-23 01:30:00;NORTE;1;0;1;1
2018-08-23 02:00:00;NORTE;3;0;3;1
2018-08-23 02:30:00;NORTE;3;0;3;1
2018-08-23 03:00:00;NORTE;3;0;3;1
2018-08-23 03:30:00;NORTE;3;0;3;1
2018-08-23 04:00:00;NORTE;14;0;14;1
2018-08-23 04:30:00;NORTE;10;0;10;1
2018-08-23 05:00:00;NORTE;19;0;19;1
2018-08-23 05:30:00;NORTE;35;0;35;1
2018-08-23 06:00:00;NORTE;17;0;17;1
2018-08-23 06:30:00;NORTE;25;0;25;1
2018-08-23 07:00:00;NORTE;35;0;35;1
2018-08-23 07:30:00;NORTE;28;0;28;1
2018-08-23 08:00:00;NORTE;35;0;35;1
2018-08-23 08:30:00;NORTE;32;0;32;1
2018-08-23 09:00:00;NORTE;19;0;19;1
2018-08-23 09:30:00;NORTE;33;0;33;1
2018-08-23 10:00:00;NORTE;31;0;31;1
2018-08-23 10:30:00;NORTE;37;0;37;1
2018-08-23 11:00:00;NORTE;19;0;19;1
2018-08-23 11:30:00;NORTE;24;0;24;1
2018-08-23 12:00:00;NORTE;26;1;27;1
2018-08-23 12:30:00;NORTE;29;1;30;1
2018-08-23 13:00:00;NORTE;35;0;35;1
2018-08-23 13:30:00;NORTE;29;0;29;1
2018-08-23 14:00:00;NORTE;35;0;35;1
2018-08-23 14:30:00;NORTE;33;0;33;1
2018-08-23 15:00:00;NORTE;24;0;24;1
2018-08-23 15:30:00;NORTE;18;0;18;1
2018-08-23 16:00:00;NORTE;22;0;22;1
2018-08-23 16:30:00;NORTE;24;0;24;1
2018-08-23 17:00:00;NORTE;19;0;19;1
2018-08-23 17:30:00;NORTE;22;0;22;1
2018-08-23 18:00:00;NORTE;33;0;33;1
2018-08-23 18:30:00;NORTE;37;0;37;1
2018-08-23 19:00:00;NORTE;19;0;19;1
2018-08-23 19:18:00;NORTE;8;0;8;1
2018-08-23 19:30:00;NORTE;22;0;22;1
2018-08-23 20:00:00;NORTE;25;0;25;1
2018-08-23 20:30:00;NORTE;20;0;20;1
2018-08-23 21:00:00;NORTE;23;0;23;1
2018-08-23 21:30:00;NORTE;20;0;20;1
2018-08-23 22:00:00;NORTE;23;0;23;1
2018-08-23 22:30:00;SUR;1;11;12;1
2018-08-23 23:00:00;SUR;0;1;1;1
2018-08-24 00:00:00;SUR;0;3;3;1
2018-08-24 00:30:00;SUR;0;2;2;1
2018-08-24 01:00:00;SUR;0;1;1;1
2018-08-24 01:30:00;CONFLICTIVA;1;1;2;2
2018-08-24 02:00:00;NORTE;2;0;2;1
2018-08-24 02:30:00;NORTE;2;0;2;1
2018-08-24 03:00:00;NORTE;5;0;5;1
2018-08-24 03:30:00;NORTE;6;0;6;1
2018-08-24 04:00:00;NORTE;10;0;10;1
2018-08-24 04:30:00;NORTE;15;0;15;1
2018-08-24 05:00:00;NORTE;16;0;16;1
2018-08-24 05:30:00;NORTE;34;0;34;1
2018-08-24 06:00:00;NORTE;20;0;20;1
2018-08-24 06:30:00;NORTE;23;0;23;1
2018-08-24 07:00:00;NORTE;40;0;40;1
2018-08-24 07:30:00;NORTE;27;0;27;1
2018-08-24 08:00:00;NORTE;32;0;32;1
2018-08-24 08:30:00;NORTE;35;0;35;1
2018-08-24 09:00:00;NORTE;20;0;20;1
2018-08-24 09:30:00;NORTE;30;0;30;1
2018-08-24 10:00:00;NORTE;38;0;38;1
2018-08-24 10:30:00;NORTE;33;0;33;1
2018-08-24 11:00:00;NORTE;29;0;29;1
2018-08-24 11:30:00;NORTE;25;0;25;1
2018-08-24 12:00:00;NORTE;28;0;28;1
2018-08-24 12:30:00;NORTE;34;0;34;1
2018-08-24 13:00:00;NORTE;28;0;28;1
2018-08-24 13:30:00;NORTE;33;0;33;1
2018-08-24 14:00:00;NORTE;36;0;36;1
2018-08-24 14:30:00;NORTE;30;0;30;1
2018-08-24 15:00:00;NORTE;28;0;28;1
2018-08-24 15:30:00;NORTE;19;0;19;1
2018-08-24 16:00:00;NORTE;20;0;20;1
2018-08-24 16:30:00;NORTE;31;0;31;1
2018-08-24 17:00:00;NORTE;16;0;16;1
2018-08-24 17:30:00;NORTE;25;0;25;1
2018-08-24 18:00:00;NORTE;34;0;34;1
2018-08-24 18:30:00;NORTE;34;0;34;1
2018-08-24 19:00:00;NORTE;29;0;29;1
2018-08-24 19:30:00;NORTE;17;0;17;1
2018-08-24 20:00:00;NORTE;37;0;37;1
2018-08-24 20:30:00;NORTE;20;0;20;1
2018-08-24 21:00:00;NORTE;12;0;12;1
2018-08-24 21:30:00;NORTE;20;0;20;1
2018-08-24 22:00:00;NORTE;13;0;13;1
2018-08-24 22:30:00;NORTE;9;0;9;1
2018-08-24 23:00:00;NORTE;3;0;3;1
2018-08-24 23:30:00;NORTE;3;0;3;1
2018-08-25 00:00:00;NORTE;1;0;1;1
2018-08-25 00:30:00;NORTE;1;0;1;1
2018-08-25 01:00:00;NORTE;2;0;2;1
2018-08-25 01:30:00;NORTE;1;0;1;1
2018-08-25 02:00:00;NORTE;4;0;4;1
2018-08-25 02:30:00;NORTE;4;0;4;1
2018-08-25 03:30:00;NORTE;3;0;3;1
2018-08-25 04:00:00;NORTE;12;0;12;1
2018-08-25 04:30:00;NORTE;14;0;14;1
2018-08-25 05:00:00;NORTE;21;0;21;1
2018-08-25 05:30:00;NORTE;28;0;28;1
2018-08-25 06:00:00;NORTE;15;0;15;1
2018-08-25 06:30:00;NORTE;19;0;19;1
2018-08-25 07:00:00;NORTE;36;0;36;1
2018-08-25 07:30:00;NORTE;27;0;27;1
2018-08-25 08:00:00;NORTE;30;0;30;1
2018-08-25 08:30:00;NORTE;32;0;32;1
2018-08-25 09:00:00;NORTE;19;0;19;1
2018-08-25 09:30:00;NORTE;29;0;29;1
2018-08-25 10:00:00;NORTE;29;0;29;1
2018-08-25 10:30:00;NORTE;31;0;31;1
2018-08-25 11:00:00;NORTE;22;0;22;1
2018-08-25 11:30:00;NORTE;29;0;29;1
2018-08-25 12:00:00;NORTE;30;0;30;1
2018-08-25 12:30:00;CONFLICTIVA;21;7;28;2
2018-08-25 13:00:00;SUR;0;31;31;1
2018-08-25 13:30:00;SUR;0;31;31;1
2018-08-25 14:00:00;SUR;0;36;36;1
2018-08-25 14:30:00;SUR;0;30;30;1
2018-08-25 15:00:00;SUR;0;22;22;1
2018-08-25 15:30:00;SUR;0;20;20;1
2018-08-25 16:00:00;NORTE;20;0;20;1
2018-08-25 16:30:00;NORTE;24;0;24;1
2018-08-25 17:00:00;NORTE;13;0;13;1
2018-08-25 17:30:00;NORTE;33;0;33;1
2018-08-25 18:00:00;NORTE;28;0;28;1
2018-08-25 18:30:00;NORTE;25;1;26;1
2018-08-25 19:00:00;NORTE;25;0;25;1
2018-08-25 19:30:00;NORTE;26;0;26;1
2018-08-25 20:00:00;NORTE;22;0;22;1
2018-08-25 20:30:00;NORTE;19;0;19;1
2018-08-25 21:00:00;NORTE;11;0;11;1
2018-08-25 21:30:00;NORTE;14;0;14;1
2018-08-25 22:00:00;NORTE;17;0;17;1
2018-08-25 22:30:00;NORTE;11;0;11;1
2018-08-25 23:00:00;NORTE;2;0;2;1
2018-08-25 23:30:00;NORTE;2;0;2;1
2018-08-26 00:00:00;NORTE;3;0;3;1
2018-08-26 00:30:00;NORTE;3;0;3;1
2018-08-26 01:00:00;NORTE;2;0;2;1
2018-08-26 01:30:00;NORTE;2;0;2;1
2018-08-26 02:00:00;NORTE;1;0;1;1
2018-08-26 02:30:00;NORTE;3;0;3;1
2018-08-26 03:00:00;NORTE;3;0;3;1
2018-08-26 03:30:00;NORTE;1;0;1;1
2018-08-26 04:00:00;NORTE;13;0;13;1
2018-08-26 04:30:00;NORTE;10;0;10;1
2018-08-26 05:00:00;NORTE;17;0;17;1
2018-08-26 05:30:00;NORTE;28;0;28;1
2018-08-26 06:00:00;NORTE;18;0;18;1
2018-08-26 06:30:00;NORTE;22;0;22;1
2018-08-26 07:00:00;NORTE;33;0;33;1
2018-08-26 07:30:00;NORTE;24;0;24;1
2018-08-26 08:00:00;NORTE;37;0;37;1
2018-08-26 08:30:00;NORTE;28;0;28;1
2018-08-26 09:00:00;NORTE;28;0;28;1
2018-08-26 09:30:00;NORTE;28;0;28;1
2018-08-26 10:00:00;NORTE;29;0;29;1
2018-08-26 10:30:00;NORTE;33;0;33;1
2018-08-26 11:00:00;NORTE;26;0;26;1
2018-08-26 11:30:00;NORTE;23;0;23;1
2018-08-26 12:00:00;NORTE;29;0;29;1
2018-08-26 12:30:00;NORTE;36;0;36;1
2018-08-26 13:00:00;NORTE;31;0;31;1
2018-08-26 13:30:00;NORTE;34;0;34;1
2018-08-26 14:00:00;NORTE;39;0;39;1
2018-08-26 14:30:00;NORTE;39;0;39;1
2018-08-26 15:00:00;NORTE;22;0;22;1
2018-08-26 15:30:00;NORTE;23;0;23;1
2018-08-26 16:00:00;NORTE;16;0;16;1
2018-08-26 16:30:00;NORTE;22;0;22;1
2018-08-26 17:00:00;NORTE;26;0;26;1
2018-08-26 17:30:00;NORTE;24;0;24;1
2018-08-26 18:00:00;NORTE;34;0;34;1
2018-08-26 18:30:00;NORTE;29;0;29;1
2018-08-26 19:00:00;NORTE;31;0;31;1
2018-08-26 19:30:00;NORTE;28;0;28;1
2018-08-26 20:00:00;NORTE;33;0;33;1
2018-08-26 20:30:00;NORTE;24;0;24;1
2018-08-26 21:00:00;NORTE;14;0;14;1
2018-08-26 21:30:00;NORTE;18;0;18;1
2018-08-26 22:00:00;NORTE;14;0;14;1
2018-08-26 22:30:00;NORTE;8;0;8;1
2018-08-26 23:00:00;NORTE;6;0;6;1
2018-08-26 23:30:00;NORTE;2;0;2;1
2018-08-27 00:00:00;NORTE;4;0;4;1
2018-08-27 00:30:00;NORTE;2;0;2;1
2018-08-27 01:30:00;NORTE;1;0;1;1
2018-08-27 02:00:00;NORTE;4;0;4;1
2018-08-27 02:30:00;NORTE;4;0;4;1
2018-08-27 03:00:00;NORTE;2;0;2;1
2018-08-27 03:30:00;NORTE;7;0;7;1
2018-08-27 04:00:00;NORTE;7;0;7;1
2018-08-27 04:30:00;NORTE;12;0;12;1
2018-08-27 05:00:00;NORTE;21;0;21;1
2018-08-27 05:30:00;NORTE;34;0;34;1
2018-08-27 06:00:00;NORTE;17;0;17;1
2018-08-27 06:30:00;NORTE;25;0;25;1
2018-08-27 07:00:00;NORTE;36;0;36;1
2018-08-27 07:30:00;NORTE;29;0;29;1
2018-08-27 08:00:00;NORTE;38;0;38;1
2018-08-27 08:30:00;NORTE;33;0;33;1
2018-08-27 09:00:00;NORTE;18;0;18;1
2018-08-27 09:30:00;NORTE;36;0;36;1
2018-08-27 10:00:00;NORTE;32;0;32;1
2018-08-27 10:30:00;NORTE;31;0;31;1
2018-08-27 11:00:00;NORTE;29;0;29;1
2018-08-27 11:30:00;NORTE;22;0;22;1
2018-08-27 12:00:00;NORTE;25;0;25;1
2018-08-27 12:30:00;NORTE;31;0;31;1
2018-08-27 13:00:00;NORTE;36;0;36;1
2018-08-27 13:30:00;CONFLICTIVA;4;24;28;2
2018-08-27 14:00:00;SUR;0;41;41;1
2018-08-27 14:30:00;SUR;0;28;28;1
2018-08-27 15:00:00;SUR;0;29;29;1
2018-08-27 15:30:00;SUR;0;16;16;1
2018-08-27 16:00:00;SUR;0;28;28;1
2018-08-27 16:30:00;SUR;0;28;28;1
2018-08-27 17:00:00;CONFLICTIVA;3;18;21;2
2018-08-27 17:30:00;NORTE;30;0;30;1
2018-08-27 18:00:00;NORTE;31;0;31;1
2018-08-27 18:30:00;NORTE;36;0;36;1
2018-08-27 19:00:00;NORTE;25;0;25;1
2018-08-27 19:30:00;NORTE;22;0;22;1
2018-08-27 20:00:00;NORTE;34;0;34;1
2018-08-27 20:30:00;NORTE;25;0;25;1
2018-08-27 21:00:00;NORTE;15;0;15;1
2018-08-27 21:30:00;NORTE;18;0;18;1
2018-08-27 22:00:00;NORTE;17;0;17;1
2018-08-27 22:30:00;NORTE;3;0;3;1
2018-08-27 23:00:00;NORTE;2;0;2;1
2018-08-28 00:00:00;NORTE;1;0;1;1
2018-08-28 00:30:00;NORTE;1;0;1;1
2018-08-28 01:00:00;NORTE;1;0;1;1
2018-08-28 02:00:00;NORTE;5;0;5;1
2018-08-28 02:30:00;NORTE;2;0;2;1
2018-08-28 03:00:00;NORTE;3;0;3;1
2018-08-28 03:30:00;NORTE;5;0;5;1
2018-08-28 04:00:00;NORTE;17;0;17;1
2018-08-28 04:30:00;NORTE;14;0;14;1
2018-08-28 05:00:00;NORTE;20;0;20;1
2018-08-28 05:30:00;NORTE;29;0;29;1
2018-08-28 06:00:00;NORTE;15;0;15;1
2018-08-28 06:30:00;NORTE;22;0;22;1
2018-08-28 07:00:00;NORTE;41;0;41;1
2018-08-28 07:30:00;NORTE;32;0;32;1
2018-08-28 08:00:00;NORTE;33;0;33;1
2018-08-28 08:30:00;NORTE;18;0;18;1
2018-08-28 09:00:00;SUR;0;28;28;1
2018-08-28 09:30:00;SUR;0;29;29;1
2018-08-28 10:00:00;SUR;0;32;32;1
2018-08-28 10:30:00;SUR;0;34;34;1
2018-08-28 11:00:00;SUR;0;26;26;1
2018-08-28 11:30:00;SUR;0;18;18;1
2018-08-28 12:00:00;SUR;0;20;20;1
2018-08-28 12:30:00;SUR;0;28;28;1
2018-08-28 13:00:00;SUR;0;13;13;1
2018-08-28 13:14:00;SUR;0;16;16;1
2018-08-28 13:30:00;SUR;0;30;30;1
2018-08-28 14:00:00;SUR;0;30;30;1
2018-08-28 14:30:00;SUR;0;32;32;1
2018-08-28 15:00:00;SUR;0;24;24;1
2018-08-28 15:30:00;SUR;0;28;28;1
2018-08-28 16:00:00;SUR;0;12;12;1
2018-08-28 16:30:00;SUR;0;26;26;1
2018-08-28 17:00:00;SUR;0;22;22;1
2018-08-28 17:30:00;SUR;0;21;21;1
2018-08-28 18:00:00;SUR;0;33;33;1
2018-08-28 18:30:00;SUR;0;29;29;1
2018-08-28 19:00:00;CONFLICTIVA;10;9;19;2
2018-08-28 19:30:00;NORTE;31;0;31;1
2018-08-28 20:00:00;NORTE;29;0;29;1
2018-08-28 20:30:00;NORTE;30;0;30;1
2018-08-28 21:00:00;NORTE;12;0;12;1
2018-08-28 21:30:00;NORTE;13;0;13;1
2018-08-28 22:00:00;NORTE;14;0;14;1
2018-08-28 22:30:00;NORTE;13;0;13;1
2018-08-28 23:00:00;NORTE;3;0;3;1
2018-08-28 23:30:00;NORTE;2;0;2;1
2018-08-29 00:30:00;NORTE;1;0;1;1
2018-08-29 01:00:00;NORTE;2;0;2;1
2018-08-29 01:30:00;NORTE;1;0;1;1
2018-08-29 02:00:00;NORTE;2;0;2;1
2018-08-29 02:30:00;NORTE;1;0;1;1
2018-08-29 03:00:00;NORTE;3;0;3;1
2018-08-29 03:30:00;NORTE;3;0;3;1
2018-08-29 04:00:00;NORTE;18;0;18;1
2018-08-29 04:30:00;NORTE;10;0;10;1
2018-08-29 05:00:00;NORTE;16;0;16;1
2018-08-29 05:30:00;NORTE;40;0;40;1
2018-08-29 06:00:00;NORTE;22;0;22;1
2018-08-29 06:30:00;NORTE;19;0;19;1
2018-08-29 07:00:00;NORTE;38;0;38;1
2018-08-29 07:30:00;NORTE;27;0;27;1
2018-08-29 08:00:00;NORTE;30;0;30;1
2018-08-29 08:30:00;NORTE;40;0;40;1
2018-08-29 09:00:00;NORTE;28;0;28;1
2018-08-29 09:30:00;NORTE;31;0;31;1
2018-08-29 10:00:00;NORTE;33;0;33;1
2018-08-29 10:30:00;NORTE;27;0;27;1
2018-08-29 11:00:00;NORTE;31;0;31;1
2018-08-29 11:30:00;NORTE;23;0;23;1
2018-08-29 12:00:00;NORTE;27;0;27;1
2018-08-29 12:30:00;NORTE;31;0;31;1
2018-08-29 13:00:00;NORTE;31;0;31;1
2018-08-29 13:30:00;NORTE;29;0;29;1
2018-08-29 14:00:00;NORTE;38;0;38;1
2018-08-29 14:30:00;NORTE;31;0;31;1
2018-08-29 15:00:00;NORTE;24;0;24;1
2018-08-29 15:30:00;NORTE;14;0;14;1
2018-08-29 16:00:00;NORTE;26;0;26;1
2018-08-29 16:30:00;NORTE;28;0;28;1
2018-08-29 17:00:00;NORTE;23;0;23;1
2018-08-29 17:30:00;NORTE;29;0;29;1
2018-08-29 18:00:00;NORTE;34;0;34;1
2018-08-29 18:30:00;NORTE;29;0;29;1
2018-08-29 19:00:00;NORTE;21;0;21;1
2018-08-29 19:30:00;NORTE;24;0;24;1
2018-08-29 20:00:00;NORTE;26;0;26;1
2018-08-29 20:30:00;NORTE;26;0;26;1
2018-08-29 21:00:00;NORTE;15;0;15;1
2018-08-29 21:30:00;NORTE;11;0;11;1
2018-08-29 22:00:00;NORTE;20;0;20;1
2018-08-29 22:30:00;NORTE;8;0;8;1
2018-08-29 23:00:00;NORTE;1;0;1;1
2018-08-29 23:30:00;NORTE;3;0;3;1
2018-08-30 00:00:00;NORTE;1;0;1;1
2018-08-30 00:30:00;NORTE;4;0;4;1
2018-08-30 01:00:00;NORTE;1;0;1;1
2018-08-30 02:00:00;NORTE;4;0;4;1
2018-08-30 02:30:00;NORTE;4;0;4;1
2018-08-30 03:00:00;NORTE;3;0;3;1
2018-08-30 03:30:00;NORTE;7;0;7;1
2018-08-30 04:00:00;NORTE;12;0;12;1
2018-08-30 04:30:00;NORTE;11;0;11;1
2018-08-30 05:00:00;NORTE;12;0;12;1
2018-08-30 05:30:00;NORTE;35;0;35;1
2018-08-30 06:00:00;NORTE;24;0;24;1
2018-08-30 06:30:00;NORTE;26;0;26;1
2018-08-30 07:00:00;NORTE;35;0;35;1
2018-08-30 07:30:00;NORTE;24;0;24;1
2018-08-30 08:00:00;NORTE;30;0;30;1
2018-08-30 08:30:00;NORTE;33;0;33;1
2018-08-30 09:00:00;NORTE;26;0;26;1
2018-08-30 09:30:00;NORTE;28;0;28;1
2018-08-30 10:00:00;NORTE;29;0;29;1
2018-08-30 10:30:00;NORTE;28;0;28;1
2018-08-30 11:00:00;NORTE;24;0;24;1
2018-08-30 11:30:00;NORTE;25;0;25;1
2018-08-30 12:00:00;NORTE;31;0;31;1
2018-08-30 12:30:00;NORTE;29;0;29;1
2018-08-30 13:00:00;NORTE;33;0;33;1
2018-08-30 13:30:00;NORTE;36;0;36;1
2018-08-30 14:00:00;NORTE;35;0;35;1
2018-08-30 14:30:00;NORTE;32;0;32;1
2018-08-30 15:00:00;NORTE;27;0;27;1
2018-08-30 15:30:00;NORTE;22;0;22;1
2018-08-30 16:00:00;NORTE;17;0;17;1
2018-08-30 16:30:00;NORTE;33;0;33;1
2018-08-30 17:00:00;NORTE;17;0;17;1
2018-08-30 17:30:00;NORTE;29;0;29;1
2018-08-30 18:00:00;NORTE;36;0;36;1
2018-08-30 18:30:00;NORTE;33;0;33;1
2018-08-30 19:00:00;NORTE;27;0;27;1
2018-08-30 19:30:00;NORTE;27;0;27;1
2018-08-30 20:00:00;NORTE;34;0;34;1
2018-08-30 20:30:00;NORTE;27;0;27;1
2018-08-30 21:00:00;NORTE;14;0;14;1
2018-08-30 21:30:00;NORTE;20;0;20;1
2018-08-30 22:00:00;NORTE;17;0;17;1
2018-08-30 22:30:00;NORTE;7;0;7;1
2018-08-30 23:00:00;NORTE;3;0;3;1
2018-08-31 00:00:00;NORTE;2;0;2;1
2018-08-31 00:30:00;NORTE;2;0;2;1
2018-08-31 01:00:00;NORTE;1;0;1;1
2018-08-31 02:00:00;NORTE;4;0;4;1
2018-08-31 03:00:00;NORTE;8;0;8;1
2018-08-31 03:30:00;NORTE;6;0;6;1
2018-08-31 04:00:00;NORTE;14;0;14;1
2018-08-31 04:30:00;NORTE;12;0;12;1
2018-08-31 05:00:00;NORTE;17;0;17;1
2018-08-31 05:30:00;NORTE;39;0;39;1
2018-08-31 06:00:00;NORTE;18;0;18;1
2018-08-31 06:30:00;NORTE;23;0;23;1
2018-08-31 07:00:00;NORTE;40;0;40;1
2018-08-31 07:30:00;NORTE;33;0;33;1
2018-08-31 08:00:00;NORTE;31;0;31;1
2018-08-31 08:30:00;NORTE;38;0;38;1
2018-08-31 09:00:00;NORTE;24;0;24;1
2018-08-31 09:30:00;NORTE;33;0;33;1
2018-08-31 10:00:00;NORTE;35;0;35;1
2018-08-31 10:30:00;NORTE;36;0;36;1
2018-08-31 11:00:00;NORTE;29;0;29;1
2018-08-31 11:30:00;NORTE;26;0;26;1
2018-08-31 12:00:00;NORTE;28;0;28;1
2018-08-31 12:30:00;NORTE;37;0;37;1
2018-08-31 13:00:00;NORTE;33;0;33;1
2018-08-31 13:30:00;NORTE;35;0;35;1
2018-08-31 14:00:00;NORTE;36;0;36;1
2018-08-31 14:30:00;NORTE;38;0;38;1
2018-08-31 15:00:00;NORTE;25;0;25;1
2018-08-31 15:30:00;NORTE;21;0;21;1
2018-08-31 16:00:00;NORTE;20;0;20;1
2018-08-31 16:30:00;NORTE;30;0;30;1
2018-08-31 17:00:00;NORTE;22;0;22;1
2018-08-31 17:30:00;NORTE;25;0;25;1
2018-08-31 18:00:00;NORTE;36;0;36;1
2018-08-31 18:30:00;NORTE;33;1;34;1
2018-08-31 19:00:00;NORTE;37;0;37;1
2018-08-31 19:30:00;NORTE;32;0;32;1
2018-08-31 20:00:00;NORTE;31;0;31;1
2018-08-31 20:30:00;NORTE;19;0;19;1
2018-08-31 21:00:00;NORTE;19;0;19;1
2018-08-31 21:30:00;NORTE;10;0;10;1
2018-08-31 22:00:00;NORTE;19;0;19;1
2018-08-31 22:30:00;NORTE;9;0;9;1
2018-08-31 23:30:00;NORTE;4;0;4;1
2018-09-01 00:00:00;NORTE;1;0;1;1
2018-09-01 00:30:00;NORTE;1;0;1;1
2018-09-01 01:00:00;NORTE;1;0;1;1
2018-09-01 01:30:00;NORTE;1;0;1;1
2018-09-01 02:00:00;NORTE;3;0;3;1
2018-09-01 02:30:00;NORTE;2;0;2;1
2018-09-01 03:00:00;NORTE;2;0;2;1
2018-09-01 03:30:00;NORTE;1;0;1;1
2018-09-01 04:00:00;NORTE;12;0;12;1
2018-09-01 04:30:00;NORTE;15;0;15;1
2018-09-01 05:00:00;NORTE;16;0;16;1
2018-09-01 05:30:00;NORTE;36;1;37;1
2018-09-01 06:00:00;NORTE;12;0;12;1
2018-09-01 06:30:00;NORTE;23;0;23;1
2018-09-01 07:00:00;NORTE;39;0;39;1
2018-09-01 07:30:00;NORTE;31;0;31;1
2018-09-01 08:00:00;NORTE;37;0;37;1
2018-09-01 08:30:00;NORTE;20;0;20;1
2018-09-01 09:00:00;NORTE;30;0;30;1
2018-09-01 09:30:00;NORTE;22;0;22;1
2018-09-01 10:00:00;NORTE;30;0;30;1
2018-09-01 10:30:00;NORTE;36;0;36;1
2018-09-01 11:00:00;NORTE;25;0;25;1
2018-09-01 11:30:00;NORTE;23;0;23;1
2018-09-01 12:00:00;NORTE;26;0;26;1
2018-09-01 12:30:00;NORTE;32;0;32;1
2018-09-01 13:00:00;NORTE;30;0;30;1
2018-09-01 13:30:00;NORTE;32;0;32;1
2018-09-01 14:00:00;NORTE;37;0;37;1
2018-09-01 14:30:00;NORTE;28;0;28;1
2018-09-01 15:00:00;NORTE;26;0;26;1
2018-09-01 15:30:00;NORTE;22;0;22;1
2018-09-01 16:00:00;NORTE;15;0;15;1
2018-09-01 16:30:00;NORTE;25;0;25;1
2018-09-01 17:00:00;NORTE;19;0;19;1
2018-09-01 17:30:00;NORTE;27;0;27;1
2018-09-01 18:00:00;NORTE;29;0;29;1
2018-09-01 18:30:00;NORTE;24;0;24;1
2018-09-01 19:00:00;NORTE;24;0;24;1
2018-09-01 19:30:00;NORTE;27;0;27;1
2018-09-01 20:00:00;NORTE;23;0;23;1
2018-09-01 20:30:00;NORTE;15;0;15;1
2018-09-01 21:00:00;NORTE;17;0;17;1
2018-09-01 21:30:00;NORTE;13;0;13;1
2018-09-01 22:00:00;NORTE;16;0;16;1
2018-09-01 22:30:00;NORTE;17;0;17;1
2018-09-01 23:00:00;NORTE;2;0;2;1
2018-09-01 23:30:00;NORTE;1;0;1;1
2018-09-02 00:00:00;NORTE;3;0;3;1
2018-09-02 00:30:00;NORTE;2;0;2;1
2018-09-02 01:00:00;NORTE;1;0;1;1
2018-09-02 01:30:00;NORTE;1;0;1;1
2018-09-02 02:00:00;NORTE;1;0;1;1
2018-09-02 02:30:00;NORTE;3;0;3;1
2018-09-02 03:00:00;NORTE;2;0;2;1
2018-09-02 04:00:00;NORTE;11;0;11;1
2018-09-02 04:30:00;NORTE;13;0;13;1
2018-09-02 05:00:00;NORTE;19;0;19;1
2018-09-02 05:30:00;NORTE;25;0;25;1
2018-09-02 06:00:00;NORTE;19;0;19;1
2018-09-02 06:30:00;NORTE;21;0;21;1
2018-09-02 07:00:00;NORTE;34;0;34;1
2018-09-02 07:30:00;NORTE;31;0;31;1
2018-09-02 08:00:00;NORTE;27;0;27;1
2018-09-02 08:30:00;NORTE;34;0;34;1
2018-09-02 09:00:00;NORTE;19;0;19;1
2018-09-02 09:30:00;NORTE;36;0;36;1
2018-09-02 10:00:00;NORTE;30;0;30;1
2018-09-02 10:30:00;NORTE;25;0;25;1
2018-09-02 11:00:00;NORTE;26;0;26;1
2018-09-02 11:30:00;NORTE;28;0;28;1
2018-09-02 12:00:00;NORTE;31;0;31;1
2018-09-02 12:30:00;NORTE;34;0;34;1
2018-09-02 13:00:00;NORTE;34;0;34;1
2018-09-02 13:30:00;NORTE;26;0;26;1
2018-09-02 14:00:00;NORTE;40;0;40;1
2018-09-02 14:30:00;NORTE;30;0;30;1
2018-09-02 15:00:00;NORTE;23;0;23;1
2018-09-02 15:30:00;NORTE;17;0;17;1
2018-09-02 16:00:00;NORTE;24;0;24;1
2018-09-02 16:30:00;NORTE;29;0;29;1
2018-09-02 17:00:00;NORTE;13;0;13;1
2018-09-02 17:30:00;NORTE;23;0;23;1
2018-09-02 18:00:00;NORTE;34;0;34;1
2018-09-02 18:30:00;NORTE;28;0;28;1
2018-09-02 19:00:00;NORTE;30;0;30;1
2018-09-02 19:30:00;NORTE;24;0;24;1
2018-09-02 20:00:00;NORTE;34;0;34;1
2018-09-02 20:30:00;NORTE;29;0;29;1
2018-09-02 21:00:00;NORTE;21;0;21;1
2018-09-02 21:30:00;NORTE;15;0;15;1
2018-09-02 21:54:00;NORTE;2;0;2;1
2018-09-02 22:00:00;NORTE;2;0;2;1
2018-09-02 22:07:00;NORTE;11;0;11;1
2018-09-02 22:30:00;NORTE;4;0;4;1
2018-09-02 22:41:00;NORTE;4;0;4;1
2018-09-02 23:00:00;NORTE;11;0;11;1
2018-09-02 23:30:00;NORTE;2;0;2;1
2018-09-03 00:00:00;NORTE;6;0;6;1
2018-09-03 00:30:00;NORTE;1;0;1;1
2018-09-03 01:00:00;NORTE;2;0;2;1
2018-09-03 01:30:00;NORTE;3;0;3;1
2018-09-03 02:00:00;NORTE;2;0;2;1
2018-09-03 02:30:00;NORTE;6;0;6;1
2018-09-03 03:30:00;NORTE;4;0;4;1
2018-09-03 04:00:00;NORTE;10;0;10;1
2018-09-03 04:30:00;NORTE;16;0;16;1
2018-09-03 05:00:00;NORTE;13;0;13;1
2018-09-03 05:30:00;NORTE;45;0;45;1
2018-09-03 06:00:00;NORTE;20;0;20;1
2018-09-03 06:30:00;NORTE;26;0;26;1
2018-09-03 07:00:00;NORTE;37;0;37;1
2018-09-03 07:30:00;NORTE;23;0;23;1
2018-09-03 08:00:00;NORTE;3;0;3;1
2018-09-03 09:00:00;NORTE;22;0;22;1
2018-09-03 09:30:00;NORTE;37;0;37;1
2018-09-03 10:00:00;NORTE;32;0;32;1
2018-09-03 10:30:00;NORTE;29;0;29;1
2018-09-03 11:00:00;NORTE;32;0;32;1
2018-09-03 11:30:00;NORTE;27;0;27;1
2018-09-03 12:00:00;NORTE;29;0;29;1
2018-09-03 12:30:00;NORTE;31;0;31;1
2018-09-03 13:00:00;NORTE;25;2;27;1
2018-09-03 13:30:00;SUR;0;28;28;1
2018-09-03 14:00:00;SUR;0;46;46;1
2018-09-03 14:30:00;SUR;0;25;25;1
2018-09-03 15:00:00;SUR;0;30;30;1
2018-09-03 15:30:00;SUR;0;23;23;1
2018-09-03 16:00:00;SUR;0;18;18;1
2018-09-03 16:30:00;SUR;0;25;25;1
2018-09-03 17:00:00;SUR;0;25;25;1
2018-09-03 17:30:00;SUR;0;28;28;1
2018-09-03 18:00:00;SUR;0;1;1;1
2018-09-03 18:01:26;SUR;0;1;1;1
2018-09-03 18:02:19;SUR;0;1;1;1
2018-09-03 18:03:15;SUR;0;1;1;1
2018-09-03 18:03:56;SUR;0;1;1;1
2018-09-03 18:05:03;SUR;0;1;1;1
2018-09-03 18:06:20;SUR;0;1;1;1
2018-09-03 18:06:38;SUR;0;1;1;1
2018-09-03 18:07:56;SUR;0;1;1;1
2018-09-03 18:08:28;SUR;0;1;1;1
2018-09-03 18:09:14;SUR;0;1;1;1
2018-09-03 18:11:03;SUR;0;1;1;1
2018-09-03 18:12:22;SUR;0;1;1;1
2018-09-03 18:12:47;SUR;0;1;1;1
2018-09-03 18:14:00;SUR;0;1;1;1
2018-09-03 18:14:16;SUR;0;1;1;1
2018-09-03 18:15:38;SUR;0;1;1;1
2018-09-03 18:16:17;SUR;0;1;1;1
2018-09-03 18:17:08;SUR;0;1;1;1
2018-09-03 18:17:23;SUR;0;1;1;1
2018-09-03 18:17:52;SUR;0;1;1;1
2018-09-03 18:18:39;SUR;0;1;1;1
2018-09-03 18:19:44;SUR;0;1;1;1
2018-09-03 18:20:37;SUR;0;1;1;1
2018-09-03 18:22:20;SUR;0;1;1;1
2018-09-03 18:22:41;SUR;0;1;1;1
2018-09-03 18:22:45;SUR;0;1;1;1
2018-09-03 18:23:47;SUR;0;1;1;1
2018-09-03 18:25:35;SUR;0;2;2;1
2018-09-03 18:26:06;SUR;0;1;1;1
2018-09-03 18:27:07;SUR;0;1;1;1
2018-09-03 18:28:21;SUR;0;1;1;1
2018-09-03 18:30:00;SUR;0;37;37;1
2018-09-03 19:00:00;SUR;0;32;32;1
2018-09-03 19:30:00;SUR;0;27;27;1
2018-09-03 20:00:00;SUR;0;32;32;1
2018-09-03 20:30:00;CONFLICTIVA;5;17;22;2
2018-09-03 21:00:00;NORTE;16;0;16;1
2018-09-03 21:30:00;NORTE;12;0;12;1
2018-09-03 22:00:00;NORTE;17;0;17;1
2018-09-03 22:30:00;NORTE;9;0;9;1
2018-09-03 23:00:00;NORTE;7;0;7;1
2018-09-03 23:30:00;NORTE;1;0;1;1
2018-09-04 00:00:00;NORTE;1;0;1;1
2018-09-04 01:00:00;NORTE;1;0;1;1
2018-09-04 01:30:00;NORTE;2;0;2;1
2018-09-04 02:00:00;NORTE;3;0;3;1
2018-09-04 02:30:00;NORTE;5;0;5;1
2018-09-04 03:00:00;NORTE;2;0;2;1
2018-09-04 03:30:00;NORTE;6;0;6;1
2018-09-04 04:00:00;NORTE;12;0;12;1
2018-09-04 04:30:00;NORTE;17;0;17;1
2018-09-04 05:00:00;NORTE;17;0;17;1
2018-09-04 05:30:00;NORTE;45;0;45;1
2018-09-04 06:00:00;NORTE;19;0;19;1
2018-09-04 06:30:00;NORTE;26;0;26;1
2018-09-04 07:00:00;NORTE;35;0;35;1
2018-09-04 07:30:00;NORTE;31;0;31;1
2018-09-04 08:00:00;NORTE;37;0;37;1
2018-09-04 08:30:00;NORTE;38;0;38;1
2018-09-04 09:00:00;NORTE;27;0;27;1
2018-09-04 09:30:00;NORTE;32;0;32;1
2018-09-04 10:00:00;NORTE;38;0;38;1
2018-09-04 10:30:00;NORTE;35;0;35;1
2018-09-04 11:00:00;NORTE;34;0;34;1
2018-09-04 11:30:00;NORTE;27;0;27;1
2018-09-04 12:00:00;NORTE;30;0;30;1
2018-09-04 12:30:00;NORTE;31;0;31;1
2018-09-04 13:00:00;NORTE;36;0;36;1
2018-09-04 13:30:00;NORTE;35;0;35;1
2018-09-04 14:00:00;NORTE;34;0;34;1
2018-09-04 14:30:00;SUR;1;30;31;1
2018-09-04 15:00:00;SUR;0;27;27;1
2018-09-04 15:30:00;SUR;0;23;23;1
2018-09-04 16:00:00;SUR;0;24;24;1
2018-09-04 16:30:00;SUR;0;27;27;1
2018-09-04 17:00:00;SUR;0;20;20;1
2018-09-04 17:30:00;SUR;0;33;33;1
2018-09-04 18:00:00;SUR;0;38;38;1
2018-09-04 18:30:00;SUR;0;28;28;1
2018-09-04 19:00:00;SUR;0;33;33;1
2018-09-04 19:30:00;SUR;0;29;29;1
2018-09-04 20:00:00;CONFLICTIVA;32;4;36;2
2018-09-04 20:30:00;NORTE;30;0;30;1
2018-09-04 21:00:00;NORTE;12;0;12;1
2018-09-04 21:30:00;NORTE;22;0;22;1
2018-09-04 22:00:00;NORTE;18;0;18;1
2018-09-04 22:30:00;NORTE;10;0;10;1
2018-09-04 23:00:00;NORTE;1;0;1;1
2018-09-05 00:00:00;NORTE;2;0;2;1
2018-09-05 00:30:00;NORTE;1;0;1;1
2018-09-05 01:00:00;NORTE;1;0;1;1
2018-09-05 01:30:00;NORTE;2;0;2;1
2018-09-05 02:00:00;NORTE;3;0;3;1
2018-09-05 02:30:00;NORTE;3;0;3;1
2018-09-05 03:00:00;NORTE;2;0;2;1
2018-09-05 03:30:00;NORTE;6;0;6;1
2018-09-05 04:00:00;NORTE;16;0;16;1
2018-09-05 04:30:00;NORTE;15;0;15;1
2018-09-05 05:00:00;NORTE;12;0;12;1
2018-09-05 05:30:00;NORTE;42;0;42;1
2018-09-05 06:00:00;NORTE;28;0;28;1
2018-09-05 06:30:00;NORTE;23;0;23;1
2018-09-05 07:00:00;NORTE;36;0;36;1
2018-09-05 07:30:00;NORTE;30;0;30;1
2018-09-05 08:00:00;NORTE;34;0;34;1
2018-09-05 08:30:00;NORTE;34;0;34;1
2018-09-05 09:00:00;NORTE;31;1;32;1
2018-09-05 09:30:00;SUR;0;37;37;1
2018-09-05 10:00:00;SUR;0;38;38;1
2018-09-05 10:30:00;SUR;0;23;23;1
2018-09-05 11:00:00;SUR;0;27;27;1
2018-09-05 11:30:00;SUR;0;34;34;1
2018-09-05 12:00:00;SUR;0;26;26;1
2018-09-05 12:30:00;SUR;0;32;32;1
2018-09-05 13:00:00;SUR;0;30;30;1
2018-09-05 13:30:00;SUR;0;33;33;1
2018-09-05 14:00:00;SUR;0;29;29;1
2018-09-05 14:30:00;SUR;0;40;40;1
2018-09-05 15:00:00;SUR;0;32;32;1
2018-09-05 15:30:00;SUR;0;18;18;1
2018-09-05 16:00:00;SUR;0;20;20;1
2018-09-05 16:30:00;SUR;0;30;30;1
2018-09-05 17:00:00;SUR;0;25;25;1
2018-09-05 17:30:00;SUR;0;30;30;1
2018-09-05 18:00:00;SUR;0;42;42;1
2018-09-05 18:30:00;SUR;0;31;31;1
2018-09-05 19:00:00;SUR;0;25;25;1
2018-09-05 19:30:00;SUR;0;36;36;1
2018-09-05 20:00:00;SUR;0;33;33;1
2018-09-05 20:30:00;SUR;0;30;30;1
2018-09-05 21:00:00;CONFLICTIVA;9;7;16;2
2018-09-05 21:30:00;NORTE;20;0;20;1
2018-09-05 22:00:00;NORTE;14;0;14;1
2018-09-05 22:30:00;NORTE;8;0;8;1
2018-09-05 23:00:00;NORTE;2;0;2;1
2018-09-05 23:30:00;NORTE;2;0;2;1
2018-09-06 00:00:00;NORTE;1;0;1;1
2018-09-06 00:30:00;NORTE;1;0;1;1
2018-09-06 01:00:00;NORTE;1;0;1;1
2018-09-06 01:30:00;NORTE;1;0;1;1
2018-09-06 02:00:00;NORTE;2;0;2;1
2018-09-06 02:30:00;NORTE;4;0;4;1
2018-09-06 03:00:00;NORTE;2;0;2;1
2018-09-06 03:30:00;NORTE;9;0;9;1
2018-09-06 04:00:00;NORTE;10;0;10;1
2018-09-06 04:30:00;NORTE;15;0;15;1
2018-09-06 05:00:00;NORTE;19;0;19;1
2018-09-06 05:30:00;NORTE;43;0;43;1
2018-09-06 06:00:00;NORTE;25;0;25;1
2018-09-06 06:30:00;NORTE;22;0;22;1
2018-09-06 07:00:00;NORTE;39;0;39;1
2018-09-06 07:30:00;NORTE;30;0;30;1
2018-09-06 08:00:00;NORTE;36;0;36;1
2018-09-06 08:30:00;NORTE;35;0;35;1
2018-09-06 09:00:00;NORTE;24;0;24;1
2018-09-06 09:30:00;NORTE;35;0;35;1
2018-09-06 10:00:00;NORTE;42;0;42;1
2018-09-06 10:30:00;NORTE;36;0;36;1
2018-09-06 11:00:00;NORTE;34;0;34;1
2018-09-06 11:30:00;NORTE;28;0;28;1
2018-09-06 12:00:00;NORTE;28;0;28;1
2018-09-06 12:30:00;NORTE;36;0;36;1
2018-09-06 13:00:00;NORTE;39;0;39;1
2018-09-06 13:30:00;NORTE;35;0;35;1
2018-09-06 14:00:00;NORTE;30;0;30;1
2018-09-06 14:30:00;NORTE;32;0;32;1
2018-09-06 15:00:00;NORTE;21;0;21;1
2018-09-06 15:30:00;NORTE;26;0;26;1
2018-09-06 16:00:00;NORTE;24;0;24;1
2018-09-06 16:30:00;NORTE;36;0;36;1
2018-09-06 17:00:00;NORTE;22;0;22;1
2018-09-06 17:30:00;NORTE;29;0;29;1
2018-09-06 18:00:00;NORTE;41;1;42;1
2018-09-06 18:30:00;NORTE;34;0;34;1
2018-09-06 19:00:00;NORTE;38;0;38;1
2018-09-06 19:30:00;NORTE;28;0;28;1
2018-09-06 20:00:00;NORTE;41;0;41;1
2018-09-06 20:30:00;NORTE;28;0;28;1
2018-09-06 21:00:00;NORTE;31;0;31;1
2018-09-06 21:30:00;NORTE;14;0;14;1
2018-09-06 22:00:00;NORTE;19;0;19;1
2018-09-06 22:30:00;NORTE;11;0;11;1
2018-09-06 23:00:00;NORTE;5;0;5;1
2018-09-06 23:30:00;NORTE;2;0;2;1
2018-09-07 00:00:00;NORTE;1;0;1;1
2018-09-07 00:30:00;NORTE;3;0;3;1
2018-09-07 01:00:00;NORTE;1;0;1;1
2018-09-07 01:30:00;NORTE;1;0;1;1
2018-09-07 02:00:00;NORTE;4;0;4;1
2018-09-07 02:30:00;NORTE;3;0;3;1
2018-09-07 03:00:00;NORTE;2;0;2;1
2018-09-07 03:30:00;NORTE;9;0;9;1
2018-09-07 04:00:00;NORTE;11;0;11;1
2018-09-07 04:30:00;NORTE;15;0;15;1
2018-09-07 05:00:00;NORTE;17;0;17;1
2018-09-07 05:30:00;NORTE;42;0;42;1
2018-09-07 06:00:00;NORTE;24;0;24;1
2018-09-07 06:30:00;NORTE;29;0;29;1
2018-09-07 07:00:00;NORTE;38;0;38;1
2018-09-07 07:30:00;NORTE;27;0;27;1
2018-09-07 08:00:00;NORTE;38;0;38;1
2018-09-07 08:30:00;NORTE;9;0;9;1
2018-09-07 12:00:00;NORTE;15;0;15;1
2018-09-07 12:30:00;NORTE;32;0;32;1
2018-09-07 13:00:00;NORTE;43;0;43;1
2018-09-07 13:30:00;NORTE;34;0;34;1
2018-09-07 14:00:00;NORTE;43;0;43;1
2018-09-07 14:30:00;NORTE;31;0;31;1
2018-09-07 15:00:00;NORTE;25;0;25;1
2018-09-07 15:30:00;NORTE;26;0;26;1
2018-09-07 16:00:00;NORTE;26;0;26;1
2018-09-07 16:30:00;NORTE;30;0;30;1
2018-09-07 17:00:00;NORTE;25;0;25;1
2018-09-07 17:30:00;NORTE;10;0;10;1
2018-09-07 17:42:00;NORTE;19;0;19;1
2018-09-07 18:00:00;NORTE;39;0;39;1
2018-09-07 18:30:00;NORTE;29;0;29;1
2018-09-07 19:00:00;NORTE;30;0;30;1
2018-09-07 19:30:00;NORTE;30;0;30;1
2018-09-07 20:00:00;NORTE;32;0;32;1
2018-09-07 20:30:00;NORTE;32;0;32;1
2018-09-07 21:00:00;NORTE;17;0;17;1
2018-09-07 21:30:00;NORTE;15;0;15;1
2018-09-07 22:00:00;NORTE;20;0;20;1
2018-09-07 22:30:00;NORTE;15;0;15;1
2018-09-07 23:00:00;NORTE;4;0;4;1
2018-09-07 23:30:00;NORTE;2;0;2;1
2018-09-08 00:00:00;NORTE;2;0;2;1
2018-09-08 00:30:00;NORTE;1;0;1;1
2018-09-08 01:00:00;NORTE;2;0;2;1
2018-09-08 01:30:00;NORTE;1;0;1;1
2018-09-08 02:00:00;NORTE;5;0;5;1
2018-09-08 02:30:00;NORTE;2;0;2;1
2018-09-08 03:00:00;NORTE;2;0;2;1
2018-09-08 03:30:00;NORTE;5;0;5;1
2018-09-08 04:00:00;NORTE;11;0;11;1
2018-09-08 04:30:00;NORTE;16;0;16;1
2018-09-08 05:00:00;NORTE;18;0;18;1
2018-09-08 05:30:00;NORTE;34;0;34;1
2018-09-08 06:00:00;NORTE;15;0;15;1
2018-09-08 06:30:00;NORTE;24;0;24;1
2018-09-08 07:00:00;NORTE;40;0;40;1
2018-09-08 07:30:00;NORTE;32;0;32;1
2018-09-08 08:00:00;NORTE;32;0;32;1
2018-09-08 08:30:00;NORTE;33;0;33;1
2018-09-08 09:00:00;NORTE;21;0;21;1
2018-09-08 09:30:00;NORTE;27;0;27;1
2018-09-08 10:00:00;NORTE;31;0;31;1
2018-09-08 10:30:00;NORTE;33;0;33;1
2018-09-08 11:00:00;NORTE;31;0;31;1
2018-09-08 11:30:00;NORTE;22;0;22;1
2018-09-08 12:00:00;NORTE;30;0;30;1
2018-09-08 12:30:00;NORTE;28;0;28;1
2018-09-08 13:00:00;NORTE;25;0;25;1
2018-09-08 13:22:00;NORTE;9;0;9;1
2018-09-08 13:30:00;NORTE;31;0;31;1
2018-09-08 14:00:00;NORTE;32;0;32;1
2018-09-08 14:30:00;NORTE;34;0;34;1
2018-09-08 15:00:00;NORTE;29;0;29;1
2018-09-08 15:30:00;NORTE;23;0;23;1
2018-09-08 16:00:00;NORTE;18;0;18;1
2018-09-08 16:30:00;NORTE;28;0;28;1
2018-09-08 17:00:00;NORTE;20;0;20;1
2018-09-08 17:30:00;NORTE;20;0;20;1
2018-09-08 18:00:00;NORTE;36;0;36;1
2018-09-08 18:30:00;NORTE;24;0;24;1
2018-09-08 19:00:00;NORTE;21;0;21;1
2018-09-08 19:30:00;NORTE;21;0;21;1
2018-09-08 20:00:00;NORTE;21;0;21;1
2018-09-08 20:30:00;NORTE;16;0;16;1
2018-09-08 21:00:00;NORTE;13;0;13;1
2018-09-08 21:30:00;NORTE;11;0;11;1
2018-09-08 22:00:00;NORTE;18;0;18;1
2018-09-08 22:30:00;NORTE;7;0;7;1
2018-09-08 23:00:00;NORTE;3;0;3;1
2018-09-08 23:30:00;NORTE;3;0;3;1
2018-09-09 00:00:00;NORTE;1;0;1;1
2018-09-09 00:30:00;NORTE;2;0;2;1
2018-09-09 01:00:00;NORTE;2;0;2;1
2018-09-09 01:30:00;NORTE;3;0;3;1
2018-09-09 02:00:00;NORTE;2;0;2;1
2018-09-09 02:30:00;NORTE;3;0;3;1
2018-09-09 03:00:00;NORTE;2;0;2;1
2018-09-09 03:30:00;NORTE;5;0;5;1
2018-09-09 04:00:00;NORTE;9;0;9;1
2018-09-09 04:30:00;NORTE;12;0;12;1
2018-09-09 05:00:00;NORTE;18;0;18;1
2018-09-09 05:30:00;NORTE;28;0;28;1
2018-09-09 06:00:00;NORTE;20;0;20;1
2018-09-09 06:30:00;NORTE;19;0;19;1
2018-09-09 07:00:00;NORTE;28;0;28;1
2018-09-09 07:30:00;NORTE;37;0;37;1
2018-09-09 08:00:00;NORTE;32;0;32;1
2018-09-09 08:30:00;NORTE;35;0;35;1
2018-09-09 09:00:00;NORTE;28;0;28;1
2018-09-09 09:30:00;NORTE;33;0;33;1
2018-09-09 10:00:00;NORTE;35;0;35;1
2018-09-09 10:30:00;NORTE;34;0;34;1
2018-09-09 11:00:00;NORTE;34;0;34;1
2018-09-09 11:30:00;NORTE;26;0;26;1
2018-09-09 12:00:00;NORTE;29;0;29;1
2018-09-09 12:30:00;NORTE;38;0;38;1
2018-09-09 13:00:00;NORTE;37;0;37;1
2018-09-09 13:30:00;NORTE;35;0;35;1
2018-09-09 14:00:00;NORTE;42;0;42;1
2018-09-09 14:30:00;NORTE;34;0;34;1
2018-09-09 15:00:00;NORTE;34;0;34;1
2018-09-09 15:30:00;NORTE;27;0;27;1
2018-09-09 16:00:00;NORTE;15;0;15;1
2018-09-09 16:30:00;NORTE;29;0;29;1
2018-09-09 17:00:00;NORTE;23;0;23;1
2018-09-09 17:30:00;NORTE;22;0;22;1
2018-09-09 18:00:00;NORTE;42;0;42;1
2018-09-09 18:30:00;NORTE;33;0;33;1
2018-09-09 19:00:00;NORTE;32;0;32;1
2018-09-09 19:30:00;NORTE;25;0;25;1
2018-09-09 20:00:00;NORTE;38;0;38;1
2018-09-09 20:30:00;NORTE;24;0;24;1
2018-09-09 21:00:00;NORTE;22;0;22;1
2018-09-09 21:30:00;NORTE;22;0;22;1
2018-09-09 22:00:00;NORTE;15;0;15;1
2018-09-09 22:30:00;NORTE;14;0;14;1
2018-09-09 23:00:00;NORTE;3;0;3;1
2018-09-09 23:30:00;NORTE;3;0;3;1
2018-09-10 00:00:00;NORTE;4;0;4;1
2018-09-10 01:00:00;NORTE;2;0;2;1
2018-09-10 01:30:00;NORTE;4;0;4;1
2018-09-10 02:00:00;NORTE;1;0;1;1
2018-09-10 02:30:00;NORTE;2;0;2;1
2018-09-10 03:00:00;NORTE;3;0;3;1
2018-09-10 03:30:00;NORTE;6;0;6;1
2018-09-10 04:00:00;NORTE;9;0;9;1
2018-09-10 04:30:00;NORTE;12;0;12;1
2018-09-10 05:00:00;NORTE;17;0;17;1
2018-09-10 05:30:00;NORTE;46;0;46;1
2018-09-10 06:00:00;NORTE;25;0;25;1
2018-09-10 06:30:00;NORTE;26;0;26;1
2018-09-10 07:00:00;NORTE;42;0;42;1
2018-09-10 07:30:00;NORTE;28;0;28;1
2018-09-10 08:00:00;NORTE;44;0;44;1
2018-09-10 08:30:00;NORTE;34;0;34;1
2018-09-10 09:00:00;NORTE;26;0;26;1
2018-09-10 09:30:00;NORTE;31;0;31;1
2018-09-10 10:00:00;NORTE;38;0;38;1
2018-09-10 10:30:00;NORTE;34;0;34;1
2018-09-10 11:00:00;NORTE;35;0;35;1
2018-09-10 11:30:00;NORTE;30;0;30;1
2018-09-10 12:00:00;NORTE;27;0;27;1
2018-09-10 12:30:00;NORTE;37;0;37;1
2018-09-10 13:00:00;NORTE;43;0;43;1
2018-09-10 13:30:00;NORTE;44;0;44;1
2018-09-10 14:00:00;NORTE;35;0;35;1
2018-09-10 14:30:00;NORTE;37;0;37;1
2018-09-10 15:00:00;NORTE;30;0;30;1
2018-09-10 15:30:00;NORTE;19;0;19;1
2018-09-10 16:00:00;NORTE;25;0;25;1
2018-09-10 16:30:00;NORTE;36;0;36;1
2018-09-10 17:00:00;NORTE;24;0;24;1
2018-09-10 17:30:00;NORTE;31;0;31;1
2018-09-10 18:00:00;NORTE;32;0;32;1
2018-09-10 18:30:00;CONFLICTIVA;21;7;28;2
2018-09-10 19:00:00;SUR;0;33;33;1
2018-09-10 19:30:00;SUR;0;28;28;1
2018-09-10 20:00:00;SUR;0;35;35;1
2018-09-10 20:30:00;SUR;0;23;23;1
2018-09-10 21:00:00;SUR;1;14;15;1
2018-09-10 21:30:00;NORTE;15;0;15;1
2018-09-10 22:00:00;NORTE;13;0;13;1
2018-09-10 22:30:00;NORTE;8;0;8;1
2018-09-11 00:00:00;NORTE;2;0;2;1
2018-09-11 01:00:00;NORTE;1;0;1;1
2018-09-11 01:30:00;NORTE;1;0;1;1
2018-09-11 02:00:00;NORTE;2;0;2;1
2018-09-11 02:30:00;NORTE;3;0;3;1
2018-09-11 03:00:00;NORTE;3;0;3;1
2018-09-11 03:30:00;NORTE;8;0;8;1
2018-09-11 04:00:00;NORTE;15;0;15;1
2018-09-11 04:30:00;NORTE;14;0;14;1
2018-09-11 05:00:00;NORTE;18;0;18;1
2018-09-11 05:30:00;NORTE;41;0;41;1
2018-09-11 06:00:00;NORTE;22;0;22;1
2018-09-11 06:30:00;NORTE;26;0;26;1
2018-09-11 07:00:00;NORTE;40;0;40;1
2018-09-11 07:30:00;NORTE;31;0;31;1
2018-09-11 08:00:00;NORTE;32;0;32;1
2018-09-11 08:30:00;NORTE;36;0;36;1
2018-09-11 09:00:00;NORTE;25;0;25;1
2018-09-11 09:30:00;NORTE;32;0;32;1
2018-09-11 10:00:00;NORTE;36;0;36;1
2018-09-11 10:30:00;NORTE;41;0;41;1
2018-09-11 11:00:00;CONFLICTIVA;3;16;19;2
2018-09-11 11:30:00;SUR;0;27;27;1
2018-09-11 12:00:00;SUR;0;28;28;1
2018-09-11 12:30:00;SUR;0;33;33;1
2018-09-11 13:00:00;SUR;0;38;38;1
2018-09-11 13:30:00;SUR;0;34;34;1
2018-09-11 14:00:00;SUR;0;35;35;1
2018-09-11 14:30:00;SUR;0;29;29;1
2018-09-11 15:00:00;SUR;0;24;24;1
2018-09-11 15:30:00;SUR;0;20;20;1
2018-09-11 16:00:00;SUR;0;26;26;1
2018-09-11 16:30:00;SUR;0;23;23;1
2018-09-11 17:00:00;SUR;0;26;26;1
2018-09-11 17:30:00;SUR;0;37;37;1
2018-09-11 18:00:00;CONFLICTIVA;21;14;35;2
2018-09-11 18:30:00;NORTE;36;0;36;1
2018-09-11 19:00:00;NORTE;35;0;35;1
2018-09-11 19:30:00;NORTE;31;0;31;1
2018-09-11 20:00:00;NORTE;40;0;40;1
2018-09-11 20:30:00;NORTE;26;0;26;1
2018-09-11 21:00:00;NORTE;16;0;16;1
2018-09-11 21:30:00;NORTE;17;0;17;1
2018-09-11 22:00:00;NORTE;14;0;14;1
2018-09-11 22:30:00;NORTE;9;0;9;1
2018-09-11 23:00:00;NORTE;2;0;2;1
2018-09-11 23:30:00;NORTE;4;0;4;1
2018-09-12 00:00:00;NORTE;1;0;1;1
2018-09-12 01:00:00;SUR;0;1;1;1
2018-09-12 01:35:00;NORTE;1;0;1;1
2018-09-12 02:00:00;NORTE;1;0;1;1
2018-09-12 02:30:00;NORTE;5;0;5;1
2018-09-12 03:00:00;NORTE;2;0;2;1
2018-09-12 03:30:00;NORTE;6;0;6;1
2018-09-12 04:00:00;NORTE;16;0;16;1
2018-09-12 04:30:00;NORTE;16;0;16;1
2018-09-12 05:00:00;NORTE;15;0;15;1
2018-09-12 05:30:00;NORTE;42;0;42;1
2018-09-12 06:00:00;NORTE;32;0;32;1
2018-09-12 06:30:00;NORTE;31;0;31;1
2018-09-12 07:00:00;NORTE;33;0;33;1
2018-09-12 07:30:00;NORTE;34;0;34;1
2018-09-12 08:00:00;NORTE;37;0;37;1
2018-09-12 08:30:00;NORTE;41;0;41;1
2018-09-12 09:00:00;NORTE;29;0;29;1
2018-09-12 09:30:00;NORTE;33;0;33;1
2018-09-12 10:00:00;NORTE;33;0;33;1
2018-09-12 10:30:00;NORTE;31;0;31;1
2018-09-12 11:00:00;NORTE;28;0;28;1
2018-09-12 11:30:00;NORTE;25;0;25;1
2018-09-12 12:00:00;NORTE;33;0;33;1
2018-09-12 12:30:00;NORTE;31;0;31;1
2018-09-12 13:00:00;NORTE;34;0;34;1
2018-09-12 13:30:00;NORTE;42;0;42;1
2018-09-12 14:00:00;NORTE;32;0;32;1
2018-09-12 14:30:00;NORTE;28;0;28;1
2018-09-12 15:00:00;NORTE;28;0;28;1
2018-09-12 15:30:00;NORTE;23;0;23;1
2018-09-12 16:00:00;NORTE;21;0;21;1
2018-09-12 16:30:00;NORTE;30;0;30;1
2018-09-12 17:00:00;NORTE;21;0;21;1
2018-09-12 17:30:00;NORTE;31;0;31;1
2018-09-12 18:00:00;NORTE;41;0;41;1
2018-09-12 18:30:00;NORTE;34;0;34;1
2018-09-12 19:00:00;NORTE;35;0;35;1
2018-09-12 19:30:00;NORTE;34;0;34;1
2018-09-12 20:00:00;NORTE;35;1;36;1
2018-09-12 20:30:00;NORTE;31;0;31;1
2018-09-12 21:00:00;NORTE;14;0;14;1
2018-09-12 21:30:00;NORTE;13;0;13;1
2018-09-12 22:00:00;NORTE;10;0;10;1
2018-09-12 22:30:00;NORTE;5;0;5;1
2018-09-12 23:00:00;NORTE;3;0;3;1
2018-09-12 23:30:00;NORTE;1;0;1;1
2018-09-13 00:00:00;NORTE;1;0;1;1
2018-09-13 00:30:00;NORTE;3;0;3;1
2018-09-13 01:00:00;NORTE;1;0;1;1
2018-09-13 01:30:00;NORTE;1;0;1;1
2018-09-13 02:00:00;NORTE;3;0;3;1
2018-09-13 02:30:00;NORTE;2;0;2;1
2018-09-13 03:00:00;NORTE;3;0;3;1
2018-09-13 03:30:00;NORTE;6;0;6;1
2018-09-13 04:00:00;NORTE;12;0;12;1
2018-09-13 04:30:00;NORTE;13;0;13;1
2018-09-13 05:00:00;NORTE;23;0;23;1
2018-09-13 05:30:00;NORTE;40;0;40;1
2018-09-13 06:00:00;NORTE;31;0;31;1
2018-09-13 06:30:00;NORTE;24;0;24;1
2018-09-13 07:00:00;NORTE;39;0;39;1
2018-09-13 07:30:00;NORTE;26;0;26;1
2018-09-13 08:00:00;NORTE;37;0;37;1
2018-09-13 08:30:00;NORTE;36;0;36;1
2018-09-13 09:00:00;NORTE;30;0;30;1
2018-09-13 09:30:00;NORTE;31;0;31;1
2018-09-13 10:00:00;NORTE;32;0;32;1
2018-09-13 10:30:00;NORTE;34;0;34;1
2018-09-13 11:00:00;NORTE;30;0;30;1
2018-09-13 11:30:00;NORTE;24;0;24;1
2018-09-13 12:00:00;NORTE;28;0;28;1
2018-09-13 12:30:00;NORTE;36;0;36;1
2018-09-13 13:00:00;NORTE;35;0;35;1
2018-09-13 13:30:00;NORTE;34;0;34;1
2018-09-13 14:00:00;NORTE;36;0;36;1
2018-09-13 14:30:00;NORTE;37;0;37;1
2018-09-13 15:00:00;NORTE;29;0;29;1
2018-09-13 15:30:00;NORTE;21;0;21;1
2018-09-13 16:00:00;NORTE;25;0;25;1
2018-09-13 16:30:00;NORTE;31;0;31;1
2018-09-13 17:00:00;NORTE;23;0;23;1
2018-09-13 17:30:00;NORTE;29;0;29;1
2018-09-13 18:00:00;NORTE;36;0;36;1
2018-09-13 18:30:00;NORTE;37;0;37;1
2018-09-13 19:00:00;NORTE;32;0;32;1
2018-09-13 19:30:00;NORTE;32;1;33;1
2018-09-13 20:00:00;NORTE;35;0;35;1
2018-09-13 20:30:00;NORTE;36;0;36;1
2018-09-13 21:00:00;NORTE;17;0;17;1
2018-09-13 21:30:00;NORTE;16;0;16;1
2018-09-13 22:00:00;NORTE;16;0;16;1
2018-09-13 22:30:00;NORTE;8;0;8;1
2018-09-13 23:00:00;NORTE;2;0;2;1
2018-09-13 23:30:00;NORTE;1;0;1;1
2018-09-14 00:00:00;NORTE;1;0;1;1
2018-09-14 01:00:00;NORTE;1;0;1;1
2018-09-14 01:30:00;NORTE;2;0;2;1
2018-09-14 02:00:00;NORTE;2;0;2;1
2018-09-14 02:30:00;NORTE;5;0;5;1
2018-09-14 03:00:00;NORTE;1;0;1;1
2018-09-14 03:30:00;NORTE;10;0;10;1
2018-09-14 04:00:00;NORTE;11;0;11;1
2018-09-14 04:30:00;NORTE;11;0;11;1
2018-09-14 05:00:00;NORTE;19;0;19;1
2018-09-14 05:30:00;NORTE;41;0;41;1
2018-09-14 06:00:00;NORTE;28;0;28;1
2018-09-14 06:30:00;NORTE;31;0;31;1
2018-09-14 07:00:00;NORTE;40;0;40;1
2018-09-14 07:30:00;NORTE;31;0;31;1
2018-09-14 08:00:00;NORTE;38;0;38;1
2018-09-14 08:30:00;NORTE;37;0;37;1
2018-09-14 09:00:00;NORTE;31;0;31;1
2018-09-14 09:30:00;NORTE;35;0;35;1
2018-09-14 10:00:00;NORTE;40;0;40;1
2018-09-14 10:30:00;NORTE;35;0;35;1
2018-09-14 11:00:00;NORTE;36;0;36;1
2018-09-14 11:30:00;NORTE;30;0;30;1
2018-09-14 12:00:00;NORTE;29;0;29;1
2018-09-14 12:30:00;NORTE;33;0;33;1
2018-09-14 13:00:00;NORTE;40;0;40;1
2018-09-14 13:30:00;NORTE;33;0;33;1
2018-09-14 14:00:00;NORTE;34;0;34;1
2018-09-14 14:30:00;NORTE;31;0;31;1
2018-09-14 15:00:00;NORTE;31;0;31;1
2018-09-14 15:30:00;NORTE;22;1;23;1
2018-09-14 16:00:00;NORTE;21;0;21;1
2018-09-14 16:30:00;NORTE;32;0;32;1
2018-09-14 17:00:00;NORTE;27;0;27;1
2018-09-14 17:30:00;NORTE;27;0;27;1
2018-09-14 18:00:00;NORTE;38;0;38;1
2018-09-14 18:30:00;NORTE;41;0;41;1
2018-09-14 19:00:00;NORTE;30;0;30;1
2018-09-14 19:30:00;NORTE;26;0;26;1
2018-09-14 20:00:00;NORTE;37;0;37;1
2018-09-14 20:30:00;NORTE;28;0;28;1
2018-09-14 21:00:00;NORTE;18;0;18;1
2018-09-14 21:30:00;NORTE;16;0;16;1
2018-09-14 22:00:00;NORTE;16;0;16;1
2018-09-14 22:30:00;NORTE;9;0;9;1
2018-09-14 23:00:00;NORTE;2;0;2;1
2018-09-14 23:30:00;NORTE;1;0;1;1
2018-09-15 00:00:00;NORTE;1;0;1;1
2018-09-15 00:30:00;NORTE;2;0;2;1
2018-09-15 01:00:00;NORTE;1;0;1;1
2018-09-15 01:30:00;NORTE;2;0;2;1
2018-09-15 02:00:00;NORTE;5;0;5;1
2018-09-15 03:00:00;NORTE;1;0;1;1
2018-09-15 03:30:00;NORTE;4;0;4;1
2018-09-15 04:00:00;NORTE;14;0;14;1
2018-09-15 04:30:00;NORTE;13;0;13;1
2018-09-15 05:00:00;NORTE;16;0;16;1
2018-09-15 05:30:00;NORTE;36;0;36;1
2018-09-15 06:00:00;NORTE;23;0;23;1
2018-09-15 06:30:00;NORTE;25;0;25;1
2018-09-15 07:00:00;NORTE;34;0;34;1
2018-09-15 07:30:00;NORTE;29;1;30;1
2018-09-15 08:00:00;NORTE;36;0;36;1
2018-09-15 08:30:00;NORTE;37;0;37;1
2018-09-15 09:00:00;NORTE;18;0;18;1
2018-09-15 09:30:00;NORTE;33;0;33;1
2018-09-15 10:00:00;NORTE;26;0;26;1
2018-09-15 10:30:00;NORTE;33;0;33;1
2018-09-15 11:00:00;NORTE;31;0;31;1
2018-09-15 11:30:00;NORTE;25;0;25;1
2018-09-15 12:00:00;NORTE;28;0;28;1
2018-09-15 12:30:00;NORTE;28;0;28;1
2018-09-15 13:00:00;NORTE;35;0;35;1
2018-09-15 13:30:00;NORTE;29;0;29;1
2018-09-15 14:00:00;NORTE;26;0;26;1
2018-09-15 14:30:00;NORTE;27;0;27;1
2018-09-15 15:00:00;NORTE;32;0;32;1
2018-09-15 15:30:00;NORTE;20;0;20;1
2018-09-15 16:00:00;NORTE;30;0;30;1
2018-09-15 16:30:00;NORTE;26;0;26;1
2018-09-15 17:00:00;NORTE;19;0;19;1
2018-09-15 17:30:00;NORTE;26;0;26;1
2018-09-15 18:00:00;NORTE;29;0;29;1
2018-09-15 18:30:00;NORTE;25;0;25;1
2018-09-15 19:00:00;SUR;1;19;20;1
2018-09-15 19:30:00;SUR;0;27;27;1
2018-09-15 20:00:00;SUR;0;24;24;1
2018-09-15 20:30:00;SUR;0;15;15;1
2018-09-15 21:00:00;SUR;0;8;8;1
2018-09-15 21:30:00;SUR;0;18;18;1
2018-09-15 22:00:00;SUR;0;17;17;1
2018-09-15 22:30:00;CONFLICTIVA;2;7;9;2
2018-09-15 23:00:00;NORTE;5;0;5;1
2018-09-15 23:30:00;NORTE;1;0;1;1
2018-09-16 00:30:00;NORTE;3;0;3;1
2018-09-16 01:00:00;NORTE;1;0;1;1
2018-09-16 01:30:00;NORTE;2;0;2;1
2018-09-16 02:30:00;NORTE;4;0;4;1
2018-09-16 03:00:00;NORTE;2;0;2;1
2018-09-16 03:30:00;NORTE;3;0;3;1
2018-09-16 04:00:00;NORTE;9;0;9;1
2018-09-16 04:30:00;NORTE;13;0;13;1
2018-09-16 05:00:00;NORTE;13;0;13;1
2018-09-16 05:30:00;NORTE;30;0;30;1
2018-09-16 06:00:00;NORTE;24;0;24;1
2018-09-16 06:30:00;NORTE;21;0;21;1
2018-09-16 07:00:00;NORTE;35;0;35;1
2018-09-16 07:30:00;NORTE;29;1;30;1
2018-09-16 08:00:00;NORTE;39;0;39;1
2018-09-16 08:30:00;NORTE;27;0;27;1
2018-09-16 09:00:00;NORTE;27;0;27;1
2018-09-16 09:30:00;NORTE;36;0;36;1
2018-09-16 10:00:00;NORTE;33;0;33;1
2018-09-16 10:30:00;NORTE;36;0;36;1
2018-09-16 11:00:00;NORTE;35;0;35;1
2018-09-16 11:30:00;NORTE;31;0;31;1
2018-09-16 12:00:00;NORTE;21;0;21;1
2018-09-16 12:30:00;NORTE;27;0;27;1
2018-09-16 13:00:00;NORTE;38;0;38;1
2018-09-16 13:30:00;NORTE;42;0;42;1
2018-09-16 14:00:00;NORTE;34;0;34;1
2018-09-16 14:30:00;NORTE;36;0;36;1
2018-09-16 15:00:00;NORTE;29;0;29;1
2018-09-16 15:30:00;NORTE;21;0;21;1
2018-09-16 16:00:00;NORTE;23;0;23;1
2018-09-16 16:30:00;NORTE;33;0;33;1
2018-09-16 17:00:00;NORTE;25;0;25;1
2018-09-16 17:30:00;NORTE;24;0;24;1
2018-09-16 18:00:00;NORTE;38;0;38;1
2018-09-16 18:30:00;NORTE;36;0;36;1
2018-09-16 19:00:00;NORTE;37;0;37;1
2018-09-16 19:30:00;NORTE;26;0;26;1
2018-09-16 20:00:00;NORTE;40;0;40;1
2018-09-16 20:30:00;NORTE;26;0;26;1
2018-09-16 21:00:00;NORTE;20;0;20;1
2018-09-16 21:30:00;NORTE;16;0;16;1
2018-09-16 22:00:00;NORTE;15;0;15;1
2018-09-16 22:30:00;NORTE;13;0;13;1
2018-09-16 23:30:00;NORTE;2;0;2;1
2018-09-17 00:00:00;NORTE;3;0;3;1
2018-09-17 00:30:00;NORTE;1;0;1;1
2018-09-17 01:00:00;NORTE;1;0;1;1
2018-09-17 01:30:00;NORTE;1;0;1;1
2018-09-17 02:00:00;NORTE;4;0;4;1
2018-09-17 02:30:00;NORTE;4;0;4;1
2018-09-17 03:00:00;NORTE;3;0;3;1
2018-09-17 03:30:00;NORTE;1;0;1;1
2018-09-17 04:00:00;NORTE;10;0;10;1
2018-09-17 04:30:00;NORTE;11;0;11;1
2018-09-17 05:00:00;NORTE;21;0;21;1
2018-09-17 05:30:00;NORTE;53;0;53;1
2018-09-17 06:00:00;NORTE;23;0;23;1
2018-09-17 06:30:00;NORTE;28;0;28;1
2018-09-17 07:00:00;NORTE;33;0;33;1
2018-09-17 07:30:00;NORTE;31;1;32;1
2018-09-17 08:00:00;NORTE;38;0;38;1
2018-09-17 08:30:00;NORTE;40;0;40;1
2018-09-17 09:00:00;NORTE;24;0;24;1
2018-09-17 09:30:00;NORTE;37;0;37;1
2018-09-17 10:00:00;NORTE;40;0;40;1
2018-09-17 10:30:00;NORTE;29;0;29;1
2018-09-17 11:00:00;SUR;0;29;29;1
2018-09-17 11:30:00;SUR;0;22;22;1
2018-09-17 12:00:00;SUR;0;23;23;1
2018-09-17 12:30:00;SUR;0;30;30;1
2018-09-17 13:00:00;SUR;0;36;36;1
2018-09-17 13:30:00;SUR;0;30;30;1
2018-09-17 14:00:00;SUR;0;37;37;1
2018-09-17 14:30:00;SUR;0;31;31;1
2018-09-17 15:00:00;SUR;0;21;21;1
2018-09-17 15:30:00;SUR;0;20;20;1
2018-09-17 16:00:00;SUR;0;28;28;1
2018-09-17 16:30:00;SUR;0;24;24;1
2018-09-17 17:00:00;SUR;0;25;25;1
2018-09-17 17:30:00;SUR;0;19;19;1
2018-09-17 17:49:00;SUR;0;9;9;1
2018-09-17 18:00:00;SUR;0;34;34;1
2018-09-17 18:30:00;SUR;0;29;29;1
2018-09-17 19:00:00;SUR;0;25;25;1
2018-09-17 19:30:00;SUR;0;31;31;1
2018-09-17 20:00:00;SUR;0;25;25;1
2018-09-17 20:30:00;SUR;0;21;21;1
2018-09-17 21:00:00;SUR;0;16;16;1
2018-09-17 21:30:00;SUR;0;18;18;1
2018-09-17 22:00:00;SUR;0;15;15;1
2018-09-17 22:30:00;SUR;0;4;4;1
2018-09-17 22:39:00;SUR;0;8;8;1
2018-09-17 23:00:00;SUR;0;11;11;1
2018-09-17 23:30:00;SUR;0;10;10;1
2018-09-18 00:00:00;SUR;0;2;2;1
2018-09-18 01:00:00;NORTE;2;0;2;1
2018-09-18 02:00:00;NORTE;4;0;4;1
2018-09-18 02:30:00;NORTE;4;0;4;1
2018-09-18 03:00:00;NORTE;3;0;3;1
2018-09-18 03:30:00;NORTE;8;0;8;1
2018-09-18 04:00:00;NORTE;10;0;10;1
2018-09-18 04:30:00;NORTE;15;0;15;1
2018-09-18 05:00:00;NORTE;21;0;21;1
2018-09-18 05:30:00;NORTE;40;0;40;1
2018-09-18 06:00:00;NORTE;27;0;27;1
2018-09-18 06:30:00;NORTE;26;0;26;1
2018-09-18 07:00:00;NORTE;36;0;36;1
2018-09-18 07:30:00;NORTE;29;0;29;1
2018-09-18 08:00:00;NORTE;34;0;34;1
2018-09-18 08:30:00;NORTE;41;0;41;1
2018-09-18 09:00:00;NORTE;26;0;26;1
2018-09-18 09:30:00;NORTE;32;0;32;1
2018-09-18 10:00:00;NORTE;39;0;39;1
2018-09-18 10:30:00;NORTE;32;0;32;1
2018-09-18 11:00:00;NORTE;33;0;33;1
2018-09-18 11:30:00;NORTE;25;0;25;1
2018-09-18 12:00:00;NORTE;27;0;27;1
2018-09-18 12:30:00;NORTE;36;0;36;1
2018-09-18 13:00:00;NORTE;34;0;34;1
2018-09-18 13:30:00;NORTE;25;0;25;1
2018-09-18 14:00:00;NORTE;36;0;36;1
2018-09-18 14:30:00;NORTE;31;0;31;1
2018-09-18 15:00:00;NORTE;34;0;34;1
2018-09-18 15:30:00;NORTE;29;0;29;1
2018-09-18 16:00:00;NORTE;21;0;21;1
2018-09-18 16:30:00;NORTE;30;0;30;1
2018-09-18 17:00:00;NORTE;28;0;28;1
2018-09-18 17:30:00;NORTE;31;0;31;1
2018-09-18 18:00:00;NORTE;39;0;39;1
2018-09-18 18:30:00;NORTE;33;0;33;1
2018-09-18 19:00:00;NORTE;36;0;36;1
2018-09-18 19:30:00;NORTE;31;0;31;1
2018-09-18 20:00:00;NORTE;36;0;36;1
2018-09-18 20:30:00;NORTE;28;0;28;1
2018-09-18 21:00:00;NORTE;16;0;16;1
2018-09-18 21:30:00;NORTE;15;0;15;1
2018-09-18 22:00:00;NORTE;14;0;14;1
2018-09-18 22:30:00;NORTE;5;0;5;1
2018-09-18 23:30:00;NORTE;1;0;1;1
2018-09-19 00:00:00;NORTE;1;0;1;1
2018-09-19 01:00:00;NORTE;3;0;3;1
2018-09-19 01:30:00;NORTE;1;0;1;1
2018-09-19 02:00:00;NORTE;3;0;3;1
2018-09-19 02:30:00;NORTE;4;0;4;1
2018-09-19 03:00:00;NORTE;1;0;1;1
2018-09-19 03:30:00;NORTE;9;0;9;1
2018-09-19 04:00:00;NORTE;10;0;10;1
2018-09-19 04:30:00;NORTE;11;0;11;1
2018-09-19 05:00:00;NORTE;18;0;18;1
2018-09-19 05:30:00;NORTE;42;0;42;1
2018-09-19 06:00:00;NORTE;23;0;23;1
2018-09-19 06:30:00;NORTE;23;0;23;1
2018-09-19 07:00:00;NORTE;40;0;40;1
2018-09-19 07:30:00;NORTE;32;0;32;1
2018-09-19 08:00:00;NORTE;38;0;38;1
2018-09-19 08:30:00;NORTE;38;0;38;1
2018-09-19 09:00:00;NORTE;25;0;25;1
2018-09-19 09:30:00;NORTE;30;0;30;1
2018-09-19 10:00:00;NORTE;43;0;43;1
2018-09-19 10:30:00;NORTE;38;0;38;1
2018-09-19 11:00:00;NORTE;35;0;35;1
2018-09-19 11:30:00;NORTE;26;0;26;1
2018-09-19 12:02:07;NORTE;1;0;1;1
2018-09-19 12:02:51;NORTE;1;0;1;1
2018-09-19 12:04:03;NORTE;1;0;1;1
2018-09-19 12:05:26;NORTE;1;0;1;1
2018-09-19 12:06:14;NORTE;1;0;1;1
2018-09-19 12:07:42;NORTE;1;0;1;1
2018-09-19 12:07:47;NORTE;1;0;1;1
2018-09-19 12:08:25;NORTE;1;0;1;1
2018-09-19 12:09:18;NORTE;1;0;1;1
2018-09-19 12:10:17;NORTE;1;0;1;1
2018-09-19 12:12:15;NORTE;1;0;1;1
2018-09-19 12:13:00;NORTE;1;0;1;1
2018-09-19 12:13:32;NORTE;1;0;1;1
2018-09-19 12:14:43;NORTE;1;0;1;1
2018-09-19 12:15:50;NORTE;1;0;1;1
2018-09-19 12:16:40;NORTE;1;0;1;1
2018-09-19 12:17:30;NORTE;1;0;1;1
2018-09-19 12:19:41;NORTE;1;0;1;1
2018-09-19 12:21:16;NORTE;1;0;1;1
2018-09-19 12:22:17;NORTE;1;0;1;1
2018-09-19 12:22:41;NORTE;1;0;1;1
2018-09-19 12:23:16;NORTE;1;0;1;1
2018-09-19 12:24:49;NORTE;1;0;1;1
2018-09-19 12:25:28;NORTE;1;0;1;1
2018-09-19 12:26:42;NORTE;1;0;1;1
2018-09-19 12:27:17;NORTE;1;0;1;1
2018-09-19 12:28:57;NORTE;1;0;1;1
2018-09-19 12:29:21;NORTE;1;0;1;1
2018-09-19 12:29:54;NORTE;1;0;1;1
2018-09-19 12:31:05;NORTE;1;0;1;1
2018-09-19 12:31:37;NORTE;1;0;1;1
2018-09-19 12:32:24;NORTE;1;0;1;1
2018-09-19 12:32:42;NORTE;1;0;1;1
2018-09-19 12:33:43;NORTE;1;0;1;1
2018-09-19 12:34:13;NORTE;1;0;1;1
2018-09-19 12:35:09;NORTE;1;0;1;1
2018-09-19 12:35:29;NORTE;1;0;1;1
2018-09-19 12:36:33;NORTE;1;0;1;1
2018-09-19 12:37:34;NORTE;1;0;1;1
2018-09-19 12:38:41;NORTE;1;0;1;1
2018-09-19 12:39:27;NORTE;1;0;1;1
2018-09-19 12:40:20;NORTE;1;0;1;1
2018-09-19 12:41:41;NORTE;1;0;1;1
2018-09-19 12:42:13;NORTE;1;0;1;1
2018-09-19 12:42:18;NORTE;1;0;1;1
2018-09-19 12:43:20;NORTE;1;0;1;1
2018-09-19 12:43:59;NORTE;1;0;1;1
2018-09-19 12:44:13;NORTE;1;0;1;1
2018-09-19 12:45:47;NORTE;1;0;1;1
2018-09-19 12:46:15;NORTE;1;0;1;1
2018-09-19 12:46:22;NORTE;1;0;1;1
2018-09-19 12:48:20;NORTE;1;0;1;1
2018-09-19 12:49:20;NORTE;1;0;1;1
2018-09-19 12:50:19;NORTE;1;0;1;1
2018-09-19 12:51:20;NORTE;1;0;1;1
2018-09-19 12:51:59;NORTE;1;0;1;1
2018-09-19 12:52:42;NORTE;1;0;1;1
2018-09-19 12:53:06;NORTE;1;0;1;1
2018-09-19 12:53:31;NORTE;1;0;1;1
2018-09-19 12:54:56;NORTE;1;0;1;1
2018-09-19 12:55:57;NORTE;1;0;1;1
2018-09-19 12:56:11;NORTE;1;0;1;1
2018-09-19 12:57:18;NORTE;1;0;1;1
2018-09-19 12:58:44;NORTE;1;0;1;1
2018-09-19 12:59:40;NORTE;1;0;1;1
2018-09-19 13:00:00;NORTE;32;0;32;1
2018-09-19 13:30:00;NORTE;30;0;30;1
2018-09-19 14:00:00;NORTE;38;0;38;1
2018-09-19 14:30:00;NORTE;24;0;24;1
2018-09-19 15:00:00;NORTE;33;0;33;1
2018-09-19 15:30:00;NORTE;27;0;27;1
2018-09-19 16:00:00;NORTE;21;0;21;1
2018-09-19 16:30:00;NORTE;34;0;34;1
2018-09-19 17:00:00;NORTE;23;0;23;1
2018-09-19 17:30:00;NORTE;35;0;35;1
2018-09-19 18:00:00;NORTE;38;0;38;1
2018-09-19 18:30:00;NORTE;39;0;39;1
2018-09-19 19:00:00;NORTE;34;0;34;1
2018-09-19 19:30:00;NORTE;20;0;20;1
2018-09-19 20:00:00;NORTE;42;0;42;1
2018-09-19 20:30:00;NORTE;25;0;25;1
2018-09-19 21:00:00;NORTE;13;0;13;1
2018-09-19 21:30:00;NORTE;15;0;15;1
2018-09-19 22:00:00;NORTE;12;0;12;1
2018-09-19 22:30:00;NORTE;4;0;4;1
2018-09-19 23:00:00;NORTE;1;0;1;1
2018-09-19 23:30:00;NORTE;1;0;1;1
2018-09-20 00:00:00;NORTE;1;0;1;1
2018-09-20 00:30:00;NORTE;3;0;3;1
2018-09-20 01:00:00;NORTE;2;0;2;1
2018-09-20 02:00:00;NORTE;2;0;2;1
2018-09-20 02:30:00;NORTE;3;0;3;1
2018-09-20 03:00:00;NORTE;3;0;3;1
2018-09-20 03:30:00;NORTE;7;0;7;1
2018-09-20 04:00:00;NORTE;8;0;8;1
2018-09-20 04:30:00;NORTE;12;0;12;1
2018-09-20 05:00:00;NORTE;18;0;18;1
2018-09-20 05:30:00;NORTE;42;0;42;1
2018-09-20 06:00:00;NORTE;20;0;20;1
2018-09-20 06:30:00;NORTE;22;0;22;1
2018-09-20 07:00:00;NORTE;34;0;34;1
2018-09-20 07:30:00;NORTE;31;0;31;1
2018-09-20 08:00:00;NORTE;35;0;35;1
2018-09-20 08:30:00;NORTE;35;0;35;1
2018-09-20 09:00:00;NORTE;29;0;29;1
2018-09-20 09:30:00;NORTE;39;0;39;1
2018-09-20 10:00:00;NORTE;35;0;35;1
2018-09-20 10:30:00;NORTE;31;0;31;1
2018-09-20 11:00:00;NORTE;33;0;33;1
2018-09-20 11:30:00;NORTE;26;0;26;1
2018-09-20 12:00:00;NORTE;25;0;25;1
2018-09-20 12:30:00;NORTE;35;1;36;1
2018-09-20 13:00:00;NORTE;36;0;36;1
2018-09-20 13:30:00;NORTE;29;0;29;1
2018-09-20 14:00:00;NORTE;33;0;33;1
2018-09-20 14:30:00;NORTE;36;0;36;1
2018-09-20 15:00:00;NORTE;35;0;35;1
2018-09-20 15:30:00;NORTE;26;0;26;1
2018-09-20 16:00:00;NORTE;26;0;26;1
2018-09-20 16:30:00;NORTE;27;0;27;1
2018-09-20 17:00:00;NORTE;22;0;22;1
2018-09-20 17:30:00;NORTE;33;0;33;1
2018-09-20 18:00:00;NORTE;35;0;35;1
2018-09-20 18:30:00;NORTE;30;0;30;1
2018-09-20 19:00:00;NORTE;37;0;37;1
2018-09-20 19:30:00;NORTE;25;0;25;1
2018-09-20 20:00:00;NORTE;33;0;33;1
2018-09-20 20:30:00;NORTE;24;0;24;1
2018-09-20 21:00:00;NORTE;19;0;19;1
2018-09-20 21:30:00;NORTE;15;0;15;1
2018-09-20 22:00:00;NORTE;19;0;19;1
2018-09-20 22:30:00;NORTE;5;0;5;1
2018-09-20 23:00:00;NORTE;3;0;3;1
2018-09-20 23:30:00;NORTE;1;0;1;1
2018-09-21 00:30:00;NORTE;1;0;1;1
2018-09-21 01:00:00;NORTE;1;0;1;1
2018-09-21 01:30:00;NORTE;1;0;1;1
2018-09-21 02:00:00;NORTE;3;0;3;1
2018-09-21 02:30:00;NORTE;2;0;2;1
2018-09-21 03:00:00;NORTE;5;0;5;1
2018-09-21 03:30:00;NORTE;6;0;6;1
2018-09-21 04:00:00;NORTE;10;0;10;1
2018-09-21 04:30:00;NORTE;11;0;11;1
2018-09-21 05:00:00;NORTE;19;0;19;1
2018-09-21 05:30:00;NORTE;43;0;43;1
2018-09-21 06:00:00;NORTE;28;0;28;1
2018-09-21 06:30:00;NORTE;27;0;27;1
2018-09-21 07:00:00;NORTE;29;0;29;1
2018-09-21 07:30:00;NORTE;30;0;30;1
2018-09-21 08:00:00;NORTE;41;0;41;1
2018-09-21 08:30:00;NORTE;37;0;37;1
2018-09-21 09:00:00;NORTE;27;0;27;1
2018-09-21 09:30:00;NORTE;39;0;39;1
2018-09-21 10:00:00;NORTE;33;0;33;1
2018-09-21 10:30:00;NORTE;30;0;30;1
2018-09-21 11:00:00;NORTE;27;0;27;1
2018-09-21 11:30:00;NORTE;24;0;24;1
2018-09-21 12:00:00;NORTE;28;0;28;1
2018-09-21 12:30:00;NORTE;34;0;34;1
2018-09-21 13:00:00;NORTE;34;0;34;1
2018-09-21 13:30:00;NORTE;37;0;37;1
2018-09-21 14:00:00;NORTE;27;0;27;1
2018-09-21 14:30:00;NORTE;40;0;40;1
2018-09-21 15:00:00;NORTE;28;0;28;1
2018-09-21 15:30:00;NORTE;23;0;23;1
2018-09-21 16:00:00;NORTE;16;0;16;1
2018-09-21 16:30:00;NORTE;40;0;40;1
2018-09-21 17:00:00;NORTE;24;0;24;1
2018-09-21 17:30:00;NORTE;25;0;25;1
2018-09-21 18:00:00;NORTE;36;0;36;1
2018-09-21 18:30:00;NORTE;36;0;36;1
2018-09-21 19:00:00;NORTE;31;0;31;1
2018-09-21 19:30:00;NORTE;29;0;29;1
2018-09-21 20:00:00;NORTE;34;0;34;1
2018-09-21 20:30:00;NORTE;33;0;33;1
2018-09-21 21:00:00;NORTE;17;0;17;1
2018-09-21 21:30:00;NORTE;12;0;12;1
2018-09-21 22:00:00;NORTE;12;0;12;1
2018-09-21 22:30:00;NORTE;3;0;3;1
2018-09-21 23:00:00;NORTE;5;0;5;1
2018-09-21 23:30:00;NORTE;2;0;2;1
2018-09-22 00:00:00;NORTE;1;0;1;1
2018-09-22 00:30:00;NORTE;1;0;1;1
2018-09-22 01:30:00;NORTE;2;0;2;1
2018-09-22 02:00:00;NORTE;4;0;4;1
2018-09-22 02:30:00;NORTE;5;0;5;1
2018-09-22 03:30:00;NORTE;2;0;2;1
2018-09-22 04:00:00;NORTE;13;0;13;1
2018-09-22 04:30:00;NORTE;13;0;13;1
2018-09-22 05:00:00;NORTE;22;0;22;1
2018-09-22 05:30:00;NORTE;31;0;31;1
2018-09-22 06:00:00;NORTE;19;0;19;1
2018-09-22 06:30:00;NORTE;21;0;21;1
2018-09-22 07:00:00;NORTE;38;0;38;1
2018-09-22 07:30:00;NORTE;30;0;30;1
2018-09-22 08:00:00;NORTE;42;0;42;1
2018-09-22 08:30:00;NORTE;35;0;35;1
2018-09-22 09:00:00;NORTE;23;0;23;1
2018-09-22 09:30:00;NORTE;25;0;25;1
2018-09-22 10:00:00;NORTE;31;1;32;1
2018-09-22 10:30:00;NORTE;34;0;34;1
2018-09-22 11:00:00;NORTE;31;0;31;1
2018-09-22 11:30:00;NORTE;13;0;13;1
2018-09-22 12:00:00;NORTE;33;0;33;1
2018-09-22 12:30:00;NORTE;34;0;34;1
2018-09-22 13:00:00;NORTE;29;0;29;1
2018-09-22 13:30:00;NORTE;33;0;33;1
2018-09-22 14:00:00;NORTE;23;0;23;1
2018-09-22 14:30:00;NORTE;22;0;22;1
2018-09-22 15:00:00;NORTE;20;0;20;1
2018-09-22 15:30:00;NORTE;28;0;28;1
2018-09-22 16:00:00;NORTE;28;0;28;1
2018-09-22 16:30:00;NORTE;32;0;32;1
2018-09-22 17:00:00;NORTE;16;0;16;1
2018-09-22 17:30:00;NORTE;22;0;22;1
2018-09-22 18:00:00;NORTE;31;0;31;1
2018-09-22 18:30:00;NORTE;28;0;28;1
2018-09-22 19:00:00;NORTE;26;0;26;1
2018-09-22 19:30:00;NORTE;19;0;19;1
2018-09-22 20:00:00;NORTE;21;0;21;1
2018-09-22 20:30:00;NORTE;18;0;18;1
2018-09-22 21:00:00;NORTE;14;0;14;1
2018-09-22 21:30:00;NORTE;14;0;14;1
2018-09-22 22:00:00;NORTE;16;0;16;1
2018-09-22 22:30:00;NORTE;11;0;11;1
2018-09-22 23:00:00;NORTE;3;0;3;1
2018-09-22 23:30:00;NORTE;1;0;1;1
2018-09-23 00:00:00;NORTE;1;0;1;1
2018-09-23 00:30:00;NORTE;1;0;1;1
2018-09-23 01:00:00;NORTE;1;0;1;1
2018-09-23 01:30:00;NORTE;1;0;1;1
2018-09-23 02:00:00;NORTE;3;0;3;1
2018-09-23 02:30:00;NORTE;2;0;2;1
2018-09-23 03:00:00;NORTE;3;0;3;1
2018-09-23 03:30:00;NORTE;2;0;2;1
2018-09-23 04:00:00;NORTE;8;0;8;1
2018-09-23 04:30:00;NORTE;8;0;8;1
2018-09-23 05:00:00;NORTE;19;0;19;1
2018-09-23 05:30:00;NORTE;27;0;27;1
2018-09-23 06:00:00;NORTE;22;0;22;1
2018-09-23 06:30:00;NORTE;21;0;21;1
2018-09-23 07:00:00;NORTE;32;0;32;1
2018-09-23 07:30:00;NORTE;34;0;34;1
2018-09-23 08:00:00;NORTE;35;0;35;1
2018-09-23 08:30:00;NORTE;30;0;30;1
2018-09-23 09:00:00;NORTE;19;0;19;1
2018-09-23 09:30:00;NORTE;32;0;32;1
2018-09-23 10:00:00;NORTE;33;0;33;1
2018-09-23 10:30:00;NORTE;31;0;31;1
2018-09-23 11:00:00;NORTE;29;0;29;1
2018-09-23 11:30:00;NORTE;32;0;32;1
2018-09-23 12:00:00;NORTE;30;0;30;1
2018-09-23 12:30:00;NORTE;34;0;34;1
2018-09-23 13:00:00;NORTE;31;0;31;1
2018-09-23 13:30:00;NORTE;40;0;40;1
2018-09-23 14:00:00;NORTE;42;0;42;1
2018-09-23 14:30:00;NORTE;33;0;33;1
2018-09-23 15:00:00;NORTE;25;0;25;1
2018-09-23 15:30:00;NORTE;19;0;19;1
2018-09-23 16:00:00;NORTE;23;0;23;1
2018-09-23 16:30:00;NORTE;31;0;31;1
2018-09-23 17:00:00;NORTE;17;0;17;1
2018-09-23 17:30:00;NORTE;37;0;37;1
2018-09-23 18:00:00;NORTE;31;0;31;1
2018-09-23 18:30:00;NORTE;37;0;37;1
2018-09-23 19:00:00;NORTE;32;0;32;1
2018-09-23 19:30:00;NORTE;24;0;24;1
2018-09-23 20:00:00;NORTE;33;0;33;1
2018-09-23 20:30:00;NORTE;31;0;31;1
2018-09-23 21:00:00;NORTE;17;0;17;1
2018-09-23 21:30:00;NORTE;10;0;10;1
2018-09-23 22:00:00;NORTE;14;0;14;1
2018-09-23 22:30:00;NORTE;10;0;10;1
2018-09-23 23:00:00;NORTE;4;0;4;1
2018-09-23 23:30:00;NORTE;4;0;4;1
2018-09-24 00:00:00;NORTE;1;0;1;1
2018-09-24 00:30:00;NORTE;1;0;1;1
2018-09-24 01:00:00;NORTE;1;0;1;1
2018-09-24 01:30:00;NORTE;1;0;1;1
2018-09-24 02:00:00;NORTE;5;0;5;1
2018-09-24 02:30:00;NORTE;2;0;2;1
2018-09-24 03:00:00;NORTE;4;0;4;1
2018-09-24 03:30:00;NORTE;5;0;5;1
2018-09-24 04:00:00;NORTE;8;0;8;1
2018-09-24 04:30:00;NORTE;15;0;15;1
2018-09-24 05:00:00;NORTE;14;0;14;1
2018-09-24 05:30:00;NORTE;46;0;46;1
2018-09-24 06:00:00;NORTE;21;0;21;1
2018-09-24 06:30:00;NORTE;24;0;24;1
2018-09-24 07:00:00;NORTE;38;0;38;1
2018-09-24 07:30:00;NORTE;34;0;34;1
2018-09-24 08:00:00;NORTE;40;0;40;1
2018-09-24 08:30:00;NORTE;38;0;38;1
2018-09-24 09:00:00;NORTE;24;0;24;1
2018-09-24 09:30:00;NORTE;30;0;30;1
2018-09-24 10:00:00;NORTE;34;0;34;1
2018-09-24 10:30:00;NORTE;35;0;35;1
2018-09-24 11:00:00;NORTE;27;0;27;1
2018-09-24 11:30:00;NORTE;32;0;32;1
2018-09-24 12:00:00;NORTE;28;0;28;1
2018-09-24 12:30:00;NORTE;33;0;33;1
2018-09-24 13:00:00;NORTE;34;0;34;1
2018-09-24 13:30:00;NORTE;37;0;37;1
2018-09-24 14:00:00;NORTE;42;0;42;1
2018-09-24 14:30:00;NORTE;32;0;32;1
2018-09-24 15:00:00;NORTE;30;0;30;1
2018-09-24 15:30:00;NORTE;21;0;21;1
2018-09-24 16:00:00;NORTE;23;0;23;1
2018-09-24 16:30:00;NORTE;33;0;33;1
2018-09-24 17:00:00;NORTE;18;0;18;1
2018-09-24 17:30:00;NORTE;28;0;28;1
2018-09-24 18:00:00;NORTE;37;0;37;1
2018-09-24 18:30:00;NORTE;35;0;35;1
2018-09-24 19:00:00;NORTE;34;0;34;1
2018-09-24 19:30:00;NORTE;24;0;24;1
2018-09-24 20:00:00;NORTE;36;0;36;1
2018-09-24 20:30:00;NORTE;24;0;24;1
2018-09-24 21:00:00;NORTE;16;0;16;1
2018-09-24 21:30:00;NORTE;13;0;13;1
2018-09-24 22:00:00;NORTE;9;0;9;1
2018-09-24 22:30:00;NORTE;4;0;4;1
2018-09-24 23:30:00;NORTE;1;0;1;1
2018-09-25 00:00:00;NORTE;1;0;1;1
2018-09-25 01:00:00;NORTE;1;0;1;1
2018-09-25 01:30:00;NORTE;2;0;2;1
2018-09-25 02:00:00;NORTE;3;0;3;1
2018-09-25 02:30:00;NORTE;4;0;4;1
2018-09-25 03:30:00;NORTE;9;0;9;1
2018-09-25 04:00:00;NORTE;11;0;11;1
2018-09-25 04:30:00;NORTE;14;0;14;1
2018-09-25 05:00:00;NORTE;17;0;17;1
2018-09-25 05:30:00;NORTE;45;0;45;1
2018-09-25 06:00:00;NORTE;18;0;18;1
2018-09-25 06:30:00;NORTE;26;0;26;1
2018-09-25 07:00:00;NORTE;33;0;33;1
2018-09-25 07:30:00;NORTE;36;0;36;1
2018-09-25 08:00:00;NORTE;36;0;36;1
2018-09-25 08:30:00;NORTE;30;0;30;1
2018-09-25 09:00:00;NORTE;23;0;23;1
2018-09-25 09:30:00;NORTE;30;0;30;1
2018-09-25 10:00:00;NORTE;37;0;37;1
2018-09-25 10:30:00;NORTE;29;0;29;1
2018-09-25 11:00:00;NORTE;32;0;32;1
2018-09-25 11:30:00;NORTE;30;0;30;1
2018-09-25 12:00:00;NORTE;26;0;26;1
2018-09-25 12:30:00;NORTE;35;0;35;1
2018-09-25 13:00:00;NORTE;27;0;27;1
2018-09-25 13:30:00;NORTE;34;0;34;1
2018-09-25 14:00:00;NORTE;41;0;41;1
2018-09-25 14:30:00;NORTE;35;0;35;1
2018-09-25 15:00:00;NORTE;21;0;21;1
2018-09-25 15:30:00;NORTE;26;0;26;1
2018-09-25 16:00:00;NORTE;21;0;21;1
2018-09-25 16:30:00;NORTE;34;0;34;1
2018-09-25 17:00:00;NORTE;29;0;29;1
2018-09-25 17:30:00;NORTE;28;0;28;1
2018-09-25 18:00:00;NORTE;41;0;41;1
2018-09-25 18:30:00;NORTE;37;0;37;1
2018-09-25 19:00:00;NORTE;35;0;35;1
2018-09-25 19:30:00;CONFLICTIVA;18;2;20;2
2018-09-25 20:00:00;SUR;0;42;42;1
2018-09-25 20:30:00;SUR;0;22;22;1
2018-09-25 21:00:00;SUR;0;17;17;1
2018-09-25 21:30:00;SUR;0;14;14;1
2018-09-25 22:00:00;SUR;0;11;11;1
2018-09-25 22:30:00;SUR;0;8;8;1
2018-09-25 23:00:00;SUR;0;1;1;1
2018-09-25 23:30:00;SUR;0;1;1;1
2018-09-26 00:00:00;SUR;0;2;2;1
2018-09-26 01:00:00;SUR;0;1;1;1
2018-09-26 01:30:00;CONFLICTIVA;1;1;2;2
2018-09-26 02:00:00;NORTE;2;0;2;1
2018-09-26 02:30:00;NORTE;3;0;3;1
2018-09-26 03:00:00;NORTE;2;0;2;1
2018-09-26 03:30:00;NORTE;9;0;9;1
2018-09-26 04:00:00;NORTE;9;0;9;1
2018-09-26 04:30:00;NORTE;13;0;13;1
2018-09-26 05:00:00;NORTE;23;0;23;1
2018-09-26 05:30:00;NORTE;34;0;34;1
2018-09-26 06:00:00;NORTE;30;0;30;1
2018-09-26 06:30:00;NORTE;25;0;25;1
2018-09-26 07:00:00;NORTE;37;0;37;1
2018-09-26 07:30:00;NORTE;34;0;34;1
2018-09-26 08:00:00;NORTE;32;0;32;1
2018-09-26 08:30:00;NORTE;33;0;33;1
2018-09-26 09:00:00;NORTE;28;0;28;1
2018-09-26 09:30:00;NORTE;39;0;39;1
2018-09-26 10:00:00;NORTE;34;0;34;1
2018-09-26 10:30:00;NORTE;29;0;29;1
2018-09-26 11:00:00;NORTE;35;0;35;1
2018-09-26 11:30:00;NORTE;26;0;26;1
2018-09-26 12:00:00;NORTE;26;0;26;1
2018-09-26 12:30:00;NORTE;35;0;35;1
2018-09-26 13:00:00;NORTE;33;0;33;1
2018-09-26 13:30:00;NORTE;36;0;36;1
2018-09-26 14:00:00;NORTE;41;0;41;1
2018-09-26 14:30:00;NORTE;34;0;34;1
2018-09-26 15:00:00;NORTE;28;0;28;1
2018-09-26 15:30:00;NORTE;19;0;19;1
2018-09-26 16:00:00;NORTE;26;0;26;1
2018-09-26 16:30:00;NORTE;28;0;28;1
2018-09-26 17:00:00;NORTE;29;0;29;1
2018-09-26 17:30:00;CONFLICTIVA;15;19;34;2
2018-09-26 18:00:00;SUR;0;37;37;1
2018-09-26 18:30:00;SUR;0;36;36;1
2018-09-26 19:00:00;SUR;0;22;22;1
2018-09-26 19:30:00;SUR;0;31;31;1
2018-09-26 20:00:00;SUR;0;30;30;1
2018-09-26 20:30:00;SUR;0;29;29;1
2018-09-26 21:00:00;SUR;0;26;26;1
2018-09-26 21:30:00;SUR;0;16;16;1
2018-09-26 22:00:00;SUR;0;8;8;1
2018-09-26 22:30:00;SUR;0;9;9;1
2018-09-26 23:00:00;SUR;0;3;3;1
2018-09-26 23:30:00;SUR;0;3;3;1
2018-09-27 00:00:00;CONFLICTIVA;1;2;3;2
2018-09-27 01:00:00;NORTE;1;0;1;1
2018-09-27 01:30:00;NORTE;1;0;1;1
2018-09-27 02:00:00;NORTE;3;0;3;1
2018-09-27 02:30:00;NORTE;4;0;4;1
2018-09-27 03:00:00;NORTE;1;0;1;1
2018-09-27 03:30:00;NORTE;6;0;6;1
2018-09-27 04:00:00;NORTE;6;0;6;1
2018-09-27 04:30:00;NORTE;16;0;16;1
2018-09-27 05:00:00;NORTE;20;0;20;1
2018-09-27 05:30:00;NORTE;41;0;41;1
2018-09-27 06:00:00;NORTE;22;0;22;1
2018-09-27 06:30:00;NORTE;26;0;26;1
2018-09-27 07:00:00;NORTE;32;0;32;1
2018-09-27 07:30:00;NORTE;39;0;39;1
2018-09-27 08:00:00;NORTE;33;0;33;1
2018-09-27 08:30:00;NORTE;36;0;36;1
2018-09-27 09:00:00;NORTE;25;0;25;1
2018-09-27 09:30:00;NORTE;36;0;36;1
2018-09-27 10:00:00;NORTE;35;0;35;1
2018-09-27 10:30:00;NORTE;36;0;36;1
2018-09-27 11:00:00;NORTE;34;0;34;1
2018-09-27 11:30:00;NORTE;28;0;28;1
2018-09-27 12:00:00;NORTE;29;0;29;1
2018-09-27 12:30:00;NORTE;33;0;33;1
2018-09-27 13:00:00;NORTE;32;0;32;1
2018-09-27 13:30:00;NORTE;24;0;24;1
2018-09-27 14:00:00;NORTE;31;0;31;1
2018-09-27 14:30:00;NORTE;37;0;37;1
2018-09-27 15:00:00;NORTE;30;0;30;1
2018-09-27 15:30:00;NORTE;24;0;24;1
2018-09-27 16:00:00;NORTE;23;0;23;1
2018-09-27 16:30:00;NORTE;31;0;31;1
2018-09-27 17:00:00;NORTE;23;0;23;1
2018-09-27 17:30:00;NORTE;35;1;36;1
2018-09-27 18:00:00;NORTE;36;0;36;1
2018-09-27 18:30:00;NORTE;36;0;36;1
2018-09-27 19:00:00;NORTE;41;0;41;1
2018-09-27 19:30:00;NORTE;22;0;22;1
2018-09-27 20:00:00;NORTE;33;0;33;1
2018-09-27 20:30:00;NORTE;28;0;28;1
2018-09-27 21:00:00;NORTE;15;0;15;1
2018-09-27 21:30:00;NORTE;17;0;17;1
2018-09-27 22:00:00;NORTE;9;0;9;1
2018-09-27 22:30:00;NORTE;5;0;5;1
2018-09-27 23:00:00;NORTE;4;0;4;1
2018-09-27 23:30:00;NORTE;1;0;1;1
2018-09-28 00:00:00;NORTE;1;0;1;1
2018-09-28 00:30:00;NORTE;1;0;1;1
2018-09-28 01:00:00;NORTE;4;0;4;1
2018-09-28 01:30:00;NORTE;1;0;1;1
2018-09-28 02:00:00;NORTE;3;0;3;1
2018-09-28 02:30:00;NORTE;2;0;2;1
2018-09-28 03:00:00;NORTE;5;0;5;1
2018-09-28 03:30:00;NORTE;9;0;9;1
2018-09-28 04:00:00;NORTE;10;0;10;1
2018-09-28 04:30:00;NORTE;8;0;8;1
2018-09-28 05:00:00;NORTE;18;0;18;1
2018-09-28 05:30:00;NORTE;40;0;40;1
2018-09-28 06:00:00;NORTE;24;0;24;1
2018-09-28 06:30:00;NORTE;29;0;29;1
2018-09-28 07:00:00;NORTE;36;0;36;1
2018-09-28 07:30:00;NORTE;32;0;32;1
2018-09-28 08:00:00;NORTE;42;0;42;1
2018-09-28 08:30:00;NORTE;34;0;34;1
2018-09-28 09:00:00;NORTE;26;0;26;1
2018-09-28 09:30:00;NORTE;35;0;35;1
2018-09-28 10:00:00;NORTE;33;0;33;1
2018-09-28 10:30:00;NORTE;27;0;27;1
2018-09-28 11:00:00;NORTE;32;0;32;1
2018-09-28 11:30:00;NORTE;28;0;28;1
2018-09-28 12:00:00;NORTE;27;0;27;1
2018-09-28 12:30:00;NORTE;35;0;35;1
2018-09-28 13:00:00;NORTE;39;0;39;1
2018-09-28 13:30:00;NORTE;37;0;37;1
2018-09-28 14:00:00;NORTE;33;0;33;1
2018-09-28 14:30:00;NORTE;34;0;34;1
2018-09-28 15:00:00;NORTE;27;0;27;1
2018-09-28 15:30:00;NORTE;22;0;22;1
2018-09-28 16:00:00;NORTE;27;0;27;1
2018-09-28 16:30:00;NORTE;28;0;28;1
2018-09-28 17:00:00;NORTE;28;0;28;1
2018-09-28 17:30:00;NORTE;29;1;30;1
2018-09-28 18:00:00;NORTE;36;0;36;1
2018-09-28 18:30:00;NORTE;36;0;36;1
2018-09-28 19:00:00;NORTE;35;0;35;1
2018-09-28 19:30:00;NORTE;32;0;32;1
2018-09-28 20:00:00;NORTE;37;0;37;1
2018-09-28 20:30:00;NORTE;30;0;30;1
2018-09-28 21:00:00;NORTE;16;0;16;1
2018-09-28 21:30:00;NORTE;11;0;11;1
2018-09-28 22:00:00;NORTE;12;0;12;1
2018-09-28 22:30:00;NORTE;7;0;7;1
2018-09-28 23:00:00;NORTE;1;0;1;1
2018-09-28 23:30:00;NORTE;2;0;2;1
2018-09-29 00:00:00;NORTE;1;0;1;1
2018-09-29 01:00:00;NORTE;2;0;2;1
2018-09-29 02:00:00;NORTE;2;0;2;1
2018-09-29 02:30:00;NORTE;3;0;3;1
2018-09-29 03:00:00;NORTE;2;0;2;1
2018-09-29 03:30:00;NORTE;3;0;3;1
2018-09-29 04:00:00;NORTE;10;0;10;1
2018-09-29 04:30:00;NORTE;14;0;14;1
2018-09-29 05:00:00;NORTE;16;0;16;1
2018-09-29 05:30:00;NORTE;35;0;35;1
2018-09-29 06:00:00;NORTE;23;0;23;1
2018-09-29 06:30:00;NORTE;25;0;25;1
2018-09-29 07:00:00;NORTE;33;0;33;1
2018-09-29 07:30:00;NORTE;30;0;30;1
2018-09-29 08:00:00;NORTE;42;0;42;1
2018-09-29 08:30:00;NORTE;29;0;29;1
2018-09-29 09:00:00;NORTE;25;0;25;1
2018-09-29 09:30:00;NORTE;27;0;27;1
2018-09-29 10:00:00;NORTE;35;0;35;1
2018-09-29 10:30:00;NORTE;33;0;33;1
2018-09-29 11:00:00;NORTE;27;0;27;1
2018-09-29 11:30:00;NORTE;24;0;24;1
2018-09-29 12:00:00;NORTE;30;0;30;1
2018-09-29 12:30:00;NORTE;38;0;38;1
2018-09-29 13:00:00;NORTE;25;0;25;1
2018-09-29 13:30:00;NORTE;27;0;27;1
2018-09-29 14:00:00;NORTE;35;0;35;1
2018-09-29 14:30:00;NORTE;33;0;33;1
2018-09-29 15:00:00;NORTE;29;0;29;1
2018-09-29 15:30:00;NORTE;18;0;18;1
2018-09-29 16:00:00;NORTE;21;0;21;1
2018-09-29 16:30:00;NORTE;30;0;30;1
2018-09-29 17:00:00;NORTE;14;0;14;1
2018-09-29 17:30:00;NORTE;25;0;25;1
2018-09-29 18:00:00;NORTE;31;0;31;1
2018-09-29 18:30:00;NORTE;29;0;29;1
2018-09-29 19:00:00;NORTE;26;0;26;1
2018-09-29 19:30:00;NORTE;22;0;22;1
2018-09-29 20:00:00;NORTE;21;0;21;1
2018-09-29 20:30:00;NORTE;15;0;15;1
2018-09-29 21:00:00;NORTE;12;0;12;1
2018-09-29 21:30:00;NORTE;13;0;13;1
2018-09-29 22:00:00;NORTE;16;0;16;1
2018-09-29 22:30:00;NORTE;5;0;5;1
2018-09-29 23:00:00;NORTE;1;0;1;1
2018-09-29 23:30:00;NORTE;1;0;1;1
2018-09-30 00:00:00;NORTE;1;0;1;1
2018-09-30 00:30:00;NORTE;1;0;1;1
2018-09-30 01:00:00;NORTE;2;0;2;1
2018-09-30 01:30:00;NORTE;1;0;1;1
2018-09-30 02:00:00;NORTE;2;0;2;1
2018-09-30 02:30:00;NORTE;1;0;1;1
2018-09-30 03:00:00;NORTE;3;0;3;1
2018-09-30 03:30:00;NORTE;3;0;3;1
2018-09-30 04:00:00;NORTE;10;0;10;1
2018-09-30 04:30:00;NORTE;12;0;12;1
2018-09-30 05:00:00;NORTE;16;0;16;1
2018-09-30 05:30:00;NORTE;28;0;28;1
2018-09-30 06:00:00;NORTE;19;0;19;1
2018-09-30 06:30:00;NORTE;22;0;22;1
2018-09-30 07:00:00;NORTE;34;0;34;1
2018-09-30 07:30:00;NORTE;30;0;30;1
2018-09-30 08:00:00;NORTE;33;0;33;1
2018-09-30 08:30:00;NORTE;39;0;39;1
2018-09-30 09:00:00;NORTE;24;0;24;1
2018-09-30 09:30:00;NORTE;35;0;35;1
2018-09-30 10:00:00;NORTE;30;0;30;1
2018-09-30 10:30:00;NORTE;39;0;39;1
2018-09-30 11:00:00;NORTE;33;1;34;1
2018-09-30 11:30:00;NORTE;30;0;30;1
2018-09-30 12:00:00;NORTE;29;0;29;1
2018-09-30 12:30:00;NORTE;35;0;35;1
2018-09-30 13:00:00;NORTE;35;0;35;1
2018-09-30 13:30:00;NORTE;31;0;31;1
2018-09-30 14:00:00;NORTE;46;0;46;1
2018-09-30 14:30:00;NORTE;35;0;35;1
2018-09-30 15:00:00;NORTE;29;0;29;1
2018-09-30 15:30:00;NORTE;23;0;23;1
2018-09-30 16:00:00;NORTE;21;0;21;1
2018-09-30 16:30:00;NORTE;34;0;34;1
2018-09-30 17:00:00;NORTE;25;0;25;1
2018-09-30 17:30:00;NORTE;31;0;31;1
2018-09-30 18:00:00;NORTE;38;0;38;1
2018-09-30 18:30:00;NORTE;43;0;43;1
2018-09-30 19:00:00;NORTE;34;0;34;1
2018-09-30 19:30:00;NORTE;30;0;30;1
2018-09-30 20:00:00;NORTE;37;0;37;1
2018-09-30 20:30:00;NORTE;27;0;27;1
2018-09-30 21:00:00;NORTE;18;0;18;1
2018-09-30 21:30:00;NORTE;14;0;14;1
2018-09-30 22:00:00;NORTE;10;0;10;1
2018-09-30 22:30:00;NORTE;11;0;11;1
2018-09-30 23:00:00;NORTE;5;0;5;1
2018-09-30 23:30:00;NORTE;1;0;1;1
2018-10-01 00:00:00;NORTE;4;0;4;1
2018-10-01 01:00:00;NORTE;2;0;2;1
2018-10-01 01:30:00;NORTE;1;0;1;1
2018-10-01 02:00:00;NORTE;4;0;4;1
2018-10-01 02:30:00;NORTE;3;0;3;1
2018-10-01 03:00:00;NORTE;5;0;5;1
2018-10-01 03:30:00;NORTE;4;0;4;1
2018-10-01 04:00:00;NORTE;10;0;10;1
2018-10-01 04:30:00;NORTE;12;0;12;1
2018-10-01 05:00:00;NORTE;24;0;24;1
2018-10-01 05:30:00;NORTE;35;0;35;1
2018-10-01 06:00:00;NORTE;23;0;23;1
2018-10-01 06:30:00;NORTE;22;0;22;1
2018-10-01 07:00:00;NORTE;42;0;42;1
2018-10-01 07:30:00;NORTE;28;0;28;1
2018-10-01 08:00:00;NORTE;41;1;42;1
2018-10-01 08:30:00;NORTE;34;0;34;1
2018-10-01 09:00:00;NORTE;31;0;31;1
2018-10-01 09:30:00;NORTE;32;0;32;1
2018-10-01 10:00:00;NORTE;32;0;32;1
2018-10-01 10:30:00;NORTE;32;0;32;1
2018-10-01 11:00:00;NORTE;35;0;35;1
2018-10-01 11:30:00;NORTE;30;0;30;1
2018-10-01 12:00:00;NORTE;23;0;23;1
2018-10-01 12:30:00;NORTE;36;0;36;1
2018-10-01 13:00:00;NORTE;42;0;42;1
2018-10-01 13:30:00;NORTE;34;0;34;1
2018-10-01 14:00:00;NORTE;37;0;37;1
2018-10-01 14:30:00;NORTE;25;0;25;1
2018-10-01 15:00:00;NORTE;33;0;33;1
2018-10-01 15:30:00;NORTE;24;1;25;1
2018-10-01 16:00:00;NORTE;24;0;24;1
2018-10-01 16:30:00;NORTE;26;0;26;1
2018-10-01 17:00:00;NORTE;38;0;38;1
2018-10-01 17:30:00;NORTE;28;0;28;1
2018-10-01 18:00:00;NORTE;42;0;42;1
2018-10-01 18:30:00;NORTE;36;0;36;1
2018-10-01 19:00:00;NORTE;34;0;34;1
2018-10-01 19:30:00;NORTE;22;0;22;1
2018-10-01 20:00:00;NORTE;32;0;32;1
2018-10-01 20:30:00;NORTE;31;0;31;1
2018-10-01 21:00:00;NORTE;14;0;14;1
2018-10-01 21:30:00;NORTE;12;0;12;1
2018-10-01 22:00:00;NORTE;13;0;13;1
2018-10-01 22:30:00;NORTE;8;0;8;1
2018-10-01 23:00:00;NORTE;1;0;1;1
2018-10-02 00:00:00;NORTE;1;0;1;1
2018-10-02 00:30:00;NORTE;1;0;1;1
2018-10-02 01:30:00;NORTE;2;0;2;1
2018-10-02 02:00:00;NORTE;3;0;3;1
2018-10-02 02:30:00;NORTE;5;0;5;1
2018-10-02 03:00:00;NORTE;2;0;2;1
2018-10-02 03:30:00;NORTE;9;0;9;1
2018-10-02 04:00:00;NORTE;10;0;10;1
2018-10-02 04:30:00;NORTE;18;0;18;1
2018-10-02 05:00:00;NORTE;21;0;21;1
2018-10-02 05:30:00;NORTE;40;0;40;1
2018-10-02 06:00:00;NORTE;23;0;23;1
2018-10-02 06:30:00;NORTE;31;0;31;1
2018-10-02 07:00:00;NORTE;36;1;37;1
2018-10-02 07:30:00;NORTE;32;0;32;1
2018-10-02 08:00:00;NORTE;40;0;40;1
2018-10-02 08:30:00;NORTE;31;0;31;1
2018-10-02 09:00:00;NORTE;19;0;19;1
2018-10-02 09:30:00;NORTE;32;0;32;1
2018-10-02 10:00:00;NORTE;40;0;40;1
2018-10-02 10:30:00;NORTE;33;0;33;1
2018-10-02 11:00:00;NORTE;26;1;27;1
2018-10-02 11:30:00;NORTE;33;0;33;1
2018-10-02 12:00:00;NORTE;30;0;30;1
2018-10-02 12:30:00;NORTE;35;0;35;1
2018-10-02 13:00:00;NORTE;33;0;33;1
2018-10-02 13:30:00;NORTE;29;0;29;1
2018-10-02 14:00:00;NORTE;32;0;32;1
2018-10-02 14:30:00;NORTE;39;0;39;1
2018-10-02 15:00:00;NORTE;26;0;26;1
2018-10-02 15:30:00;NORTE;25;0;25;1
2018-10-02 16:00:00;NORTE;29;0;29;1
2018-10-02 16:30:00;NORTE;25;0;25;1
2018-10-02 17:00:00;NORTE;32;0;32;1
2018-10-02 17:30:00;NORTE;35;0;35;1
2018-10-02 18:00:00;NORTE;38;0;38;1
2018-10-02 18:30:00;NORTE;30;0;30;1
2018-10-02 19:00:00;NORTE;33;0;33;1
2018-10-02 19:30:00;NORTE;31;0;31;1
2018-10-02 20:00:00;NORTE;42;0;42;1
2018-10-02 20:30:00;NORTE;22;0;22;1
2018-10-02 21:00:00;NORTE;10;0;10;1
2018-10-02 21:30:00;NORTE;16;0;16;1
2018-10-02 22:00:00;NORTE;8;0;8;1
2018-10-02 22:30:00;NORTE;6;0;6;1
2018-10-02 23:00:00;NORTE;2;0;2;1
2018-10-02 23:30:00;NORTE;3;0;3;1
2018-10-03 00:00:00;NORTE;2;0;2;1
2018-10-03 00:30:00;NORTE;2;0;2;1
2018-10-03 01:00:00;NORTE;1;0;1;1
2018-10-03 01:30:00;NORTE;1;0;1;1
2018-10-03 02:00:00;NORTE;1;0;1;1
2018-10-03 02:30:00;NORTE;3;0;3;1
2018-10-03 03:00:00;NORTE;3;0;3;1
2018-10-03 03:30:00;NORTE;8;0;8;1
2018-10-03 04:00:00;NORTE;13;0;13;1
2018-10-03 04:30:00;NORTE;15;0;15;1
2018-10-03 05:00:00;NORTE;24;0;24;1
2018-10-03 05:30:00;NORTE;42;0;42;1
2018-10-03 06:00:00;NORTE;20;0;20;1
2018-10-03 06:30:00;NORTE;19;0;19;1
2018-10-03 07:00:00;NORTE;37;0;37;1
2018-10-03 07:30:00;NORTE;27;0;27;1
2018-10-03 08:00:00;NORTE;36;0;36;1
2018-10-03 08:30:00;NORTE;39;0;39;1
2018-10-03 09:00:00;NORTE;28;0;28;1
2018-10-03 09:30:00;NORTE;29;0;29;1
2018-10-03 10:00:00;NORTE;44;0;44;1
2018-10-03 10:30:00;NORTE;34;0;34;1
2018-10-03 11:00:00;NORTE;30;0;30;1
2018-10-03 11:30:00;NORTE;29;0;29;1
2018-10-03 12:00:00;NORTE;30;0;30;1
2018-10-03 12:30:00;NORTE;31;0;31;1
2018-10-03 13:00:00;NORTE;29;0;29;1
2018-10-03 13:30:00;NORTE;30;0;30;1
2018-10-03 14:00:00;NORTE;31;0;31;1
2018-10-03 14:30:00;NORTE;33;0;33;1
2018-10-03 15:00:00;NORTE;24;0;24;1
2018-10-03 15:30:00;NORTE;25;0;25;1
2018-10-03 16:00:00;NORTE;23;0;23;1
2018-10-03 16:30:00;NORTE;25;0;25;1
2018-10-03 17:00:00;NORTE;23;0;23;1
2018-10-03 17:30:00;NORTE;34;0;34;1
2018-10-03 18:00:00;NORTE;44;0;44;1
2018-10-03 18:30:00;NORTE;37;0;37;1
2018-10-03 19:00:00;NORTE;24;0;24;1
2018-10-03 19:30:00;NORTE;37;0;37;1
2018-10-03 20:00:00;NORTE;38;0;38;1
2018-10-03 20:30:00;NORTE;22;0;22;1
2018-10-03 21:00:00;NORTE;15;0;15;1
2018-10-03 21:30:00;NORTE;13;0;13;1
2018-10-03 22:00:00;NORTE;9;0;9;1
2018-10-03 22:30:00;NORTE;8;0;8;1
2018-10-03 23:00:00;NORTE;1;0;1;1
2018-10-03 23:30:00;NORTE;1;0;1;1
2018-10-04 00:00:00;NORTE;3;0;3;1
2018-10-04 01:00:00;NORTE;1;0;1;1
2018-10-04 01:30:00;NORTE;1;0;1;1
2018-10-04 02:00:00;NORTE;3;0;3;1
2018-10-04 02:30:00;NORTE;3;0;3;1
2018-10-04 03:00:00;NORTE;3;0;3;1
2018-10-04 03:30:00;NORTE;6;0;6;1
2018-10-04 04:00:00;NORTE;10;0;10;1
2018-10-04 04:30:00;NORTE;11;0;11;1
2018-10-04 05:00:00;NORTE;20;0;20;1
2018-10-04 05:30:00;NORTE;43;0;43;1
2018-10-04 06:00:00;NORTE;20;0;20;1
2018-10-04 06:30:00;NORTE;30;0;30;1
2018-10-04 07:00:00;NORTE;35;0;35;1
2018-10-04 07:30:00;NORTE;32;0;32;1
2018-10-04 08:00:00;NORTE;39;0;39;1
2018-10-04 08:30:00;NORTE;35;0;35;1
2018-10-04 09:00:00;NORTE;21;0;21;1
2018-10-04 09:30:00;NORTE;37;0;37;1
2018-10-04 10:00:00;NORTE;34;0;34;1
2018-10-04 10:30:00;NORTE;31;0;31;1
2018-10-04 11:00:00;NORTE;37;0;37;1
2018-10-04 11:30:00;NORTE;27;0;27;1
2018-10-04 12:00:00;NORTE;23;0;23;1
2018-10-04 12:30:00;NORTE;37;0;37;1
2018-10-04 13:00:00;NORTE;31;0;31;1
2018-10-04 13:30:00;NORTE;32;0;32;1
2018-10-04 14:00:00;NORTE;37;0;37;1
2018-10-04 14:30:00;NORTE;40;0;40;1
2018-10-04 15:00:00;NORTE;31;0;31;1
2018-10-04 15:30:00;NORTE;23;0;23;1
2018-10-04 16:00:00;NORTE;24;0;24;1
2018-10-04 16:30:00;NORTE;36;0;36;1
2018-10-04 17:00:00;NORTE;26;0;26;1
2018-10-04 17:30:00;NORTE;28;0;28;1
2018-10-04 18:00:00;NORTE;38;0;38;1
2018-10-04 18:30:00;NORTE;35;0;35;1
2018-10-04 19:00:00;NORTE;33;0;33;1
2018-10-04 19:30:00;NORTE;24;0;24;1
2018-10-04 20:00:00;NORTE;38;0;38;1
2018-10-04 20:30:00;NORTE;25;0;25;1
2018-10-04 21:00:00;NORTE;15;0;15;1
2018-10-04 21:30:00;NORTE;14;0;14;1
2018-10-04 22:00:00;NORTE;12;0;12;1
2018-10-04 22:30:00;NORTE;6;0;6;1
2018-10-04 23:00:00;NORTE;4;0;4;1
2018-10-04 23:30:00;NORTE;1;0;1;1
2018-10-05 00:00:00;NORTE;1;0;1;1
2018-10-05 00:30:00;NORTE;1;0;1;1
2018-10-05 01:00:00;NORTE;1;0;1;1
2018-10-05 01:30:00;NORTE;1;0;1;1
2018-10-05 02:00:00;NORTE;3;0;3;1
2018-10-05 02:30:00;NORTE;5;0;5;1
2018-10-05 03:00:00;NORTE;5;0;5;1
2018-10-05 03:30:00;NORTE;7;0;7;1
2018-10-05 04:00:00;NORTE;9;0;9;1
2018-10-05 04:30:00;NORTE;12;0;12;1
2018-10-05 05:00:00;NORTE;15;0;15;1
2018-10-05 05:30:00;NORTE;43;0;43;1
2018-10-05 06:00:00;NORTE;18;0;18;1
2018-10-05 06:30:00;NORTE;34;0;34;1
2018-10-05 07:00:00;NORTE;36;0;36;1
2018-10-05 07:30:00;NORTE;35;0;35;1
2018-10-05 08:00:00;NORTE;42;0;42;1
2018-10-05 08:30:00;NORTE;32;0;32;1
2018-10-05 09:00:00;NORTE;33;0;33;1
2018-10-05 09:30:00;NORTE;33;0;33;1
2018-10-05 10:00:00;NORTE;32;0;32;1
2018-10-05 10:30:00;NORTE;33;0;33;1
2018-10-05 11:00:00;NORTE;33;0;33;1
2018-10-05 11:30:00;NORTE;28;0;28;1
2018-10-05 12:00:00;NORTE;28;0;28;1
2018-10-05 12:30:00;NORTE;34;0;34;1
2018-10-05 13:00:00;NORTE;31;0;31;1
2018-10-05 13:30:00;NORTE;35;0;35;1
2018-10-05 14:00:00;NORTE;38;0;38;1
2018-10-05 14:30:00;NORTE;30;0;30;1
2018-10-05 15:00:00;NORTE;32;0;32;1
2018-10-05 15:30:00;NORTE;28;0;28;1
2018-10-05 16:00:00;NORTE;25;0;25;1
2018-10-05 16:30:00;NORTE;31;0;31;1
2018-10-05 17:00:00;NORTE;32;0;32;1
2018-10-05 17:30:00;NORTE;32;0;32;1
2018-10-05 18:00:00;NORTE;34;0;34;1
2018-10-05 18:30:00;NORTE;39;0;39;1
2018-10-05 19:00:00;NORTE;36;0;36;1
2018-10-05 19:30:00;NORTE;28;0;28;1
2018-10-05 20:00:00;NORTE;38;0;38;1
2018-10-05 20:30:00;NORTE;27;0;27;1
2018-10-05 21:00:00;NORTE;14;0;14;1
2018-10-05 21:30:00;NORTE;14;0;14;1
2018-10-05 22:00:00;NORTE;13;0;13;1
2018-10-05 22:30:00;NORTE;5;0;5;1
2018-10-05 23:00:00;NORTE;3;0;3;1
2018-10-05 23:30:00;NORTE;1;0;1;1
2018-10-06 00:00:00;NORTE;2;0;2;1
2018-10-06 01:00:00;NORTE;1;0;1;1
2018-10-06 02:00:00;NORTE;5;0;5;1
2018-10-06 02:30:00;NORTE;6;0;6;1
2018-10-06 03:30:00;NORTE;3;0;3;1
2018-10-06 04:00:00;NORTE;13;0;13;1
2018-10-06 04:30:00;NORTE;12;0;12;1
2018-10-06 05:00:00;NORTE;14;0;14;1
2018-10-06 05:30:00;NORTE;34;0;34;1
2018-10-06 06:00:00;NORTE;20;0;20;1
2018-10-06 06:30:00;NORTE;22;0;22;1
2018-10-06 07:00:00;NORTE;34;0;34;1
2018-10-06 07:30:00;NORTE;29;0;29;1
2018-10-06 08:00:00;NORTE;46;0;46;1
2018-10-06 08:30:00;NORTE;34;0;34;1
2018-10-06 09:00:00;NORTE;13;0;13;1
2018-10-06 09:30:00;NORTE;31;0;31;1
2018-10-06 10:00:00;NORTE;32;0;32;1
2018-10-06 10:30:00;NORTE;36;0;36;1
2018-10-06 11:00:00;CONFLICTIVA;19;10;29;2
2018-10-06 11:30:00;SUR;0;21;21;1
2018-10-06 12:00:00;SUR;0;25;25;1
2018-10-06 12:30:00;SUR;0;28;28;1
2018-10-06 13:00:00;SUR;0;32;32;1
2018-10-06 13:30:00;SUR;0;30;30;1
2018-10-06 14:00:00;SUR;0;29;29;1
2018-10-06 14:30:00;SUR;0;32;32;1
2018-10-06 15:00:00;SUR;0;26;26;1
2018-10-06 15:30:00;SUR;0;24;24;1
2018-10-06 16:00:00;SUR;0;27;27;1
2018-10-06 16:30:00;SUR;0;22;22;1
2018-10-06 17:00:00;SUR;0;16;16;1
2018-10-06 17:30:00;SUR;0;33;33;1
2018-10-06 18:00:00;SUR;0;26;26;1
2018-10-06 18:30:00;SUR;0;25;25;1
2018-10-06 19:00:00;CONFLICTIVA;11;9;20;2
2018-10-06 19:30:00;NORTE;25;0;25;1
2018-10-06 20:00:00;NORTE;25;0;25;1
2018-10-06 20:30:00;NORTE;12;0;12;1
2018-10-06 21:00:00;NORTE;7;0;7;1
2018-10-06 21:30:00;NORTE;10;0;10;1
2018-10-06 22:00:00;NORTE;11;0;11;1
2018-10-06 22:30:00;NORTE;10;0;10;1
2018-10-06 23:00:00;NORTE;2;0;2;1
2018-10-07 00:00:00;NORTE;2;0;2;1
2018-10-07 00:30:00;NORTE;2;0;2;1
2018-10-07 01:00:00;NORTE;2;0;2;1
2018-10-07 01:30:00;NORTE;1;0;1;1
2018-10-07 02:00:00;NORTE;3;0;3;1
2018-10-07 02:30:00;NORTE;3;0;3;1
2018-10-07 03:30:00;NORTE;5;0;5;1
2018-10-07 04:00:00;NORTE;7;0;7;1
2018-10-07 04:30:00;NORTE;10;0;10;1
2018-10-07 05:00:00;NORTE;17;0;17;1
2018-10-07 05:30:00;NORTE;32;0;32;1
2018-10-07 06:00:00;NORTE;18;0;18;1
2018-10-07 06:30:00;NORTE;18;0;18;1
2018-10-07 07:00:00;NORTE;33;0;33;1
2018-10-07 07:30:00;NORTE;29;0;29;1
2018-10-07 08:00:00;NORTE;39;0;39;1
2018-10-07 08:30:00;NORTE;31;0;31;1
2018-10-07 09:00:00;NORTE;22;0;22;1
2018-10-07 09:30:00;NORTE;29;0;29;1
2018-10-07 10:00:00;NORTE;36;0;36;1
2018-10-07 10:30:00;NORTE;35;0;35;1
2018-10-07 11:00:00;NORTE;30;0;30;1
2018-10-07 11:30:00;NORTE;30;0;30;1
2018-10-07 12:00:00;NORTE;29;0;29;1
2018-10-07 12:30:00;NORTE;30;0;30;1
2018-10-07 13:00:00;NORTE;36;0;36;1
2018-10-07 13:30:00;NORTE;39;0;39;1
2018-10-07 14:00:00;NORTE;40;1;41;1
2018-10-07 14:30:00;NORTE;27;0;27;1
2018-10-07 15:00:00;NORTE;35;0;35;1
2018-10-07 15:30:00;NORTE;20;0;20;1
2018-10-07 16:00:00;NORTE;22;0;22;1
2018-10-07 16:30:00;NORTE;33;0;33;1
2018-10-07 17:00:00;NORTE;24;0;24;1
2018-10-07 17:30:00;NORTE;31;0;31;1
2018-10-07 18:00:00;NORTE;38;0;38;1
2018-10-07 18:30:00;NORTE;37;0;37;1
2018-10-07 19:00:00;NORTE;32;0;32;1
2018-10-07 19:30:00;NORTE;31;0;31;1
2018-10-07 20:00:00;NORTE;32;0;32;1
2018-10-07 20:30:00;NORTE;24;0;24;1
2018-10-07 21:00:00;NORTE;18;0;18;1
2018-10-07 21:30:00;NORTE;8;0;8;1
2018-10-07 22:00:00;NORTE;17;0;17;1
2018-10-07 22:30:00;NORTE;9;0;9;1
2018-10-07 23:00:00;NORTE;4;0;4;1
2018-10-07 23:30:00;NORTE;1;0;1;1
2018-10-08 00:00:00;NORTE;3;0;3;1
2018-10-08 01:00:00;NORTE;1;0;1;1
2018-10-08 01:30:00;NORTE;1;0;1;1
2018-10-08 02:00:00;NORTE;4;0;4;1
2018-10-08 02:30:00;NORTE;3;0;3;1
2018-10-08 03:00:00;NORTE;1;0;1;1
2018-10-08 03:30:00;NORTE;5;0;5;1
2018-10-08 04:00:00;NORTE;9;0;9;1
2018-10-08 04:30:00;NORTE;11;0;11;1
2018-10-08 05:00:00;NORTE;19;0;19;1
2018-10-08 05:30:00;NORTE;43;0;43;1
2018-10-08 06:00:00;NORTE;27;0;27;1
2018-10-08 06:30:00;NORTE;22;0;22;1
2018-10-08 07:00:00;NORTE;39;0;39;1
2018-10-08 07:30:00;NORTE;33;0;33;1
2018-10-08 08:00:00;NORTE;34;0;34;1
2018-10-08 08:30:00;NORTE;44;0;44;1
2018-10-08 09:00:00;NORTE;25;0;25;1
2018-10-08 09:30:00;NORTE;35;0;35;1
2018-10-08 10:00:00;NORTE;33;0;33;1
2018-10-08 10:30:00;NORTE;34;0;34;1
2018-10-08 11:00:00;NORTE;38;0;38;1
2018-10-08 11:30:00;NORTE;30;0;30;1
2018-10-08 12:00:00;NORTE;29;0;29;1
2018-10-08 12:30:00;NORTE;35;0;35;1
2018-10-08 13:00:00;NORTE;44;0;44;1
2018-10-08 13:30:00;NORTE;32;0;32;1
2018-10-08 14:00:00;NORTE;35;0;35;1
2018-10-08 14:30:00;NORTE;31;0;31;1
2018-10-08 15:00:00;NORTE;29;0;29;1
2018-10-08 15:30:00;NORTE;21;0;21;1
2018-10-08 16:00:00;NORTE;24;0;24;1
2018-10-08 16:30:00;NORTE;33;0;33;1
2018-10-08 17:00:00;NORTE;24;0;24;1
2018-10-08 17:30:00;NORTE;33;0;33;1
2018-10-08 18:00:00;NORTE;43;0;43;1
2018-10-08 18:30:00;NORTE;39;0;39;1
2018-10-08 19:00:00;NORTE;34;0;34;1
2018-10-08 19:30:00;NORTE;24;0;24;1
2018-10-08 20:00:00;NORTE;41;0;41;1
2018-10-08 20:30:00;NORTE;22;0;22;1
2018-10-08 21:00:00;NORTE;15;0;15;1
2018-10-08 21:30:00;NORTE;13;0;13;1
2018-10-08 22:00:00;NORTE;9;0;9;1
2018-10-08 22:30:00;NORTE;7;0;7;1
2018-10-09 00:00:00;NORTE;2;0;2;1
2018-10-09 00:30:00;NORTE;1;0;1;1
2018-10-09 01:00:00;NORTE;3;0;3;1
2018-10-09 02:00:00;NORTE;2;0;2;1
2018-10-09 02:30:00;NORTE;6;0;6;1
2018-10-09 03:00:00;NORTE;4;0;4;1
2018-10-09 03:30:00;NORTE;6;0;6;1
2018-10-09 04:00:00;NORTE;13;0;13;1
2018-10-09 04:30:00;NORTE;13;0;13;1
2018-10-09 05:00:00;NORTE;16;0;16;1
2018-10-09 05:30:00;NORTE;47;0;47;1
2018-10-09 06:00:00;NORTE;19;0;19;1
2018-10-09 06:30:00;NORTE;23;0;23;1
2018-10-09 07:00:00;NORTE;36;0;36;1
2018-10-09 07:30:00;NORTE;30;0;30;1
2018-10-09 08:00:00;NORTE;34;0;34;1
2018-10-09 08:30:00;NORTE;35;0;35;1
2018-10-09 09:00:00;NORTE;15;0;15;1
2018-10-09 09:30:00;NORTE;38;0;38;1
2018-10-09 10:00:00;NORTE;36;0;36;1
2018-10-09 10:30:00;NORTE;40;0;40;1
2018-10-09 11:00:00;NORTE;28;0;28;1
2018-10-09 11:30:00;NORTE;31;0;31;1
2018-10-09 12:00:00;CONFLICTIVA;6;20;26;2
2018-10-09 12:30:00;SUR;0;28;28;1
2018-10-09 13:00:00;SUR;0;29;29;1
2018-10-09 13:30:00;SUR;0;33;33;1
2018-10-09 14:00:00;SUR;0;36;36;1
2018-10-09 14:30:00;SUR;1;31;32;1
2018-10-09 15:00:00;SUR;0;30;30;1
2018-10-09 15:30:00;SUR;0;28;28;1
2018-10-09 16:00:00;SUR;0;26;26;1
2018-10-09 16:30:00;SUR;0;27;27;1
2018-10-09 17:00:00;SUR;0;16;16;1
2018-10-09 17:23:00;SUR;0;3;3;1
2018-10-09 17:30:00;SUR;0;3;3;1
2018-10-09 17:35:00;SUR;0;24;24;1
2018-10-09 18:00:00;SUR;0;19;19;1
2018-10-09 18:19:00;SUR;0;11;11;1
2018-10-09 18:30:00;SUR;0;8;8;1
2018-10-09 18:39:00;SUR;0;20;20;1
2018-10-09 19:00:00;SUR;0;11;11;1
2018-10-09 19:09:00;SUR;0;16;16;1
2018-10-09 19:21:00;SUR;0;8;8;1
2018-10-09 19:30:00;SUR;0;38;38;1
2018-10-09 20:00:00;SUR;0;21;21;1
2018-10-09 20:30:00;NORTE;21;0;21;1
2018-10-09 20:50:00;NORTE;10;0;10;1
2018-10-09 21:00:00;NORTE;25;0;25;1
2018-10-09 21:30:00;NORTE;16;0;16;1
2018-10-09 22:00:00;NORTE;17;0;17;1
2018-10-09 22:30:00;NORTE;11;0;11;1
2018-10-09 23:00:00;NORTE;2;0;2;1
2018-10-09 23:30:00;NORTE;3;0;3;1
2018-10-10 00:00:00;NORTE;1;0;1;1
2018-10-10 01:30:00;NORTE;3;0;3;1
2018-10-10 02:00:00;NORTE;2;0;2;1
2018-10-10 02:30:00;NORTE;3;0;3;1
2018-10-10 03:00:00;NORTE;4;0;4;1
2018-10-10 03:30:00;NORTE;8;0;8;1
2018-10-10 04:00:00;NORTE;9;0;9;1
2018-10-10 04:30:00;NORTE;13;0;13;1
2018-10-10 05:00:00;NORTE;14;0;14;1
2018-10-10 05:30:00;NORTE;39;0;39;1
2018-10-10 06:00:00;NORTE;28;0;28;1
2018-10-10 06:30:00;NORTE;26;0;26;1
2018-10-10 07:00:00;NORTE;36;0;36;1
2018-10-10 07:30:00;NORTE;32;0;32;1
2018-10-10 08:00:00;NORTE;37;0;37;1
2018-10-10 08:30:00;NORTE;37;0;37;1
2018-10-10 09:00:00;NORTE;29;0;29;1
2018-10-10 09:30:00;SUR;1;29;30;1
2018-10-10 10:00:00;SUR;0;34;34;1
2018-10-10 10:30:00;SUR;0;32;32;1
2018-10-10 11:00:00;SUR;0;30;30;1
2018-10-10 11:30:00;SUR;0;32;32;1
2018-10-10 12:00:00;SUR;0;24;24;1
2018-10-10 12:30:00;SUR;0;29;29;1
2018-10-10 13:00:00;SUR;0;24;24;1
2018-10-10 13:30:00;SUR;0;33;33;1
2018-10-10 14:00:00;SUR;0;42;42;1
2018-10-10 14:30:00;SUR;0;38;38;1
2018-10-10 15:00:00;SUR;0;27;27;1
2018-10-10 15:30:00;SUR;0;23;23;1
2018-10-10 16:00:00;NORTE;24;0;24;1
2018-10-10 16:30:00;NORTE;33;0;33;1
2018-10-10 17:00:00;NORTE;34;0;34;1
2018-10-10 17:30:05;NORTE;1;0;1;1
2018-10-10 17:30:13;NORTE;1;0;1;1
2018-10-10 17:30:55;NORTE;1;0;1;1
2018-10-10 17:31:59;NORTE;1;0;1;1
2018-10-10 17:33:35;NORTE;1;0;1;1
2018-10-10 17:34:09;NORTE;1;0;1;1
2018-10-10 17:36:34;NORTE;1;0;1;1
2018-10-10 17:37:25;NORTE;1;0;1;1
2018-10-10 17:41:08;NORTE;1;0;1;1
2018-10-10 17:42:16;NORTE;1;0;1;1
2018-10-10 17:43:26;NORTE;1;0;1;1
2018-10-10 17:44:35;NORTE;1;0;1;1
2018-10-10 17:44:46;NORTE;1;0;1;1
2018-10-10 17:46:01;NORTE;1;0;1;1
2018-10-10 17:46:08;NORTE;1;0;1;1
2018-10-10 17:47:16;NORTE;1;0;1;1
2018-10-10 17:48:21;NORTE;1;0;1;1
2018-10-10 17:48:25;NORTE;1;0;1;1
2018-10-10 17:49:49;NORTE;1;0;1;1
2018-10-10 17:50:16;NORTE;1;0;1;1
2018-10-10 17:50:19;NORTE;1;0;1;1
2018-10-10 17:51:14;NORTE;1;0;1;1
2018-10-10 17:51:50;NORTE;1;0;1;1
2018-10-10 17:53:39;NORTE;1;0;1;1
2018-10-10 17:54:27;NORTE;1;0;1;1
2018-10-10 17:54:57;NORTE;1;0;1;1
2018-10-10 17:56:26;NORTE;1;0;1;1
2018-10-10 17:56:48;NORTE;1;0;1;1
2018-10-10 17:57:14;NORTE;1;0;1;1
2018-10-10 17:57:43;NORTE;1;0;1;1
2018-10-10 17:58:54;NORTE;1;0;1;1
2018-10-10 17:59:06;NORTE;1;0;1;1
2018-10-10 17:59:58;NORTE;1;0;1;1
2018-10-10 18:00:00;NORTE;41;0;41;1
2018-10-10 18:30:00;NORTE;38;0;38;1
2018-10-10 19:00:00;NORTE;34;0;34;1
2018-10-10 19:30:00;NORTE;28;0;28;1
2018-10-10 20:00:00;NORTE;46;0;46;1
2018-10-10 20:30:00;NORTE;25;0;25;1
2018-10-10 21:00:00;NORTE;13;0;13;1
2018-10-10 21:30:00;NORTE;12;0;12;1
2018-10-10 22:00:00;NORTE;13;0;13;1
2018-10-10 22:30:00;NORTE;5;0;5;1
2018-10-10 23:00:00;NORTE;1;0;1;1
2018-10-10 23:30:00;NORTE;1;0;1;1
2018-10-11 00:00:00;NORTE;2;0;2;1
2018-10-11 00:30:00;NORTE;3;0;3;1
2018-10-11 01:00:00;NORTE;2;0;2;1
2018-10-11 02:00:00;NORTE;3;0;3;1
2018-10-11 02:30:00;NORTE;4;0;4;1
2018-10-11 03:00:00;NORTE;3;0;3;1
2018-10-11 03:30:00;NORTE;7;0;7;1
2018-10-11 04:00:00;NORTE;8;0;8;1
2018-10-11 04:30:00;NORTE;14;0;14;1
2018-10-11 05:00:00;NORTE;21;0;21;1
2018-10-11 05:30:00;NORTE;43;0;43;1
2018-10-11 06:00:00;CONFLICTIVA;17;2;19;2
2018-10-11 06:30:00;SUR;0;25;25;1
2018-10-11 07:00:00;SUR;0;34;34;1
2018-10-11 07:30:00;SUR;0;26;26;1
2018-10-11 08:00:00;SUR;0;9;9;1
2018-10-11 08:10:00;SUR;0;26;26;1
2018-10-11 08:30:00;SUR;0;37;37;1
2018-10-11 09:00:00;SUR;0;27;27;1
2018-10-11 09:30:00;SUR;0;29;29;1
2018-10-11 10:00:00;SUR;0;41;41;1
2018-10-11 10:30:00;SUR;0;35;35;1
2018-10-11 11:00:00;SUR;0;32;32;1
2018-10-11 11:30:00;SUR;0;32;32;1
2018-10-11 12:00:00;SUR;0;31;31;1
2018-10-11 12:30:00;SUR;0;28;28;1
2018-10-11 13:00:00;SUR;0;34;34;1
2018-10-11 13:30:00;SUR;0;36;36;1
2018-10-11 14:00:00;SUR;0;35;35;1
2018-10-11 14:30:00;SUR;0;35;35;1
2018-10-11 15:00:00;SUR;0;28;28;1
2018-10-11 15:30:00;SUR;0;18;18;1
2018-10-11 16:00:00;SUR;0;25;25;1
2018-10-11 16:30:00;SUR;0;35;35;1
2018-10-11 17:00:00;SUR;0;24;24;1
2018-10-11 17:30:00;SUR;0;31;31;1
2018-10-11 18:00:00;SUR;0;34;34;1
2018-10-11 18:30:00;SUR;0;32;32;1
2018-10-11 19:00:00;SUR;0;27;27;1
2018-10-11 19:30:00;CONFLICTIVA;19;6;25;2
2018-10-11 20:00:00;NORTE;35;0;35;1
2018-10-11 20:30:00;NORTE;32;0;32;1
2018-10-11 21:00:00;NORTE;20;0;20;1
2018-10-11 21:30:00;NORTE;12;0;12;1
2018-10-11 22:00:00;NORTE;21;0;21;1
2018-10-11 22:30:00;NORTE;4;0;4;1
2018-10-11 23:00:00;NORTE;4;0;4;1
2018-10-11 23:30:00;NORTE;1;0;1;1
2018-10-12 00:00:00;NORTE;1;0;1;1
2018-10-12 00:30:00;NORTE;1;0;1;1
2018-10-12 01:00:00;NORTE;1;0;1;1
2018-10-12 02:00:00;NORTE;2;0;2;1
2018-10-12 02:37:15;NORTE;1;0;1;1
2018-10-12 02:45:45;NORTE;1;0;1;1
2018-10-12 02:46:59;NORTE;1;0;1;1
2018-10-12 02:47:47;NORTE;1;0;1;1
2018-10-12 02:49:17;NORTE;1;0;1;1
2018-10-12 03:00:00;SUR;0;3;3;1
2018-10-12 03:30:00;SUR;0;5;5;1
2018-10-12 04:00:00;SUR;0;9;9;1
2018-10-12 04:30:00;SUR;0;9;9;1
2018-10-12 05:00:00;SUR;0;16;16;1
2018-10-12 05:30:00;SUR;0;36;36;1
2018-10-12 06:00:00;SUR;0;23;23;1
2018-10-12 06:30:00;SUR;0;31;31;1
2018-10-12 07:00:00;SUR;0;37;37;1
2018-10-12 07:30:00;SUR;0;29;29;1
2018-10-12 08:00:00;SUR;0;33;33;1
2018-10-12 08:30:00;SUR;0;26;26;1
2018-10-12 09:00:00;SUR;0;32;32;1
2018-10-12 09:30:00;SUR;0;19;19;1
2018-10-12 10:00:00;SUR;0;35;35;1
2018-10-12 10:30:00;SUR;0;42;42;1
2018-10-12 11:00:00;SUR;0;37;37;1
2018-10-12 11:30:00;SUR;0;26;26;1
2018-10-12 12:00:00;SUR;0;28;28;1
2018-10-12 12:30:00;CONFLICTIVA;14;15;29;2
2018-10-12 13:00:00;NORTE;39;0;39;1
2018-10-12 13:30:00;NORTE;43;0;43;1
2018-10-12 14:00:00;NORTE;38;0;38;1
2018-10-12 14:30:00;NORTE;36;0;36;1
2018-10-12 15:00:00;NORTE;32;0;32;1
2018-10-12 15:30:00;NORTE;27;0;27;1
2018-10-12 16:00:00;NORTE;25;0;25;1
2018-10-12 16:30:00;NORTE;30;0;30;1
2018-10-12 17:00:00;NORTE;24;0;24;1
2018-10-12 17:30:00;NORTE;28;1;29;1
2018-10-12 18:00:00;NORTE;38;0;38;1
2018-10-12 18:30:00;NORTE;37;0;37;1
2018-10-12 19:00:00;NORTE;29;0;29;1
2018-10-12 19:30:00;NORTE;35;0;35;1
2018-10-12 20:00:00;NORTE;36;0;36;1
2018-10-12 20:30:00;NORTE;19;0;19;1
2018-10-12 21:00:00;NORTE;16;0;16;1
2018-10-12 21:30:00;NORTE;11;0;11;1
2018-10-12 22:00:00;NORTE;17;0;17;1
2018-10-12 22:30:00;NORTE;3;0;3;1
2018-10-12 23:00:00;NORTE;1;0;1;1
2018-10-12 23:30:00;NORTE;2;0;2;1
2018-10-13 00:00:00;NORTE;1;0;1;1
2018-10-13 00:30:00;NORTE;1;0;1;1
2018-10-13 01:00:00;NORTE;1;0;1;1
2018-10-13 01:30:00;NORTE;1;0;1;1
2018-10-13 02:00:00;NORTE;1;0;1;1
2018-10-13 02:30:00;NORTE;3;0;3;1
2018-10-13 03:00:00;NORTE;4;0;4;1
2018-10-13 03:30:00;NORTE;1;0;1;1
2018-10-13 04:00:00;NORTE;12;0;12;1
2018-10-13 04:30:00;NORTE;13;0;13;1
2018-10-13 05:00:00;NORTE;20;0;20;1
2018-10-13 05:30:00;NORTE;28;0;28;1
2018-10-13 06:00:00;NORTE;22;0;22;1
2018-10-13 06:30:00;NORTE;28;0;28;1
2018-10-13 07:00:00;NORTE;34;0;34;1
2018-10-13 07:30:00;NORTE;34;0;34;1
2018-10-13 08:00:00;NORTE;38;0;38;1
2018-10-13 08:30:00;NORTE;30;0;30;1
2018-10-13 09:00:00;NORTE;16;0;16;1
2018-10-13 09:30:00;NORTE;33;0;33;1
2018-10-13 10:00:00;NORTE;35;0;35;1
2018-10-13 10:30:00;NORTE;33;0;33;1
2018-10-13 11:00:00;NORTE;26;0;26;1
2018-10-13 11:30:00;NORTE;21;0;21;1
2018-10-13 12:00:00;NORTE;25;0;25;1
2018-10-13 12:30:00;NORTE;38;0;38;1
2018-10-13 13:00:00;NORTE;31;0;31;1
2018-10-13 13:30:00;NORTE;29;0;29;1
2018-10-13 14:00:00;NORTE;34;0;34;1
2018-10-13 14:30:00;NORTE;34;0;34;1
2018-10-13 15:00:00;NORTE;23;0;23;1
2018-10-13 15:30:00;NORTE;21;0;21;1
2018-10-13 16:00:00;NORTE;26;0;26;1
2018-10-13 16:30:00;NORTE;21;0;21;1
2018-10-13 17:00:00;NORTE;19;0;19;1
2018-10-13 17:30:00;NORTE;24;0;24;1
2018-10-13 18:00:00;NORTE;34;0;34;1
2018-10-13 18:30:00;NORTE;24;0;24;1
2018-10-13 19:00:00;NORTE;21;0;21;1
2018-10-13 19:30:00;NORTE;23;0;23;1
2018-10-13 20:00:00;NORTE;22;0;22;1
2018-10-13 20:30:00;NORTE;14;0;14;1
2018-10-13 21:00:00;NORTE;11;0;11;1
2018-10-13 21:30:00;NORTE;11;0;11;1
2018-10-13 22:00:00;NORTE;12;0;12;1
2018-10-13 22:30:00;NORTE;8;0;8;1
2018-10-13 23:00:00;NORTE;5;0;5;1
2018-10-14 00:00:00;SUR;0;1;1;1
2018-10-14 00:30:00;SUR;0;1;1;1
2018-10-14 01:00:00;SUR;0;2;2;1
2018-10-14 01:30:00;SUR;0;1;1;1
2018-10-14 02:30:00;SUR;0;2;2;1
2018-10-14 03:00:00;SUR;0;6;6;1
2018-10-14 03:30:00;SUR;0;3;3;1
2018-10-14 04:00:00;SUR;0;7;7;1
2018-10-14 04:30:00;SUR;0;8;8;1
2018-10-14 05:00:00;SUR;0;15;15;1
2018-10-14 05:30:00;SUR;0;22;22;1
2018-10-14 06:00:00;SUR;0;25;25;1
2018-10-14 06:30:00;SUR;0;21;21;1
2018-10-14 07:00:00;SUR;0;32;32;1
2018-10-14 07:30:00;SUR;0;25;25;1
2018-10-14 08:00:00;SUR;0;22;22;1
2018-10-14 08:17:00;SUR;0;13;13;1
2018-10-14 08:30:00;SUR;0;28;28;1
2018-10-14 09:00:00;SUR;0;25;25;1
2018-10-14 09:30:00;SUR;0;29;29;1
2018-10-14 10:00:00;SUR;0;34;34;1
2018-10-14 10:30:00;SUR;0;35;35;1
2018-10-14 11:00:00;SUR;0;32;32;1
2018-10-14 11:30:00;SUR;0;24;24;1
2018-10-14 12:00:00;SUR;0;30;30;1
2018-10-14 12:30:00;SUR;0;29;29;1
2018-10-14 13:00:00;SUR;0;34;34;1
2018-10-14 13:30:00;SUR;0;42;42;1
2018-10-14 14:00:00;NORTE;31;1;32;1
2018-10-14 14:30:00;NORTE;40;0;40;1
2018-10-14 15:00:00;NORTE;35;0;35;1
2018-10-14 15:30:00;NORTE;23;0;23;1
2018-10-14 16:00:00;NORTE;28;0;28;1
2018-10-14 16:30:00;NORTE;27;0;27;1
2018-10-14 17:00:00;NORTE;30;0;30;1
2018-10-14 17:30:00;NORTE;31;0;31;1
2018-10-14 18:00:00;NORTE;40;0;40;1
2018-10-14 18:30:00;NORTE;28;0;28;1
2018-10-14 19:00:00;NORTE;28;0;28;1
2018-10-14 19:30:00;NORTE;35;0;35;1
2018-10-14 20:00:00;NORTE;28;0;28;1
2018-10-14 20:30:00;NORTE;37;0;37;1
2018-10-14 21:00:00;NORTE;17;0;17;1
2018-10-14 21:30:00;NORTE;16;0;16;1
2018-10-14 22:00:00;NORTE;18;0;18;1
2018-10-14 22:30:00;NORTE;13;0;13;1
2018-10-14 23:00:00;NORTE;4;0;4;1
2018-10-14 23:30:00;NORTE;1;0;1;1
2018-10-15 00:00:00;NORTE;4;0;4;1
2018-10-15 00:30:00;NORTE;1;0;1;1
2018-10-15 01:00:00;NORTE;1;0;1;1
2018-10-15 01:30:00;NORTE;1;0;1;1
2018-10-15 02:00:00;NORTE;4;0;4;1
2018-10-15 02:30:00;NORTE;3;0;3;1
2018-10-15 03:00:00;NORTE;1;0;1;1
2018-10-15 03:30:00;NORTE;7;0;7;1
2018-10-15 04:00:00;NORTE;5;0;5;1
2018-10-15 04:30:00;NORTE;11;0;11;1
2018-10-15 05:00:00;NORTE;17;0;17;1
2018-10-15 05:30:00;NORTE;44;0;44;1
2018-10-15 06:00:00;NORTE;25;0;25;1
2018-10-15 06:30:00;NORTE;23;0;23;1
2018-10-15 07:00:00;NORTE;39;0;39;1
2018-10-15 07:30:00;NORTE;26;0;26;1
2018-10-15 08:00:00;NORTE;38;0;38;1
2018-10-15 08:30:00;NORTE;30;2;32;1
2018-10-15 09:00:00;SUR;0;34;34;1
2018-10-15 09:30:00;SUR;0;31;31;1
2018-10-15 10:00:00;SUR;0;35;35;1
2018-10-15 10:30:00;SUR;0;35;35;1
2018-10-15 11:00:00;SUR;0;32;32;1
2018-10-15 11:30:00;SUR;0;28;28;1
2018-10-15 12:00:00;SUR;0;27;27;1
2018-10-15 12:30:00;SUR;0;32;32;1
2018-10-15 13:00:00;SUR;0;36;36;1
2018-10-15 13:30:00;SUR;0;33;33;1
2018-10-15 14:00:00;SUR;0;33;33;1
2018-10-15 14:30:00;SUR;0;35;35;1
2018-10-15 15:00:00;SUR;0;28;28;1
2018-10-15 15:30:00;SUR;0;21;21;1
2018-10-15 16:00:00;SUR;0;26;26;1
2018-10-15 16:30:00;SUR;0;29;29;1
2018-10-15 17:00:00;SUR;0;20;20;1
2018-10-15 17:30:00;SUR;0;30;30;1
2018-10-15 18:00:00;NORTE;36;0;36;1
2018-10-15 18:30:00;NORTE;37;0;37;1
2018-10-15 19:00:00;NORTE;41;0;41;1
2018-10-15 19:30:00;NORTE;28;0;28;1
2018-10-15 20:00:00;NORTE;37;0;37;1
2018-10-15 20:30:00;NORTE;24;0;24;1
2018-10-15 21:00:00;NORTE;19;0;19;1
2018-10-15 21:30:00;NORTE;13;0;13;1
2018-10-15 22:00:00;NORTE;9;0;9;1
2018-10-15 22:30:00;NORTE;7;0;7;1
2018-10-15 23:00:00;NORTE;4;0;4;1
2018-10-15 23:30:00;NORTE;2;0;2;1
2018-10-16 01:00:00;NORTE;3;0;3;1
2018-10-16 01:30:00;NORTE;1;0;1;1
2018-10-16 02:00:00;NORTE;4;0;4;1
2018-10-16 02:30:00;NORTE;5;0;5;1
2018-10-16 03:00:00;NORTE;2;0;2;1
2018-10-16 03:30:00;NORTE;9;0;9;1
2018-10-16 04:00:00;NORTE;11;0;11;1
2018-10-16 04:30:00;NORTE;13;0;13;1
2018-10-16 05:00:00;NORTE;22;0;22;1
2018-10-16 05:30:00;NORTE;37;0;37;1
2018-10-16 06:00:00;NORTE;22;0;22;1
2018-10-16 06:30:00;NORTE;20;0;20;1
2018-10-16 07:00:00;NORTE;43;0;43;1
2018-10-16 07:30:00;NORTE;34;0;34;1
2018-10-16 08:00:00;NORTE;36;0;36;1
2018-10-16 08:30:00;NORTE;40;0;40;1
2018-10-16 09:00:00;NORTE;22;0;22;1
2018-10-16 09:30:00;NORTE;34;0;34;1
2018-10-16 10:00:00;NORTE;39;0;39;1
2018-10-16 10:30:00;NORTE;38;0;38;1
2018-10-16 11:00:00;NORTE;28;0;28;1
2018-10-16 11:30:00;NORTE;25;0;25;1
2018-10-16 12:00:00;NORTE;29;0;29;1
2018-10-16 12:30:00;NORTE;37;0;37;1
2018-10-16 13:00:00;NORTE;26;0;26;1
2018-10-16 13:30:00;NORTE;34;0;34;1
2018-10-16 14:00:00;NORTE;45;0;45;1
2018-10-16 14:30:00;NORTE;38;0;38;1
2018-10-16 15:00:00;NORTE;23;0;23;1
2018-10-16 15:30:00;NORTE;22;0;22;1
2018-10-16 16:00:00;NORTE;26;1;27;1
2018-10-16 16:30:00;NORTE;26;0;26;1
2018-10-16 17:00:00;NORTE;26;0;26;1
2018-10-16 17:30:00;NORTE;34;0;34;1
2018-10-16 18:00:00;NORTE;46;0;46;1
2018-10-16 18:30:00;NORTE;30;0;30;1
2018-10-16 19:00:00;NORTE;28;0;28;1
2018-10-16 19:30:00;NORTE;32;0;32;1
2018-10-16 20:00:00;NORTE;37;0;37;1
2018-10-16 20:30:00;NORTE;28;0;28;1
2018-10-16 21:00:00;NORTE;15;0;15;1
2018-10-16 21:30:00;NORTE;10;0;10;1
2018-10-16 22:00:00;NORTE;14;0;14;1
2018-10-16 22:30:00;NORTE;6;0;6;1
2018-10-16 23:30:00;NORTE;1;0;1;1
2018-10-17 00:30:00;NORTE;1;0;1;1
2018-10-17 01:00:00;NORTE;2;0;2;1
2018-10-17 01:30:00;NORTE;2;0;2;1
2018-10-17 02:00:00;NORTE;2;0;2;1
2018-10-17 02:30:00;NORTE;3;0;3;1
2018-10-17 03:00:00;NORTE;6;0;6;1
2018-10-17 03:30:00;NORTE;10;0;10;1
2018-10-17 04:00:00;NORTE;10;0;10;1
2018-10-17 04:30:00;NORTE;13;0;13;1
2018-10-17 05:00:00;NORTE;16;0;16;1
2018-10-17 05:30:00;NORTE;44;0;44;1
2018-10-17 06:00:00;NORTE;24;0;24;1
2018-10-17 06:30:00;NORTE;27;0;27;1
2018-10-17 07:00:00;NORTE;29;0;29;1
2018-10-17 07:30:00;NORTE;37;0;37;1
2018-10-17 08:00:00;NORTE;33;0;33;1
2018-10-17 08:30:00;NORTE;38;0;38;1
2018-10-17 09:00:00;NORTE;25;0;25;1
2018-10-17 09:30:00;NORTE;37;0;37;1
2018-10-17 10:00:00;NORTE;38;0;38;1
2018-10-17 10:30:00;NORTE;28;0;28;1
2018-10-17 11:00:00;NORTE;36;0;36;1
2018-10-17 11:30:00;NORTE;26;0;26;1
2018-10-17 12:00:00;NORTE;31;0;31;1
2018-10-17 12:30:00;NORTE;31;0;31;1
2018-10-17 13:00:00;NORTE;40;0;40;1
2018-10-17 13:30:00;NORTE;30;0;30;1
2018-10-17 14:00:00;NORTE;38;0;38;1
2018-10-17 14:30:00;NORTE;36;0;36;1
2018-10-17 15:00:00;NORTE;27;0;27;1
2018-10-17 15:30:00;SUR;1;20;21;1
2018-10-17 16:00:00;SUR;0;28;28;1
2018-10-17 16:30:00;SUR;0;27;27;1
2018-10-17 17:00:00;SUR;0;29;29;1
2018-10-17 17:30:00;SUR;0;33;33;1
2018-10-17 18:00:00;SUR;0;38;38;1
2018-10-17 18:30:00;SUR;0;37;37;1
2018-10-17 19:00:00;CONFLICTIVA;4;20;24;2
2018-10-17 19:30:00;NORTE;29;0;29;1
2018-10-17 20:00:00;NORTE;31;0;31;1
2018-10-17 20:30:00;NORTE;28;0;28;1
2018-10-17 21:00:00;NORTE;17;0;17;1
2018-10-17 21:30:00;NORTE;11;0;11;1
2018-10-17 22:00:00;NORTE;12;0;12;1
2018-10-17 22:30:00;NORTE;3;0;3;1
2018-10-17 23:00:00;NORTE;1;0;1;1
2018-10-17 23:30:00;NORTE;1;0;1;1
2018-10-18 00:00:00;NORTE;1;0;1;1
2018-10-18 00:30:00;NORTE;2;0;2;1
2018-10-18 01:00:00;NORTE;1;0;1;1
2018-10-18 01:30:00;NORTE;1;0;1;1
2018-10-18 02:00:00;NORTE;4;0;4;1
2018-10-18 02:30:00;NORTE;3;0;3;1
2018-10-18 03:00:00;NORTE;2;0;2;1
2018-10-18 03:30:00;NORTE;11;0;11;1
2018-10-18 04:00:00;NORTE;7;0;7;1
2018-10-18 04:30:00;NORTE;11;0;11;1
2018-10-18 05:00:00;NORTE;22;0;22;1
2018-10-18 05:30:00;NORTE;40;0;40;1
2018-10-18 06:00:00;NORTE;21;0;21;1
2018-10-18 06:30:00;NORTE;21;0;21;1
2018-10-18 07:00:00;NORTE;40;0;40;1
2018-10-18 07:30:00;NORTE;29;0;29;1
2018-10-18 08:00:00;NORTE;34;0;34;1
2018-10-18 08:30:00;NORTE;41;0;41;1
2018-10-18 09:00:00;NORTE;23;0;23;1
2018-10-18 09:30:00;NORTE;34;0;34;1
2018-10-18 10:00:00;NORTE;43;0;43;1
2018-10-18 10:30:00;NORTE;33;0;33;1
2018-10-18 11:00:00;NORTE;35;0;35;1
2018-10-18 11:30:00;NORTE;30;0;30;1
2018-10-18 12:00:00;NORTE;26;0;26;1
2018-10-18 12:30:00;NORTE;38;0;38;1
2018-10-18 13:00:00;NORTE;28;0;28;1
2018-10-18 13:30:00;NORTE;30;0;30;1
2018-10-18 14:00:00;NORTE;42;0;42;1
2018-10-18 14:30:00;NORTE;35;0;35;1
2018-10-18 15:00:00;NORTE;30;0;30;1
2018-10-18 15:30:00;NORTE;22;0;22;1
2018-10-18 16:00:00;NORTE;27;0;27;1
2018-10-18 16:30:00;NORTE;29;0;29;1
2018-10-18 17:00:00;NORTE;27;0;27;1
2018-10-18 17:30:00;NORTE;31;0;31;1
2018-10-18 18:00:00;NORTE;37;0;37;1
2018-10-18 18:30:00;NORTE;31;0;31;1
2018-10-18 19:00:00;NORTE;34;0;34;1
2018-10-18 19:30:00;NORTE;23;0;23;1
2018-10-18 19:52:00;NORTE;7;0;7;1
2018-10-18 20:00:00;NORTE;26;0;26;1
2018-10-18 20:20:00;NORTE;11;0;11;1
2018-10-18 20:30:00;NORTE;22;0;22;1
2018-10-18 21:00:00;NORTE;10;0;10;1
2018-10-18 21:30:00;NORTE;18;0;18;1
2018-10-18 22:00:00;NORTE;17;0;17;1
2018-10-18 22:30:00;NORTE;5;0;5;1
2018-10-18 22:42:00;NORTE;2;0;2;1
2018-10-18 23:00:00;NORTE;4;0;4;1
2018-10-18 23:30:00;NORTE;2;0;2;1
2018-10-19 00:30:00;NORTE;3;0;3;1
2018-10-19 01:00:00;NORTE;2;0;2;1
2018-10-19 01:30:00;NORTE;2;0;2;1
2018-10-19 02:00:00;NORTE;1;0;1;1
2018-10-19 02:30:00;NORTE;6;0;6;1
2018-10-19 03:00:00;NORTE;2;0;2;1
2018-10-19 03:30:00;NORTE;7;0;7;1
2018-10-19 04:00:00;NORTE;8;0;8;1
2018-10-19 04:30:00;NORTE;12;0;12;1
2018-10-19 05:00:00;NORTE;17;0;17;1
2018-10-19 05:30:00;NORTE;39;0;39;1
2018-10-19 06:00:00;NORTE;15;0;15;1
2018-10-19 06:17:00;NORTE;14;0;14;1
2018-10-19 06:30:00;NORTE;25;0;25;1
2018-10-19 07:00:00;NORTE;41;0;41;1
2018-10-19 07:30:00;NORTE;31;0;31;1
2018-10-19 08:00:00;NORTE;36;0;36;1
2018-10-19 08:30:00;NORTE;32;0;32;1
2018-10-19 09:00:00;NORTE;32;0;32;1
2018-10-19 09:30:00;NORTE;26;0;26;1
2018-10-19 10:00:00;NORTE;37;0;37;1
2018-10-19 10:30:00;NORTE;41;0;41;1
2018-10-19 11:00:00;NORTE;38;0;38;1
2018-10-19 11:30:00;NORTE;28;0;28;1
2018-10-19 12:00:00;NORTE;31;0;31;1
2018-10-19 12:30:00;NORTE;39;0;39;1
2018-10-19 13:00:00;NORTE;40;0;40;1
2018-10-19 13:30:00;NORTE;36;0;36;1
2018-10-19 14:00:00;NORTE;42;0;42;1
2018-10-19 14:30:00;NORTE;38;0;38;1
2018-10-19 15:00:00;NORTE;20;0;20;1
2018-10-19 15:30:00;NORTE;24;0;24;1
2018-10-19 16:00:00;NORTE;24;0;24;1
2018-10-19 16:30:00;NORTE;33;0;33;1
2018-10-19 17:00:00;NORTE;29;0;29;1
2018-10-19 17:30:00;NORTE;34;0;34;1
2018-10-19 18:00:00;NORTE;38;0;38;1
2018-10-19 18:30:00;NORTE;36;0;36;1
2018-10-19 19:00:00;NORTE;30;0;30;1
2018-10-19 19:30:00;NORTE;35;0;35;1
2018-10-19 20:00:00;NORTE;34;0;34;1
2018-10-19 20:30:00;NORTE;29;0;29;1
2018-10-19 21:00:00;NORTE;16;0;16;1
2018-10-19 21:30:00;NORTE;12;0;12;1
2018-10-19 22:00:00;NORTE;13;0;13;1
2018-10-19 22:30:00;NORTE;3;0;3;1
2018-10-19 23:00:00;NORTE;1;0;1;1
2018-10-19 23:30:00;NORTE;1;0;1;1
2018-10-20 00:30:00;NORTE;1;0;1;1
2018-10-20 01:30:00;NORTE;1;0;1;1
2018-10-20 02:00:00;NORTE;3;0;3;1
2018-10-20 02:30:00;NORTE;2;0;2;1
2018-10-20 03:00:00;NORTE;2;0;2;1
2018-10-20 03:30:00;NORTE;3;0;3;1
2018-10-20 04:00:00;NORTE;12;0;12;1
2018-10-20 04:30:00;NORTE;12;0;12;1
2018-10-20 05:00:00;NORTE;14;0;14;1
2018-10-20 05:30:00;NORTE;36;0;36;1
2018-10-20 06:00:00;NORTE;15;0;15;1
2018-10-20 06:30:00;NORTE;27;0;27;1
2018-10-20 07:00:00;NORTE;35;0;35;1
2018-10-20 07:30:00;NORTE;33;0;33;1
2018-10-20 08:00:00;NORTE;39;0;39;1
2018-10-20 08:30:00;NORTE;36;0;36;1
2018-10-20 09:00:00;NORTE;20;0;20;1
2018-10-20 09:30:00;NORTE;28;0;28;1
2018-10-20 10:00:00;NORTE;31;0;31;1
2018-10-20 10:30:00;NORTE;37;0;37;1
2018-10-20 11:00:00;NORTE;35;0;35;1
2018-10-20 11:30:00;NORTE;22;0;22;1
2018-10-20 12:00:00;NORTE;29;0;29;1
2018-10-20 12:30:00;NORTE;35;0;35;1
2018-10-20 13:00:00;NORTE;31;0;31;1
2018-10-20 13:30:00;NORTE;26;0;26;1
2018-10-20 14:00:00;NORTE;33;0;33;1
2018-10-20 14:30:00;NORTE;31;0;31;1
2018-10-20 15:00:00;NORTE;35;0;35;1
2018-10-20 15:30:00;NORTE;18;0;18;1
2018-10-20 16:00:00;NORTE;23;0;23;1
2018-10-20 16:30:00;NORTE;22;0;22;1
2018-10-20 17:00:00;NORTE;6;0;6;1
2018-10-20 17:08:00;NORTE;10;0;10;1
2018-10-20 17:30:00;NORTE;23;0;23;1
2018-10-20 18:00:00;NORTE;35;0;35;1
2018-10-20 18:30:00;NORTE;22;0;22;1
2018-10-20 19:00:00;NORTE;25;0;25;1
2018-10-20 19:30:00;NORTE;18;0;18;1
2018-10-20 20:00:00;NORTE;25;0;25;1
2018-10-20 20:30:00;NORTE;12;0;12;1
2018-10-20 21:00:00;NORTE;11;0;11;1
2018-10-20 21:30:00;NORTE;13;0;13;1
2018-10-20 22:00:00;NORTE;10;0;10;1
2018-10-20 22:30:00;NORTE;3;0;3;1
2018-10-20 23:00:00;NORTE;1;0;1;1
2018-10-20 23:30:00;NORTE;2;0;2;1
2018-10-21 00:00:00;NORTE;1;0;1;1
2018-10-21 00:30:00;NORTE;4;0;4;1
2018-10-21 01:00:00;NORTE;2;0;2;1
2018-10-21 01:30:00;NORTE;2;0;2;1
2018-10-21 02:00:00;NORTE;3;0;3;1
2018-10-21 02:30:00;NORTE;2;0;2;1
2018-10-21 03:30:00;NORTE;8;0;8;1
2018-10-21 04:00:00;NORTE;5;0;5;1
2018-10-21 04:30:00;NORTE;7;0;7;1
2018-10-21 05:00:00;NORTE;14;0;14;1
2018-10-21 05:30:00;NORTE;36;0;36;1
2018-10-21 06:00:00;NORTE;15;0;15;1
2018-10-21 06:30:00;NORTE;21;0;21;1
2018-10-21 07:00:00;NORTE;27;0;27;1
2018-10-21 07:30:00;NORTE;33;0;33;1
2018-10-21 08:00:00;NORTE;39;0;39;1
2018-10-21 08:30:00;NORTE;32;0;32;1
2018-10-21 09:00:00;NORTE;22;0;22;1
2018-10-21 09:30:00;NORTE;34;0;34;1
2018-10-21 10:00:00;NORTE;34;0;34;1
2018-10-21 10:30:00;NORTE;37;0;37;1
2018-10-21 11:00:00;NORTE;29;0;29;1
2018-10-21 11:30:00;NORTE;37;0;37;1
2018-10-21 12:00:00;NORTE;26;0;26;1
2018-10-21 12:30:00;NORTE;33;0;33;1
2018-10-21 13:00:00;NORTE;32;0;32;1
2018-10-21 13:30:00;NORTE;36;0;36;1
2018-10-21 14:00:00;NORTE;43;0;43;1
2018-10-21 14:30:00;NORTE;30;0;30;1
2018-10-21 15:00:00;NORTE;25;0;25;1
2018-10-21 15:30:00;NORTE;25;0;25;1
2018-10-21 16:00:00;NORTE;21;0;21;1
2018-10-21 16:30:00;NORTE;32;0;32;1
2018-10-21 17:00:00;NORTE;21;0;21;1
2018-10-21 17:30:00;NORTE;34;0;34;1
2018-10-21 18:00:00;NORTE;36;0;36;1
2018-10-21 18:30:00;NORTE;31;0;31;1
2018-10-21 19:00:00;NORTE;33;0;33;1
2018-10-21 19:30:00;NORTE;25;0;25;1
2018-10-21 20:00:00;NORTE;37;0;37;1
2018-10-21 20:30:00;NORTE;30;0;30;1
2018-10-21 21:00:00;NORTE;14;0;14;1
2018-10-21 21:30:00;NORTE;18;0;18;1
2018-10-21 22:00:00;NORTE;12;0;12;1
2018-10-21 22:30:00;NORTE;7;0;7;1
2018-10-21 23:00:00;NORTE;3;0;3;1
2018-10-21 23:30:00;NORTE;4;0;4;1
2018-10-22 00:00:00;NORTE;1;0;1;1
2018-10-22 00:30:00;NORTE;1;0;1;1
2018-10-22 01:00:00;NORTE;1;0;1;1
2018-10-22 01:30:00;NORTE;2;0;2;1
2018-10-22 02:00:00;NORTE;5;0;5;1
2018-10-22 02:30:00;NORTE;2;0;2;1
2018-10-22 03:00:00;NORTE;3;0;3;1
2018-10-22 03:30:00;NORTE;2;0;2;1
2018-10-22 04:00:00;NORTE;9;0;9;1
2018-10-22 04:30:00;NORTE;9;0;9;1
2018-10-22 05:00:00;NORTE;15;0;15;1
2018-10-22 05:30:00;NORTE;44;0;44;1
2018-10-22 06:00:00;NORTE;21;0;21;1
2018-10-22 06:30:00;NORTE;28;0;28;1
2018-10-22 07:00:00;NORTE;33;0;33;1
2018-10-22 07:30:00;NORTE;31;0;31;1
2018-10-22 08:00:00;NORTE;35;0;35;1
2018-10-22 08:30:00;NORTE;36;0;36;1
2018-10-22 09:00:00;NORTE;27;0;27;1
2018-10-22 09:30:00;NORTE;28;0;28;1
2018-10-22 10:00:00;NORTE;36;0;36;1
2018-10-22 10:30:00;NORTE;36;0;36;1
2018-10-22 11:00:00;NORTE;33;0;33;1
2018-10-22 11:30:00;NORTE;22;0;22;1
2018-10-22 12:00:00;NORTE;29;0;29;1
2018-10-22 12:30:00;NORTE;28;0;28;1
2018-10-22 13:00:00;NORTE;28;0;28;1
2018-10-22 13:30:00;NORTE;32;0;32;1
2018-10-22 14:00:00;NORTE;42;0;42;1
2018-10-22 14:30:00;NORTE;27;0;27;1
2018-10-22 15:00:00;NORTE;33;0;33;1
2018-10-22 15:30:00;NORTE;31;0;31;1
2018-10-22 16:00:00;NORTE;21;0;21;1
2018-10-22 16:30:00;NORTE;33;0;33;1
2018-10-22 17:00:00;NORTE;23;0;23;1
2018-10-22 17:30:00;NORTE;36;0;36;1
2018-10-22 18:00:00;NORTE;32;0;32;1
2018-10-22 18:30:00;NORTE;35;0;35;1
2018-10-22 19:00:00;NORTE;31;0;31;1
2018-10-22 19:30:00;NORTE;28;0;28;1
2018-10-22 20:00:00;NORTE;38;0;38;1
2018-10-22 20:30:00;NORTE;17;0;17;1
2018-10-22 21:00:00;NORTE;14;0;14;1
2018-10-22 21:30:00;NORTE;16;0;16;1
2018-10-22 22:00:00;NORTE;11;0;11;1
2018-10-22 22:30:00;NORTE;5;0;5;1
2018-10-22 23:00:00;NORTE;1;0;1;1
2018-10-22 23:30:00;NORTE;1;0;1;1
2018-10-23 00:00:00;NORTE;2;0;2;1
2018-10-23 01:00:00;NORTE;1;0;1;1
2018-10-23 01:30:00;NORTE;1;0;1;1
2018-10-23 02:00:00;NORTE;5;0;5;1
2018-10-23 02:30:00;NORTE;4;0;4;1
2018-10-23 03:00:00;NORTE;4;0;4;1
2018-10-23 03:30:00;NORTE;7;0;7;1
2018-10-23 04:00:00;NORTE;7;0;7;1
2018-10-23 04:30:00;NORTE;15;0;15;1
2018-10-23 05:00:00;NORTE;18;0;18;1
2018-10-23 05:30:00;NORTE;41;0;41;1
2018-10-23 06:00:00;NORTE;23;0;23;1
2018-10-23 06:30:00;NORTE;22;0;22;1
2018-10-23 07:00:00;NORTE;40;0;40;1
2018-10-23 07:30:00;NORTE;28;0;28;1
2018-10-23 08:00:00;NORTE;33;0;33;1
2018-10-23 08:30:00;NORTE;37;0;37;1
2018-10-23 09:00:00;NORTE;18;0;18;1
2018-10-23 09:30:00;NORTE;35;0;35;1
2018-10-23 10:00:00;NORTE;34;0;34;1
2018-10-23 10:30:00;NORTE;39;0;39;1
2018-10-23 11:00:00;NORTE;25;0;25;1
2018-10-23 11:30:00;NORTE;28;0;28;1
2018-10-23 12:00:00;NORTE;24;0;24;1
2018-10-23 12:30:00;NORTE;32;0;32;1
2018-10-23 13:00:00;NORTE;33;0;33;1
2018-10-23 13:30:00;NORTE;26;0;26;1
2018-10-23 14:00:00;NORTE;14;0;14;1
2018-10-23 14:30:00;NORTE;25;0;25;1
2018-10-23 15:00:00;NORTE;18;0;18;1
2018-10-23 15:30:00;NORTE;23;0;23;1
2018-10-23 16:00:00;NORTE;23;0;23;1
2018-10-23 16:30:00;NORTE;33;0;33;1
2018-10-23 17:00:00;NORTE;18;0;18;1
2018-10-23 17:30:00;NORTE;33;0;33;1
2018-10-23 18:00:00;NORTE;43;0;43;1
2018-10-23 18:30:00;NORTE;32;0;32;1
2018-10-23 19:00:00;NORTE;32;0;32;1
2018-10-23 19:30:00;NORTE;31;0;31;1
2018-10-23 20:00:00;NORTE;37;0;37;1
2018-10-23 20:30:00;NORTE;26;0;26;1
2018-10-23 21:00:00;NORTE;13;0;13;1
2018-10-23 21:30:00;NORTE;11;0;11;1
2018-10-23 22:00:00;NORTE;12;0;12;1
2018-10-23 22:30:00;NORTE;5;0;5;1
2018-10-23 23:00:00;NORTE;1;0;1;1
2018-10-23 23:30:00;NORTE;1;0;1;1
2018-10-24 00:00:00;NORTE;2;0;2;1
2018-10-24 01:00:00;NORTE;2;0;2;1
2018-10-24 02:00:00;NORTE;3;0;3;1
2018-10-24 02:30:00;NORTE;4;0;4;1
2018-10-24 03:00:00;NORTE;2;0;2;1
2018-10-24 03:30:00;NORTE;8;0;8;1
2018-10-24 04:00:00;NORTE;9;0;9;1
2018-10-24 04:30:00;NORTE;13;0;13;1
2018-10-24 05:00:00;NORTE;19;0;19;1
2018-10-24 05:30:00;NORTE;38;0;38;1
2018-10-24 06:00:00;NORTE;21;0;21;1
2018-10-24 06:30:00;NORTE;30;0;30;1
2018-10-24 07:00:00;NORTE;34;0;34;1
2018-10-24 07:30:00;NORTE;30;0;30;1
2018-10-24 08:00:00;NORTE;34;0;34;1
2018-10-24 08:30:00;NORTE;34;0;34;1
2018-10-24 09:00:00;NORTE;25;0;25;1
2018-10-24 09:30:00;NORTE;31;0;31;1
2018-10-24 10:00:00;NORTE;39;0;39;1
2018-10-24 10:30:00;NORTE;29;0;29;1
2018-10-24 11:00:00;NORTE;36;0;36;1
2018-10-24 11:30:00;NORTE;26;0;26;1
2018-10-24 12:00:00;NORTE;33;0;33;1
2018-10-24 12:30:00;NORTE;29;0;29;1
2018-10-24 13:00:00;CONFLICTIVA;14;9;23;2
2018-10-24 13:30:00;SUR;0;33;33;1
2018-10-24 14:00:00;SUR;0;36;36;1
2018-10-24 14:30:00;SUR;0;36;36;1
2018-10-24 15:00:00;SUR;0;26;26;1
2018-10-24 15:30:00;CONFLICTIVA;10;11;21;2
2018-10-24 16:00:00;NORTE;23;0;23;1
2018-10-24 16:30:00;NORTE;31;0;31;1
2018-10-24 17:00:00;NORTE;26;0;26;1
2018-10-24 17:30:00;NORTE;41;0;41;1
2018-10-24 18:00:00;NORTE;34;0;34;1
2018-10-24 18:30:00;NORTE;29;0;29;1
2018-10-24 19:00:00;NORTE;32;0;32;1
2018-10-24 19:30:00;NORTE;31;0;31;1
2018-10-24 20:00:00;NORTE;34;0;34;1
2018-10-24 20:30:00;NORTE;20;0;20;1
2018-10-24 21:00:00;NORTE;14;0;14;1
2018-10-24 21:30:00;NORTE;14;0;14;1
2018-10-24 22:00:00;NORTE;13;0;13;1
2018-10-24 22:30:00;NORTE;2;0;2;1
2018-10-25 00:00:00;NORTE;1;0;1;1
2018-10-25 00:30:00;NORTE;1;0;1;1
2018-10-25 01:00:00;NORTE;1;0;1;1
2018-10-25 01:30:00;NORTE;1;0;1;1
2018-10-25 02:00:00;NORTE;6;0;6;1
2018-10-25 02:30:00;NORTE;2;0;2;1
2018-10-25 03:00:00;NORTE;3;0;3;1
2018-10-25 03:30:00;NORTE;7;0;7;1
2018-10-25 04:00:00;NORTE;10;0;10;1
2018-10-25 04:30:00;NORTE;10;0;10;1
2018-10-25 05:00:00;NORTE;17;0;17;1
2018-10-25 05:30:00;NORTE;44;0;44;1
2018-10-25 06:00:00;NORTE;12;0;12;1
2018-10-25 06:30:00;NORTE;23;0;23;1
2018-10-25 07:00:00;NORTE;38;0;38;1
2018-10-25 07:30:00;NORTE;34;0;34;1
2018-10-25 08:00:00;NORTE;29;0;29;1
2018-10-25 08:30:00;NORTE;35;0;35;1
2018-10-25 09:00:00;NORTE;24;0;24;1
2018-10-25 09:30:00;NORTE;30;0;30;1
2018-10-25 10:00:00;NORTE;36;0;36;1
2018-10-25 10:30:00;NORTE;35;0;35;1
2018-10-25 11:00:00;NORTE;36;0;36;1
2018-10-25 11:30:00;NORTE;25;0;25;1
2018-10-25 12:00:00;NORTE;25;0;25;1
2018-10-25 12:30:00;NORTE;34;0;34;1
2018-10-25 13:00:00;NORTE;39;0;39;1
2018-10-25 13:30:00;NORTE;38;0;38;1
2018-10-25 14:00:00;NORTE;35;0;35;1
2018-10-25 14:30:00;NORTE;31;0;31;1
2018-10-25 15:00:00;NORTE;29;0;29;1
2018-10-25 15:30:00;NORTE;23;0;23;1
2018-10-25 16:00:00;NORTE;15;0;15;1
2018-10-25 16:30:00;NORTE;38;0;38;1
2018-10-25 17:00:00;NORTE;31;0;31;1
2018-10-25 17:30:00;NORTE;26;0;26;1
2018-10-25 18:00:00;NORTE;39;0;39;1
2018-10-25 18:30:00;NORTE;32;0;32;1
2018-10-25 19:00:00;NORTE;29;0;29;1
2018-10-25 19:30:00;NORTE;32;0;32;1
2018-10-25 20:00:00;NORTE;33;0;33;1
2018-10-25 20:30:00;NORTE;25;0;25;1
2018-10-25 21:00:00;NORTE;17;0;17;1
2018-10-25 21:30:00;NORTE;14;0;14;1
2018-10-25 22:00:00;NORTE;13;0;13;1
2018-10-25 22:30:00;NORTE;6;0;6;1
2018-10-25 23:00:00;NORTE;2;0;2;1
2018-10-25 23:30:00;NORTE;2;0;2;1
2018-10-26 00:30:00;NORTE;3;0;3;1
2018-10-26 01:00:00;NORTE;1;0;1;1
2018-10-26 01:30:00;NORTE;3;0;3;1
2018-10-26 02:00:00;NORTE;5;0;5;1
2018-10-26 02:30:00;NORTE;3;0;3;1
2018-10-26 03:00:00;NORTE;3;0;3;1
2018-10-26 03:30:00;NORTE;11;0;11;1
2018-10-26 04:00:00;NORTE;9;0;9;1
2018-10-26 04:30:00;NORTE;12;0;12;1
2018-10-26 05:00:00;NORTE;15;0;15;1
2018-10-26 05:30:00;NORTE;38;0;38;1
2018-10-26 06:00:00;NORTE;22;0;22;1
2018-10-26 06:30:00;NORTE;26;0;26;1
2018-10-26 07:00:00;NORTE;29;0;29;1
2018-10-26 07:30:00;NORTE;28;0;28;1
2018-10-26 08:00:00;NORTE;38;0;38;1
2018-10-26 08:30:00;NORTE;28;0;28;1
2018-10-26 09:00:00;NORTE;27;0;27;1
2018-10-26 09:30:00;NORTE;22;0;22;1
2018-10-26 10:00:00;NORTE;34;0;34;1
2018-10-26 10:30:00;NORTE;32;0;32;1
2018-10-26 11:00:00;NORTE;36;0;36;1
2018-10-26 11:30:00;NORTE;26;0;26;1
2018-10-26 12:00:00;NORTE;33;0;33;1
2018-10-26 12:30:00;NORTE;32;0;32;1
2018-10-26 13:00:00;NORTE;30;0;30;1
2018-10-26 13:30:00;NORTE;31;0;31;1
2018-10-26 14:00:00;NORTE;37;0;37;1
2018-10-26 14:30:00;NORTE;36;0;36;1
2018-10-26 15:00:00;NORTE;26;0;26;1
2018-10-26 15:30:00;NORTE;23;0;23;1
2018-10-26 16:00:00;NORTE;17;0;17;1
2018-10-26 16:30:00;NORTE;35;0;35;1
2018-10-26 17:00:00;NORTE;21;0;21;1
2018-10-26 17:30:00;NORTE;30;0;30;1
2018-10-26 18:00:00;NORTE;41;0;41;1
2018-10-26 18:30:00;NORTE;28;0;28;1
2018-10-26 19:00:00;NORTE;33;0;33;1
2018-10-26 19:30:00;NORTE;25;0;25;1
2018-10-26 20:00:00;NORTE;36;0;36;1
2018-10-26 20:30:00;NORTE;36;0;36;1
2018-10-26 21:00:00;NORTE;17;0;17;1
2018-10-26 21:30:00;NORTE;16;0;16;1
2018-10-26 22:00:00;NORTE;11;0;11;1
2018-10-26 22:30:00;NORTE;7;0;7;1
2018-10-26 23:00:00;NORTE;2;0;2;1
2018-10-26 23:30:00;NORTE;1;0;1;1
2018-10-27 00:00:00;NORTE;1;0;1;1
2018-10-27 00:30:00;NORTE;1;0;1;1
2018-10-27 01:30:00;NORTE;1;0;1;1
2018-10-27 02:00:00;NORTE;3;0;3;1
2018-10-27 02:30:00;NORTE;2;0;2;1
2018-10-27 03:00:00;NORTE;3;0;3;1
2018-10-27 03:30:00;NORTE;5;0;5;1
2018-10-27 04:00:00;NORTE;7;0;7;1
2018-10-27 04:30:00;NORTE;14;0;14;1
2018-10-27 05:00:00;NORTE;14;0;14;1
2018-10-27 05:30:00;NORTE;32;0;32;1
2018-10-27 06:00:00;NORTE;23;0;23;1
2018-10-27 06:30:00;NORTE;18;0;18;1
2018-10-27 07:00:00;NORTE;34;0;34;1
2018-10-27 07:30:00;NORTE;33;0;33;1
2018-10-27 08:00:00;NORTE;35;0;35;1
2018-10-27 08:30:00;NORTE;32;0;32;1
2018-10-27 09:00:00;NORTE;17;0;17;1
2018-10-27 09:30:00;NORTE;35;0;35;1
2018-10-27 10:00:00;NORTE;31;0;31;1
2018-10-27 10:30:00;NORTE;26;0;26;1
2018-10-27 11:00:00;NORTE;33;0;33;1
2018-10-27 11:30:00;NORTE;23;0;23;1
2018-10-27 12:00:00;NORTE;24;0;24;1
2018-10-27 12:30:00;NORTE;32;0;32;1
2018-10-27 13:00:00;NORTE;32;0;32;1
2018-10-27 13:30:00;NORTE;27;0;27;1
2018-10-27 14:00:00;NORTE;29;0;29;1
2018-10-27 14:30:00;NORTE;31;0;31;1
2018-10-27 15:00:00;NORTE;27;0;27;1
2018-10-27 15:30:00;NORTE;21;0;21;1
2018-10-27 16:00:00;NORTE;13;0;13;1
2018-10-27 16:30:00;NORTE;23;0;23;1
2018-10-27 17:00:00;NORTE;19;0;19;1
2018-10-27 17:30:00;NORTE;22;0;22;1
2018-10-27 18:00:00;NORTE;30;0;30;1
2018-10-27 18:30:00;NORTE;27;0;27;1
2018-10-27 19:00:00;NORTE;27;0;27;1
2018-10-27 19:30:00;NORTE;18;0;18;1
2018-10-27 20:00:00;NORTE;19;0;19;1
2018-10-27 20:30:00;NORTE;22;0;22;1
2018-10-27 21:00:00;NORTE;15;0;15;1
2018-10-27 21:30:00;NORTE;11;0;11;1
2018-10-27 22:00:00;NORTE;15;0;15;1
2018-10-27 22:30:00;NORTE;10;0;10;1
2018-10-27 23:00:00;NORTE;1;0;1;1
2018-10-27 23:30:00;NORTE;1;0;1;1
2018-10-28 01:00:00;NORTE;5;0;5;1
2018-10-28 01:30:00;NORTE;4;0;4;1
2018-10-28 02:30:00;NORTE;1;0;1;1
2018-10-28 03:00:00;NORTE;2;0;2;1
2018-10-28 03:30:00;NORTE;1;0;1;1
2018-10-28 04:00:00;NORTE;3;0;3;1
2018-10-28 04:30:00;NORTE;6;0;6;1
2018-10-28 05:00:00;NORTE;5;0;5;1
2018-10-28 05:30:00;NORTE;8;0;8;1
2018-10-28 06:00:00;NORTE;23;0;23;1
2018-10-28 06:30:00;NORTE;20;0;20;1
2018-10-28 07:00:00;NORTE;7;0;7;1
2018-10-28 07:30:00;NORTE;17;0;17;1
2018-10-28 08:00:00;NORTE;28;0;28;1
2018-10-28 08:30:00;NORTE;24;0;24;1
2018-10-28 09:00:00;NORTE;30;0;30;1
2018-10-28 09:30:00;NORTE;33;0;33;1
2018-10-28 10:00:00;NORTE;28;0;28;1
2018-10-28 10:30:00;NORTE;32;0;32;1
2018-10-28 11:00:00;NORTE;34;0;34;1
2018-10-28 11:30:00;NORTE;36;0;36;1
2018-10-28 12:00:00;NORTE;27;0;27;1
2018-10-28 12:30:00;NORTE;25;0;25;1
2018-10-28 13:00:00;NORTE;23;0;23;1
2018-10-28 13:30:00;NORTE;35;0;35;1
2018-10-28 14:00:00;NORTE;33;0;33;1
2018-10-28 14:30:00;NORTE;34;0;34;1
2018-10-28 15:00:00;NORTE;38;0;38;1
2018-10-28 15:30:00;NORTE;26;0;26;1
2018-10-28 16:00:00;NORTE;21;0;21;1
2018-10-28 16:30:00;NORTE;19;0;19;1
2018-10-28 17:00:00;NORTE;22;0;22;1
2018-10-28 17:30:00;NORTE;26;0;26;1
2018-10-28 18:00:00;NORTE;33;0;33;1
2018-10-28 18:30:00;NORTE;21;0;21;1
2018-10-28 19:00:00;NORTE;35;0;35;1
2018-10-28 19:30:00;NORTE;31;0;31;1
2018-10-28 20:00:00;NORTE;29;0;29;1
2018-10-28 20:30:00;NORTE;26;0;26;1
2018-10-28 21:00:00;NORTE;35;0;35;1
2018-10-28 21:30:00;NORTE;32;0;32;1
2018-10-28 22:00:00;NORTE;19;0;19;1
2018-10-28 22:30:00;NORTE;12;0;12;1
2018-10-28 23:00:00;NORTE;12;0;12;1
2018-10-28 23:30:00;NORTE;11;0;11;1
2018-10-29 00:00:00;NORTE;4;0;4;1
2018-10-29 00:30:00;NORTE;3;0;3;1
2018-10-29 01:00:00;NORTE;2;0;2;1
2018-10-29 01:30:00;NORTE;1;0;1;1
2018-10-29 02:00:00;NORTE;1;0;1;1
2018-10-29 02:30:00;NORTE;3;0;3;1
2018-10-29 03:00:00;NORTE;3;0;3;1
2018-10-29 03:30:00;NORTE;5;0;5;1
2018-10-29 04:30:00;NORTE;4;0;4;1
2018-10-29 05:00:00;NORTE;12;0;12;1
2018-10-29 05:30:00;NORTE;14;0;14;1
2018-10-29 06:00:00;NORTE;12;0;12;1
2018-10-29 06:30:00;NORTE;36;0;36;1
2018-10-29 07:00:00;NORTE;16;0;16;1
2018-10-29 07:30:00;NORTE;27;0;27;1
2018-10-29 08:00:00;NORTE;32;0;32;1
2018-10-29 08:30:00;NORTE;27;1;28;1
2018-10-29 09:00:00;NORTE;36;0;36;1
2018-10-29 09:30:00;NORTE;35;0;35;1
2018-10-29 10:00:00;NORTE;19;0;19;1
2018-10-29 10:30:00;NORTE;39;0;39;1
2018-10-29 11:00:00;NORTE;35;0;35;1
2018-10-29 11:30:00;NORTE;35;0;35;1
2018-10-29 12:00:00;NORTE;24;0;24;1
2018-10-29 12:30:00;NORTE;25;0;25;1
2018-10-29 13:00:00;NORTE;28;0;28;1
2018-10-29 13:30:00;NORTE;27;0;27;1
2018-10-29 14:00:00;NORTE;40;0;40;1
2018-10-29 14:30:00;NORTE;33;0;33;1
2018-10-29 15:00:00;NORTE;35;0;35;1
2018-10-29 15:30:00;NORTE;25;0;25;1
2018-10-29 16:00:00;NORTE;22;0;22;1
2018-10-29 16:30:00;NORTE;18;0;18;1
2018-10-29 17:00:00;NORTE;24;0;24;1
2018-10-29 17:30:00;NORTE;36;0;36;1
2018-10-29 18:00:00;NORTE;33;0;33;1
2018-10-29 18:30:00;NORTE;31;0;31;1
2018-10-29 19:00:00;NORTE;42;0;42;1
2018-10-29 19:30:00;NORTE;33;0;33;1
2018-10-29 20:00:00;NORTE;23;0;23;1
2018-10-29 20:30:00;NORTE;31;0;31;1
2018-10-29 21:00:00;NORTE;25;0;25;1
2018-10-29 21:30:00;NORTE;23;0;23;1
2018-10-29 22:00:00;NORTE;18;0;18;1
2018-10-29 22:30:00;NORTE;12;0;12;1
2018-10-29 23:00:00;NORTE;15;0;15;1
2018-10-29 23:30:00;NORTE;5;0;5;1
2018-10-30 00:00:00;NORTE;1;0;1;1
2018-10-30 00:30:00;NORTE;1;0;1;1
2018-10-30 01:00:00;NORTE;1;0;1;1
2018-10-30 02:30:00;NORTE;1;0;1;1
2018-10-30 03:00:00;NORTE;4;0;4;1
2018-10-30 03:30:00;NORTE;5;0;5;1
2018-10-30 04:00:00;NORTE;3;0;3;1
2018-10-30 04:30:00;SUR;0;7;7;1
2018-10-30 05:00:00;SUR;0;11;11;1
2018-10-30 05:30:00;SUR;0;15;15;1
2018-10-30 06:00:00;SUR;0;20;20;1
2018-10-30 06:30:00;SUR;0;36;36;1
2018-10-30 07:00:00;SUR;0;23;23;1
2018-10-30 07:30:00;SUR;0;16;16;1
2018-10-30 08:00:00;SUR;0;30;30;1
2018-10-30 08:30:00;SUR;0;27;27;1
2018-10-30 09:00:00;SUR;0;36;36;1
2018-10-30 09:30:00;SUR;0;30;30;1
2018-10-30 10:00:00;SUR;0;30;30;1
2018-10-30 10:30:00;SUR;0;23;23;1
2018-10-30 11:00:00;SUR;0;36;36;1
2018-10-30 11:30:00;SUR;0;31;31;1
2018-10-30 12:00:00;SUR;0;32;32;1
2018-10-30 12:30:00;SUR;0;28;28;1
2018-10-30 13:00:00;SUR;0;26;26;1
2018-10-30 13:30:00;SUR;0;27;27;1
2018-10-30 14:00:00;SUR;0;16;16;1
2018-10-30 14:14:00;SUR;0;16;16;1
2018-10-30 14:30:00;SUR;0;35;35;1
2018-10-30 15:00:00;SUR;0;38;38;1
2018-10-30 15:30:00;SUR;0;28;28;1
2018-10-30 16:00:00;SUR;0;34;34;1
2018-10-30 16:30:00;SUR;0;24;24;1
2018-10-30 17:00:00;SUR;0;16;16;1
2018-10-30 17:30:00;SUR;0;31;31;1
2018-10-30 18:00:00;SUR;0;29;29;1
2018-10-30 18:30:00;SUR;0;24;24;1
2018-10-30 19:00:00;SUR;0;41;41;1
2018-10-30 19:30:00;SUR;0;32;32;1
2018-10-30 20:00:00;SUR;0;15;15;1
2018-10-30 20:30:00;SUR;0;26;26;1
2018-10-30 21:00:00;SUR;0;26;26;1
2018-10-30 21:30:00;SUR;0;23;23;1
2018-10-30 22:00:00;SUR;0;13;13;1
2018-10-30 22:30:00;SUR;0;6;6;1
2018-10-30 23:00:00;SUR;0;12;12;1
2018-10-30 23:30:00;SUR;0;8;8;1
2018-10-31 00:00:00;NORTE;1;0;1;1
2018-10-31 00:30:00;NORTE;1;0;1;1
2018-10-31 01:00:00;NORTE;1;0;1;1
2018-10-31 02:00:00;NORTE;2;0;2;1
2018-10-31 03:00:00;NORTE;4;0;4;1
2018-10-31 03:30:00;NORTE;2;0;2;1
2018-10-31 04:00:00;NORTE;4;0;4;1
2018-10-31 04:30:00;NORTE;6;0;6;1
2018-10-31 05:00:00;NORTE;4;0;4;1
2018-10-31 05:11:00;NORTE;7;0;7;1
2018-10-31 05:30:00;NORTE;15;0;15;1
2018-10-31 06:00:00;NORTE;20;0;20;1
2018-10-31 06:30:00;NORTE;10;0;10;1
2018-10-31 06:39:00;NORTE;27;0;27;1
2018-10-31 07:00:00;NORTE;9;0;9;1
2018-10-31 07:19:00;NORTE;10;0;10;1
2018-10-31 07:30:00;NORTE;23;0;23;1
2018-10-31 08:00:00;NORTE;38;0;38;1
2018-10-31 08:30:00;NORTE;18;0;18;1
2018-10-31 09:00:00;NORTE;44;0;44;1
2018-10-31 09:30:00;NORTE;28;0;28;1
2018-10-31 10:00:00;NORTE;22;0;22;1
2018-10-31 10:30:00;NORTE;40;0;40;1
2018-10-31 11:00:00;NORTE;37;0;37;1
2018-10-31 11:30:00;NORTE;31;0;31;1
2018-10-31 12:00:00;NORTE;27;0;27;1
2018-10-31 12:30:00;NORTE;31;0;31;1
2018-10-31 13:00:00;SUR;2;28;30;1
2018-10-31 13:30:00;SUR;0;29;29;1
2018-10-31 14:00:00;SUR;0;33;33;1
2018-10-31 14:30:00;SUR;0;32;32;1
2018-10-31 15:00:00;SUR;0;37;37;1
2018-10-31 15:30:00;SUR;0;28;28;1
2018-10-31 16:00:00;SUR;0;22;22;1
2018-10-31 16:30:00;SUR;0;15;15;1
2018-10-31 17:00:00;SUR;0;20;20;1
2018-10-31 17:30:00;SUR;0;31;31;1
2018-10-31 18:00:00;SUR;0;24;24;1
2018-10-31 18:30:00;CONFLICTIVA;17;9;26;2
2018-10-31 19:00:00;NORTE;38;0;38;1
2018-10-31 19:30:00;NORTE;31;0;31;1
2018-10-31 20:00:00;NORTE;23;0;23;1
2018-10-31 20:30:00;NORTE;26;0;26;1
2018-10-31 21:00:00;NORTE;40;0;40;1
2018-10-31 21:30:00;NORTE;28;0;28;1
2018-10-31 22:00:00;NORTE;12;0;12;1
2018-10-31 22:30:00;NORTE;9;0;9;1
2018-10-31 23:00:00;NORTE;13;0;13;1
2018-10-31 23:30:00;NORTE;9;0;9;1
2018-11-01 00:00:00;NORTE;1;0;1;1
2018-11-01 00:30:00;NORTE;1;0;1;1
2018-11-01 01:00:00;NORTE;1;0;1;1
2018-11-01 01:30:00;NORTE;2;0;2;1
2018-11-01 02:00:00;NORTE;1;0;1;1
2018-11-01 02:30:00;NORTE;1;0;1;1
2018-11-01 03:00:00;NORTE;1;0;1;1
2018-11-01 03:30:00;NORTE;4;0;4;1
2018-11-01 04:00:00;NORTE;6;0;6;1
2018-11-01 04:30:00;NORTE;6;0;6;1
2018-11-01 05:00:00;NORTE;11;0;11;1
2018-11-01 05:30:00;NORTE;17;0;17;1
2018-11-01 06:00:00;NORTE;19;0;19;1
2018-11-01 06:30:00;NORTE;32;0;32;1
2018-11-01 07:00:00;NORTE;11;0;11;1
2018-11-01 07:17:00;NORTE;7;0;7;1
2018-11-01 07:30:00;NORTE;18;0;18;1
2018-11-01 08:00:00;NORTE;32;0;32;1
2018-11-01 08:30:00;NORTE;27;0;27;1
2018-11-01 09:00:00;NORTE;39;0;39;1
2018-11-01 09:30:00;NORTE;30;0;30;1
2018-11-01 10:00:00;NORTE;22;0;22;1
2018-11-01 10:30:00;NORTE;29;0;29;1
2018-11-01 11:00:00;NORTE;44;0;44;1
2018-11-01 11:30:00;NORTE;27;0;27;1
2018-11-01 12:00:00;NORTE;33;0;33;1
2018-11-01 12:30:00;NORTE;31;0;31;1
2018-11-01 13:00:00;NORTE;25;0;25;1
2018-11-01 13:30:00;NORTE;35;0;35;1
2018-11-01 14:00:00;NORTE;34;0;34;1
2018-11-01 14:30:00;NORTE;30;0;30;1
2018-11-01 15:00:00;NORTE;43;0;43;1
2018-11-01 15:30:00;NORTE;25;0;25;1
2018-11-01 16:00:00;NORTE;25;0;25;1
2018-11-01 16:30:00;NORTE;20;0;20;1
2018-11-01 17:00:00;NORTE;25;0;25;1
2018-11-01 17:30:00;NORTE;33;0;33;1
2018-11-01 18:00:00;NORTE;28;0;28;1
2018-11-01 18:30:00;NORTE;34;0;34;1
2018-11-01 19:00:00;NORTE;32;0;32;1
2018-11-01 19:30:00;NORTE;34;0;34;1
2018-11-01 20:00:00;NORTE;31;0;31;1
2018-11-01 20:30:00;NORTE;24;0;24;1
2018-11-01 21:00:00;NORTE;25;0;25;1
2018-11-01 21:30:00;NORTE;29;0;29;1
2018-11-01 22:00:00;NORTE;14;0;14;1
2018-11-01 22:30:00;NORTE;5;0;5;1
2018-11-01 23:00:00;CONFLICTIVA;9;1;10;2
2018-11-01 23:30:00;NORTE;3;0;3;1
2018-11-02 00:00:00;NORTE;1;0;1;1
2018-11-02 00:30:00;NORTE;1;0;1;1
2018-11-02 01:30:00;NORTE;1;0;1;1
2018-11-02 02:30:00;NORTE;2;0;2;1
2018-11-02 03:00:00;NORTE;1;0;1;1
2018-11-02 03:30:00;NORTE;4;0;4;1
2018-11-02 04:00:00;NORTE;7;0;7;1
2018-11-02 04:30:00;NORTE;3;0;3;1
2018-11-02 05:00:00;NORTE;12;0;12;1
2018-11-02 05:30:00;NORTE;13;0;13;1
2018-11-02 06:00:00;NORTE;20;0;20;1
2018-11-02 06:30:00;NORTE;32;0;32;1
2018-11-02 07:00:00;NORTE;16;0;16;1
2018-11-02 07:30:00;NORTE;23;0;23;1
2018-11-02 08:00:00;NORTE;34;0;34;1
2018-11-02 08:30:00;NORTE;30;0;30;1
2018-11-02 09:00:00;NORTE;37;0;37;1
2018-11-02 09:30:00;NORTE;31;0;31;1
2018-11-02 10:00:00;NORTE;19;0;19;1
2018-11-02 10:30:00;NORTE;38;0;38;1
2018-11-02 11:00:00;NORTE;37;0;37;1
2018-11-02 11:30:00;NORTE;28;0;28;1
2018-11-02 12:00:00;NORTE;27;0;27;1
2018-11-02 12:30:00;NORTE;26;0;26;1
2018-11-02 13:00:00;NORTE;30;0;30;1
2018-11-02 13:30:00;NORTE;29;0;29;1
2018-11-02 14:00:00;NORTE;39;0;39;1
2018-11-02 14:30:00;NORTE;26;0;26;1
2018-11-02 15:00:00;NORTE;36;0;36;1
2018-11-02 15:30:00;NORTE;32;0;32;1
2018-11-02 16:00:00;NORTE;29;0;29;1
2018-11-02 16:30:00;NORTE;19;0;19;1
2018-11-02 17:00:00;NORTE;28;0;28;1
2018-11-02 17:30:00;NORTE;27;0;27;1
2018-11-02 18:00:00;NORTE;33;0;33;1
2018-11-02 18:30:00;NORTE;31;0;31;1
2018-11-02 19:00:00;NORTE;38;0;38;1
2018-11-02 19:30:00;NORTE;30;0;30;1
2018-11-02 20:00:00;NORTE;24;0;24;1
2018-11-02 20:30:00;NORTE;25;0;25;1
2018-11-02 21:00:00;NORTE;28;0;28;1
2018-11-02 21:30:00;NORTE;23;0;23;1
2018-11-02 22:00:00;NORTE;7;0;7;1
2018-11-02 22:30:00;NORTE;7;0;7;1
2018-11-02 23:00:00;NORTE;13;0;13;1
2018-11-02 23:30:00;NORTE;4;0;4;1
2018-11-03 02:00:00;NORTE;1;0;1;1
2018-11-03 02:30:00;NORTE;2;0;2;1
2018-11-03 03:00:00;NORTE;1;0;1;1
2018-11-03 03:30:00;NORTE;5;0;5;1
2018-11-03 04:00:00;NORTE;4;0;4;1
2018-11-03 04:30:00;NORTE;6;0;6;1
2018-11-03 05:00:00;NORTE;9;0;9;1
2018-11-03 05:30:00;NORTE;10;0;10;1
2018-11-03 06:00:00;NORTE;24;0;24;1
2018-11-03 06:30:00;NORTE;25;0;25;1
2018-11-03 07:00:00;NORTE;19;0;19;1
2018-11-03 07:30:00;NORTE;24;0;24;1
2018-11-03 08:00:00;NORTE;30;0;30;1
2018-11-03 08:30:00;NORTE;27;0;27;1
2018-11-03 09:00:00;NORTE;38;0;38;1
2018-11-03 09:30:00;NORTE;28;0;28;1
2018-11-03 10:00:00;NORTE;22;0;22;1
2018-11-03 10:30:00;NORTE;35;0;35;1
2018-11-03 11:00:00;NORTE;32;0;32;1
2018-11-03 11:30:00;NORTE;29;0;29;1
2018-11-03 12:00:00;NORTE;24;0;24;1
2018-11-03 12:30:00;NORTE;31;0;31;1
2018-11-03 13:00:00;NORTE;31;0;31;1
2018-11-03 13:30:00;NORTE;27;0;27;1
2018-11-03 14:00:00;NORTE;29;0;29;1
2018-11-03 14:30:00;NORTE;28;0;28;1
2018-11-03 15:00:00;NORTE;33;0;33;1
2018-11-03 15:30:00;NORTE;29;0;29;1
2018-11-03 16:00:00;NORTE;21;0;21;1
2018-11-03 16:30:00;NORTE;16;0;16;1
2018-11-03 17:00:00;NORTE;18;0;18;1
2018-11-03 17:30:00;NORTE;32;0;32;1
2018-11-03 18:00:00;NORTE;14;0;14;1
2018-11-03 18:30:00;NORTE;21;0;21;1
2018-11-03 19:00:00;NORTE;36;0;36;1
2018-11-03 19:30:00;NORTE;21;0;21;1
2018-11-03 20:00:00;NORTE;21;0;21;1
2018-11-03 20:30:00;NORTE;20;0;20;1
2018-11-03 21:00:00;NORTE;14;0;14;1
2018-11-03 21:30:00;NORTE;15;0;15;1
2018-11-03 22:00:00;NORTE;12;0;12;1
2018-11-03 22:30:00;NORTE;4;0;4;1
2018-11-03 23:00:00;NORTE;13;0;13;1
2018-11-03 23:30:00;NORTE;2;0;2;1
2018-11-04 01:00:00;NORTE;2;0;2;1
2018-11-04 01:30:00;NORTE;2;0;2;1
2018-11-04 02:00:00;NORTE;1;0;1;1
2018-11-04 02:30:00;NORTE;2;0;2;1
2018-11-04 03:00:00;NORTE;2;0;2;1
2018-11-04 03:30:00;NORTE;2;0;2;1
2018-11-04 04:00:00;NORTE;3;0;3;1
2018-11-04 04:30:00;NORTE;3;0;3;1
2018-11-04 05:00:00;NORTE;7;0;7;1
2018-11-04 05:30:00;NORTE;11;0;11;1
2018-11-04 06:00:00;NORTE;22;0;22;1
2018-11-04 06:30:00;NORTE;23;0;23;1
2018-11-04 07:00:00;NORTE;13;0;13;1
2018-11-04 07:30:00;NORTE;15;0;15;1
2018-11-04 08:00:00;NORTE;26;0;26;1
2018-11-04 08:30:00;NORTE;29;0;29;1
2018-11-04 09:00:00;NORTE;34;0;34;1
2018-11-04 09:30:00;NORTE;28;0;28;1
2018-11-04 10:00:00;NORTE;27;0;27;1
2018-11-04 10:30:00;NORTE;36;0;36;1
2018-11-04 11:00:00;NORTE;39;0;39;1
2018-11-04 11:30:00;NORTE;32;0;32;1
2018-11-04 12:00:00;NORTE;26;0;26;1
2018-11-04 12:30:00;NORTE;34;0;34;1
2018-11-04 13:00:00;NORTE;27;0;27;1
2018-11-04 13:30:00;NORTE;28;0;28;1
2018-11-04 14:00:00;NORTE;33;0;33;1
2018-11-04 14:30:00;NORTE;31;0;31;1
2018-11-04 15:00:00;NORTE;41;0;41;1
2018-11-04 15:30:00;NORTE;33;0;33;1
2018-11-04 16:00:00;CONFLICTIVA;16;12;28;2
2018-11-04 16:30:00;SUR;0;20;20;1
2018-11-04 17:00:00;SUR;0;22;22;1
2018-11-04 17:30:00;SUR;0;32;32;1
2018-11-04 18:00:00;SUR;0;24;24;1
2018-11-04 18:30:00;SUR;0;32;32;1
2018-11-04 19:00:00;SUR;0;36;36;1
2018-11-04 19:30:00;SUR;0;29;29;1
2018-11-04 20:00:00;SUR;0;28;28;1
2018-11-04 20:30:00;NORTE;28;2;30;1
2018-11-04 21:00:00;NORTE;36;0;36;1
2018-11-04 21:30:00;NORTE;29;0;29;1
2018-11-04 22:00:00;NORTE;16;0;16;1
2018-11-04 22:30:00;NORTE;12;0;12;1
2018-11-04 23:00:00;SUR;0;16;16;1
2018-11-04 23:30:00;SUR;0;8;8;1
2018-11-05 00:00:00;SUR;0;6;6;1
2018-11-05 01:00:00;SUR;0;3;3;1
2018-11-05 01:30:00;SUR;0;1;1;1
2018-11-05 02:30:00;NORTE;1;0;1;1
2018-11-05 03:00:00;NORTE;2;0;2;1
2018-11-05 03:30:00;SUR;0;4;4;1
2018-11-05 04:00:00;SUR;0;1;1;1
2018-11-05 04:30:00;SUR;0;5;5;1
2018-11-05 05:00:00;SUR;0;9;9;1
2018-11-05 05:30:00;SUR;0;13;13;1
2018-11-05 06:00:00;SUR;0;17;17;1
2018-11-05 06:30:00;SUR;0;36;36;1
2018-11-05 07:00:00;SUR;0;26;26;1
2018-11-05 07:30:00;SUR;0;26;26;1
2018-11-05 08:00:00;SUR;0;31;31;1
2018-11-05 08:30:00;SUR;0;25;25;1
2018-11-05 09:00:00;SUR;0;33;33;1
2018-11-05 09:30:00;SUR;0;36;36;1
2018-11-05 10:00:00;SUR;0;27;27;1
2018-11-05 10:30:00;SUR;0;35;35;1
2018-11-05 11:00:00;SUR;0;35;35;1
2018-11-05 11:30:00;SUR;0;27;27;1
2018-11-05 12:00:00;SUR;0;30;30;1
2018-11-05 12:30:00;SUR;0;30;30;1
2018-11-05 13:00:00;SUR;0;23;23;1
2018-11-05 13:30:00;SUR;0;37;37;1
2018-11-05 14:00:00;SUR;0;34;34;1
2018-11-05 14:30:00;SUR;0;38;38;1
2018-11-05 15:00:00;SUR;0;35;35;1
2018-11-05 15:30:00;SUR;0;30;30;1
2018-11-05 16:00:00;SUR;0;27;27;1
2018-11-05 16:30:00;SUR;0;19;19;1
2018-11-05 17:00:00;SUR;0;18;18;1
2018-11-05 17:30:00;SUR;0;31;31;1
2018-11-05 18:00:00;SUR;0;34;34;1
2018-11-05 18:30:00;SUR;0;33;33;1
2018-11-05 19:00:00;SUR;0;35;35;1
2018-11-05 19:30:00;SUR;0;38;38;1
2018-11-05 20:00:00;SUR;0;32;32;1
2018-11-05 20:30:00;SUR;0;27;27;1
2018-11-05 21:00:00;SUR;0;27;27;1
2018-11-05 21:30:00;SUR;0;19;19;1
2018-11-05 22:00:00;SUR;0;17;17;1
2018-11-05 22:30:00;SUR;0;12;12;1
2018-11-05 23:00:00;SUR;0;7;7;1
2018-11-05 23:30:00;SUR;0;7;7;1
2018-11-06 00:00:00;SUR;0;2;2;1
2018-11-06 01:30:00;SUR;0;1;1;1
2018-11-06 03:00:00;SUR;0;1;1;1
2018-11-06 03:30:00;SUR;0;8;8;1
2018-11-06 04:00:00;SUR;0;4;4;1
2018-11-06 04:30:00;SUR;0;8;8;1
2018-11-06 05:00:00;SUR;0;9;9;1
2018-11-06 05:30:00;SUR;0;8;8;1
2018-11-06 06:00:00;SUR;0;24;24;1
2018-11-06 06:30:00;SUR;0;37;37;1
2018-11-06 07:00:00;SUR;0;20;20;1
2018-11-06 07:30:00;SUR;0;18;18;1
2018-11-06 08:00:00;SUR;0;36;36;1
2018-11-06 08:30:00;SUR;0;26;26;1
2018-11-06 09:00:00;SUR;0;32;32;1
2018-11-06 09:30:00;SUR;0;29;29;1
2018-11-06 10:00:00;SUR;0;28;28;1
2018-11-06 10:30:00;SUR;0;30;30;1
2018-11-06 11:00:00;SUR;0;30;30;1
2018-11-06 11:30:00;SUR;0;30;30;1
2018-11-06 12:00:00;SUR;0;27;27;1
2018-11-06 12:30:00;SUR;0;27;27;1
2018-11-06 13:00:00;SUR;0;20;20;1
2018-11-06 13:30:00;SUR;0;25;25;1
2018-11-06 14:00:00;SUR;0;41;41;1
2018-11-06 14:30:00;SUR;0;25;25;1
2018-11-06 15:00:00;SUR;0;35;35;1
2018-11-06 15:30:00;SUR;0;38;38;1
2018-11-06 16:00:00;SUR;0;29;29;1
2018-11-06 16:30:00;SUR;0;16;16;1
2018-11-06 17:00:00;SUR;0;16;16;1
2018-11-06 17:30:00;SUR;0;33;33;1
2018-11-06 18:00:00;SUR;0;30;30;1
2018-11-06 18:30:00;SUR;0;21;21;1
2018-11-06 19:00:00;SUR;0;41;41;1
2018-11-06 19:30:00;SUR;0;26;26;1
2018-11-06 20:00:00;SUR;0;22;22;1
2018-11-06 20:30:00;SUR;0;29;29;1
2018-11-06 21:00:00;SUR;0;30;30;1
2018-11-06 21:30:00;SUR;0;22;22;1
2018-11-06 22:00:00;SUR;0;14;14;1
2018-11-06 22:30:00;SUR;0;7;7;1
2018-11-06 23:00:00;SUR;0;11;11;1
2018-11-06 23:30:00;SUR;0;3;3;1
2018-11-07 01:00:00;SUR;0;1;1;1
2018-11-07 01:30:00;SUR;0;2;2;1
2018-11-07 02:30:00;SUR;0;1;1;1
2018-11-07 03:00:00;SUR;0;3;3;1
2018-11-07 03:30:00;SUR;0;3;3;1
2018-11-07 04:00:00;SUR;0;3;3;1
2018-11-07 04:30:00;SUR;0;6;6;1
2018-11-07 05:00:00;SUR;0;6;6;1
2018-11-07 05:30:00;SUR;0;17;17;1
2018-11-07 06:00:00;SUR;0;21;21;1
2018-11-07 06:30:00;SUR;0;36;36;1
2018-11-07 07:00:00;SUR;0;20;20;1
2018-11-07 07:30:00;SUR;0;23;23;1
2018-11-07 08:00:00;SUR;0;21;21;1
2018-11-07 08:17:00;SUR;0;13;13;1
2018-11-07 08:30:00;SUR;0;17;17;1
2018-11-07 08:51:00;SUR;0;12;12;1
2018-11-07 09:03:00;SUR;0;29;29;1
2018-11-07 09:30:00;SUR;0;29;29;1
2018-11-07 09:50:00;SUR;0;12;12;1
2018-11-07 10:00:00;SUR;0;24;24;1
2018-11-07 10:30:00;SUR;0;34;34;1
2018-11-07 11:00:00;SUR;0;40;40;1
2018-11-07 11:30:00;SUR;0;16;16;1
2018-11-07 11:48:00;SUR;0;14;14;1
2018-11-07 12:00:00;SUR;0;26;26;1
2018-11-07 12:30:00;SUR;0;29;29;1
2018-11-07 13:00:00;SUR;0;28;28;1
2018-11-07 13:30:00;SUR;0;12;12;1
2018-11-07 13:43:00;SUR;0;17;17;1
2018-11-07 14:00:00;SUR;0;38;38;1
2018-11-07 14:30:00;SUR;0;34;34;1
2018-11-07 15:00:00;SUR;0;34;34;1
2018-11-07 15:30:00;SUR;0;28;28;1
2018-11-07 16:00:00;SUR;0;25;25;1
2018-11-07 16:30:00;SUR;0;19;19;1
2018-11-07 17:00:00;SUR;0;18;18;1
2018-11-07 17:30:00;SUR;0;28;28;1
2018-11-07 18:00:00;SUR;0;26;26;1
2018-11-07 18:30:00;SUR;0;22;22;1
2018-11-07 19:00:00;SUR;0;37;37;1
2018-11-07 19:30:00;SUR;0;30;30;1
2018-11-07 20:00:00;CONFLICTIVA;3;18;21;2
2018-11-07 20:30:00;NORTE;34;0;34;1
2018-11-07 21:00:00;NORTE;33;0;33;1
2018-11-07 21:30:00;NORTE;29;0;29;1
2018-11-07 22:00:00;NORTE;16;0;16;1
2018-11-07 22:30:00;NORTE;10;0;10;1
2018-11-07 23:00:00;NORTE;10;0;10;1
2018-11-07 23:30:00;NORTE;5;0;5;1
2018-11-08 00:00:00;NORTE;1;0;1;1
2018-11-08 00:30:00;NORTE;1;0;1;1
2018-11-08 01:00:00;NORTE;1;0;1;1
2018-11-08 01:30:00;NORTE;2;0;2;1
2018-11-08 02:30:00;NORTE;1;0;1;1
2018-11-08 03:00:00;NORTE;4;0;4;1
2018-11-08 03:30:00;NORTE;3;0;3;1
2018-11-08 04:00:00;NORTE;2;0;2;1
2018-11-08 04:30:00;NORTE;6;0;6;1
2018-11-08 05:00:00;NORTE;12;0;12;1
2018-11-08 05:30:00;NORTE;13;0;13;1
2018-11-08 06:00:00;NORTE;21;0;21;1
2018-11-08 06:30:00;NORTE;43;0;43;1
2018-11-08 07:00:00;NORTE;17;0;17;1
2018-11-08 07:30:00;NORTE;20;0;20;1
2018-11-08 08:00:00;NORTE;40;0;40;1
2018-11-08 08:30:00;NORTE;18;0;18;1
2018-11-08 08:51:00;NORTE;10;0;10;1
2018-11-08 09:00:00;NORTE;40;0;40;1
2018-11-08 09:30:00;NORTE;33;0;33;1
2018-11-08 10:00:00;CONFLICTIVA;3;19;22;2
2018-11-08 10:30:00;SUR;0;34;34;1
2018-11-08 11:00:00;SUR;0;36;36;1
2018-11-08 11:30:00;SUR;0;32;32;1
2018-11-08 12:00:00;SUR;0;25;25;1
2018-11-08 12:30:00;SUR;0;23;23;1
2018-11-08 13:00:00;SUR;0;30;30;1
2018-11-08 13:30:00;SUR;0;33;33;1
2018-11-08 14:00:00;SUR;0;38;38;1
2018-11-08 14:30:00;SUR;0;33;33;1
2018-11-08 15:00:00;SUR;0;32;32;1
2018-11-08 15:30:00;SUR;0;31;31;1
2018-11-08 16:00:00;SUR;0;24;24;1
2018-11-08 16:30:00;SUR;0;17;17;1
2018-11-08 17:00:00;NORTE;18;0;18;1
2018-11-08 17:30:00;NORTE;32;0;32;1
2018-11-08 18:00:00;NORTE;34;0;34;1
2018-11-08 18:30:00;NORTE;32;0;32;1
2018-11-08 19:00:00;NORTE;32;0;32;1
2018-11-08 19:20:00;NORTE;11;0;11;1
2018-11-08 19:30:00;NORTE;35;0;35;1
2018-11-08 20:00:00;NORTE;31;0;31;1
2018-11-08 20:30:00;NORTE;22;0;22;1
2018-11-08 21:00:00;NORTE;32;0;32;1
2018-11-08 21:30:00;NORTE;25;0;25;1
2018-11-08 22:00:00;NORTE;16;0;16;1
2018-11-08 22:30:00;NORTE;13;0;13;1
2018-11-08 23:00:00;NORTE;14;0;14;1
2018-11-08 23:30:00;NORTE;6;0;6;1
2018-11-09 00:00:00;NORTE;1;0;1;1
2018-11-09 01:00:00;NORTE;3;0;3;1
2018-11-09 01:30:00;NORTE;1;0;1;1
2018-11-09 02:00:00;NORTE;1;0;1;1
2018-11-09 03:00:00;NORTE;2;0;2;1
2018-11-09 03:30:00;NORTE;5;0;5;1
2018-11-09 04:00:00;NORTE;3;0;3;1
2018-11-09 04:30:00;NORTE;8;0;8;1
2018-11-09 05:00:00;NORTE;9;0;9;1
2018-11-09 05:30:00;NORTE;15;0;15;1
2018-11-09 06:00:00;NORTE;18;0;18;1
2018-11-09 06:30:00;NORTE;34;0;34;1
2018-11-09 07:00:00;NORTE;20;0;20;1
2018-11-09 07:30:00;NORTE;21;0;21;1
2018-11-09 08:00:00;NORTE;39;0;39;1
2018-11-09 08:30:00;NORTE;28;0;28;1
2018-11-09 09:00:00;NORTE;34;0;34;1
2018-11-09 09:30:00;NORTE;32;0;32;1
2018-11-09 10:00:00;NORTE;32;0;32;1
2018-11-09 10:30:00;NORTE;38;0;38;1
2018-11-09 11:00:00;NORTE;35;0;35;1
2018-11-09 11:30:00;NORTE;32;0;32;1
2018-11-09 12:00:00;NORTE;30;0;30;1
2018-11-09 12:30:00;NORTE;27;0;27;1
2018-11-09 13:00:00;NORTE;26;0;26;1
2018-11-09 13:30:00;NORTE;31;0;31;1
2018-11-09 14:00:00;NORTE;37;0;37;1
2018-11-09 14:30:00;NORTE;35;0;35;1
2018-11-09 15:00:00;NORTE;33;0;33;1
2018-11-09 15:30:00;NORTE;30;0;30;1
2018-11-09 16:00:00;NORTE;26;0;26;1
2018-11-09 16:30:00;NORTE;19;0;19;1
2018-11-09 17:00:00;NORTE;25;0;25;1
2018-11-09 17:30:00;NORTE;31;0;31;1
2018-11-09 18:00:00;NORTE;27;0;27;1
2018-11-09 18:30:00;NORTE;34;0;34;1
2018-11-09 19:00:00;NORTE;31;0;31;1
2018-11-09 19:30:00;NORTE;37;0;37;1
2018-11-09 20:00:00;NORTE;31;0;31;1
2018-11-09 20:30:00;NORTE;29;0;29;1
2018-11-09 21:00:00;NORTE;29;0;29;1
2018-11-09 21:30:00;NORTE;19;0;19;1
2018-11-09 22:00:00;NORTE;11;0;11;1
2018-11-09 22:30:00;NORTE;4;0;4;1
2018-11-09 22:50:00;NORTE;3;0;3;1
2018-11-09 23:00:00;NORTE;11;0;11;1
2018-11-09 23:30:00;NORTE;2;0;2;1
2018-11-10 00:00:00;NORTE;3;0;3;1
2018-11-10 00:30:00;NORTE;3;0;3;1
2018-11-10 01:30:00;NORTE;1;0;1;1
2018-11-10 02:00:00;NORTE;1;0;1;1
2018-11-10 03:00:00;NORTE;4;0;4;1
2018-11-10 03:30:00;NORTE;4;0;4;1
2018-11-10 04:00:00;NORTE;1;0;1;1
2018-11-10 04:30:00;NORTE;5;0;5;1
2018-11-10 05:00:00;NORTE;10;0;10;1
2018-11-10 05:30:00;CONFLICTIVA;10;3;13;2
2018-11-10 06:00:00;SUR;0;22;22;1
2018-11-10 06:30:00;SUR;0;20;20;1
2018-11-10 07:00:00;SUR;0;22;22;1
2018-11-10 07:30:00;SUR;0;9;9;1
2018-11-10 07:47:00;SUR;0;11;11;1
2018-11-10 08:00:00;SUR;0;31;31;1
2018-11-10 08:30:00;SUR;0;23;23;1
2018-11-10 09:00:00;SUR;0;7;7;1
2018-11-10 09:08:00;SUR;0;23;23;1
2018-11-10 09:30:00;SUR;0;36;36;1
2018-11-10 10:00:00;SUR;0;31;31;1
2018-11-10 10:30:00;SUR;0;24;24;1
2018-11-10 11:00:00;SUR;0;36;36;1
2018-11-10 11:30:00;SUR;0;36;36;1
2018-11-10 12:00:00;SUR;0;24;24;1
2018-11-10 12:30:00;SUR;0;28;28;1
2018-11-10 13:00:00;SUR;0;23;23;1
2018-11-10 13:30:00;SUR;0;30;30;1
2018-11-10 14:00:00;SUR;0;34;34;1
2018-11-10 14:30:00;SUR;0;27;27;1
2018-11-10 15:00:00;SUR;0;38;38;1
2018-11-10 15:30:00;SUR;0;26;26;1
2018-11-10 16:00:00;SUR;0;18;18;1
2018-11-10 16:30:00;SUR;0;17;17;1
2018-11-10 17:00:00;SUR;0;16;16;1
2018-11-10 17:30:00;SUR;0;27;27;1
2018-11-10 18:00:00;SUR;0;20;20;1
2018-11-10 18:30:00;SUR;0;20;20;1
2018-11-10 19:00:00;SUR;0;35;35;1
2018-11-10 19:30:00;SUR;0;8;8;1
2018-11-10 19:49:00;SUR;0;5;5;1
2018-11-10 20:00:00;SUR;0;19;19;1
2018-11-10 20:30:00;SUR;0;21;21;1
2018-11-10 21:00:00;SUR;0;18;18;1
2018-11-10 21:30:00;SUR;0;17;17;1
2018-11-10 22:00:00;SUR;0;10;10;1
2018-11-10 22:30:00;SUR;0;9;9;1
2018-11-10 23:00:00;SUR;0;10;10;1
2018-11-10 23:30:00;SUR;0;6;6;1
2018-11-11 00:19:00;SUR;0;1;1;1
2018-11-11 00:38:00;SUR;0;1;1;1
2018-11-11 01:00:00;SUR;0;2;2;1
2018-11-11 02:00:00;SUR;0;3;3;1
2018-11-11 03:00:00;SUR;0;2;2;1
2018-11-11 03:30:00;SUR;0;1;1;1
2018-11-11 04:00:00;SUR;0;3;3;1
2018-11-11 04:30:00;SUR;0;3;3;1
2018-11-11 05:00:00;SUR;0;7;7;1
2018-11-11 05:30:00;SUR;0;10;10;1
2018-11-11 06:00:00;SUR;0;13;13;1
2018-11-11 06:30:00;SUR;0;22;22;1
2018-11-11 07:00:00;SUR;0;18;18;1
2018-11-11 07:30:00;SUR;0;18;18;1
2018-11-11 08:00:00;SUR;0;28;28;1
2018-11-11 08:30:00;SUR;0;22;22;1
2018-11-11 09:00:00;SUR;0;31;31;1
2018-11-11 09:30:00;SUR;0;29;29;1
2018-11-11 10:00:00;SUR;0;25;25;1
2018-11-11 10:30:00;SUR;0;33;33;1
2018-11-11 11:00:00;SUR;0;35;35;1
2018-11-11 11:30:00;SUR;0;31;31;1
2018-11-11 12:00:00;SUR;0;22;22;1
2018-11-11 12:30:00;SUR;0;26;26;1
2018-11-11 13:00:00;SUR;0;33;33;1
2018-11-11 13:30:00;SUR;0;31;31;1
2018-11-11 14:00:00;SUR;0;39;39;1
2018-11-11 14:30:00;SUR;0;29;29;1
2018-11-11 15:00:00;SUR;0;32;32;1
2018-11-11 15:30:00;SUR;0;39;39;1
2018-11-11 16:00:00;SUR;0;26;26;1
2018-11-11 16:30:00;SUR;0;15;15;1
2018-11-11 17:00:00;SUR;0;22;22;1
2018-11-11 17:30:00;SUR;0;34;34;1
2018-11-11 18:00:00;SUR;0;28;28;1
2018-11-11 18:30:00;SUR;0;37;37;1
2018-11-11 19:00:00;SUR;0;37;37;1
2018-11-11 19:30:00;SUR;0;34;34;1
2018-11-11 20:00:00;SUR;0;24;24;1
2018-11-11 20:30:00;NORTE;36;0;36;1
2018-11-11 21:00:00;NORTE;28;0;28;1
2018-11-11 21:30:00;CONFLICTIVA;13;8;21;2
2018-11-11 22:00:00;SUR;0;26;26;1
2018-11-11 22:30:00;SUR;0;18;18;1
2018-11-11 23:00:00;SUR;0;15;15;1
2018-11-11 23:30:00;SUR;0;6;6;1
2018-11-12 00:00:00;SUR;0;5;5;1
2018-11-12 00:30:00;SUR;0;1;1;1
2018-11-12 01:00:00;SUR;0;2;2;1
2018-11-12 01:30:00;SUR;0;2;2;1
2018-11-12 02:00:00;SUR;0;1;1;1
2018-11-12 02:30:00;SUR;0;1;1;1
2018-11-12 03:00:00;SUR;0;5;5;1
2018-11-12 03:30:00;SUR;0;3;3;1
2018-11-12 04:00:00;SUR;0;2;2;1
2018-11-12 04:30:00;SUR;0;8;8;1
2018-11-12 05:00:00;CONFLICTIVA;4;2;6;2
2018-11-12 05:30:00;NORTE;13;0;13;1
2018-11-12 06:00:00;NORTE;21;0;21;1
2018-11-12 06:30:00;NORTE;36;0;36;1
2018-11-12 07:00:00;NORTE;25;0;25;1
2018-11-12 07:30:00;NORTE;23;0;23;1
2018-11-12 08:00:00;NORTE;35;0;35;1
2018-11-12 08:30:00;NORTE;23;0;23;1
2018-11-12 09:00:00;NORTE;33;0;33;1
2018-11-12 09:30:00;NORTE;40;0;40;1
2018-11-12 10:00:00;NORTE;29;0;29;1
2018-11-12 10:30:00;NORTE;41;0;41;1
2018-11-12 11:00:00;NORTE;35;0;35;1
2018-11-12 11:30:00;NORTE;29;0;29;1
2018-11-12 12:00:00;NORTE;23;0;23;1
2018-11-12 12:30:00;NORTE;29;0;29;1
2018-11-12 13:00:00;NORTE;31;0;31;1
2018-11-12 13:30:00;NORTE;28;0;28;1
2018-11-12 14:00:00;NORTE;34;0;34;1
2018-11-12 14:30:00;NORTE;31;0;31;1
2018-11-12 15:00:00;NORTE;36;0;36;1
2018-11-12 15:30:00;NORTE;35;0;35;1
2018-11-12 16:00:00;NORTE;24;0;24;1
2018-11-12 16:30:00;NORTE;21;0;21;1
2018-11-12 17:00:00;NORTE;19;0;19;1
2018-11-12 17:30:00;NORTE;29;0;29;1
2018-11-12 18:00:00;NORTE;34;0;34;1
2018-11-12 18:30:00;NORTE;32;0;32;1
2018-11-12 19:00:00;NORTE;36;0;36;1
2018-11-12 19:30:00;NORTE;34;0;34;1
2018-11-12 20:00:00;NORTE;28;0;28;1
2018-11-12 20:30:00;NORTE;24;0;24;1
2018-11-12 21:00:00;NORTE;39;0;39;1
2018-11-12 21:30:00;NORTE;24;0;24;1
2018-11-12 22:00:00;NORTE;13;0;13;1
2018-11-12 22:30:00;NORTE;13;0;13;1
2018-11-12 23:00:00;NORTE;12;0;12;1
2018-11-12 23:30:00;NORTE;2;0;2;1
2018-11-13 03:00:00;NORTE;2;0;2;1
2018-11-13 03:30:00;NORTE;6;0;6;1
2018-11-13 04:00:00;NORTE;4;0;4;1
2018-11-13 04:30:00;NORTE;7;0;7;1
2018-11-13 05:00:00;NORTE;7;0;7;1
2018-11-13 05:30:00;NORTE;17;0;17;1
2018-11-13 06:00:00;NORTE;26;0;26;1
2018-11-13 06:30:00;NORTE;38;0;38;1
2018-11-13 07:00:00;NORTE;21;0;21;1
2018-11-13 07:30:00;NORTE;24;0;24;1
2018-11-13 08:00:00;NORTE;30;0;30;1
2018-11-13 08:30:00;NORTE;26;0;26;1
2018-11-13 09:00:00;NORTE;42;0;42;1
2018-11-13 09:30:00;NORTE;30;0;30;1
2018-11-13 10:00:00;NORTE;21;0;21;1
2018-11-13 10:30:00;NORTE;37;0;37;1
2018-11-13 11:00:00;NORTE;35;0;35;1
2018-11-13 11:30:00;NORTE;27;0;27;1
2018-11-13 12:00:00;NORTE;28;0;28;1
2018-11-13 12:30:00;NORTE;29;0;29;1
2018-11-13 13:00:00;NORTE;28;0;28;1
2018-11-13 13:30:00;NORTE;33;0;33;1
2018-11-13 14:00:00;NORTE;30;0;30;1
2018-11-13 14:30:00;NORTE;31;0;31;1
2018-11-13 15:00:00;NORTE;34;0;34;1
2018-11-13 15:30:00;NORTE;31;0;31;1
2018-11-13 16:00:00;NORTE;27;0;27;1
2018-11-13 16:30:00;NORTE;19;0;19;1
2018-11-13 17:00:00;NORTE;22;0;22;1
2018-11-13 17:30:00;NORTE;35;0;35;1
2018-11-13 18:00:00;NORTE;19;0;19;1
2018-11-13 18:30:00;NORTE;28;0;28;1
2018-11-13 19:00:00;NORTE;35;0;35;1
2018-11-13 19:30:00;NORTE;36;0;36;1
2018-11-13 20:00:00;NORTE;18;0;18;1
2018-11-13 20:30:00;NORTE;26;0;26;1
2018-11-13 21:00:00;NORTE;29;0;29;1
2018-11-13 21:30:00;NORTE;23;0;23;1
2018-11-13 22:00:00;NORTE;13;0;13;1
2018-11-13 22:30:00;NORTE;4;0;4;1
2018-11-13 23:00:00;NORTE;12;0;12;1
2018-11-13 23:30:00;NORTE;2;0;2;1
2018-11-14 00:00:00;NORTE;1;0;1;1
2018-11-14 00:30:00;NORTE;1;0;1;1
2018-11-14 01:00:00;NORTE;1;0;1;1
2018-11-14 01:30:00;NORTE;1;0;1;1
2018-11-14 02:30:00;NORTE;1;0;1;1
2018-11-14 03:00:00;NORTE;1;0;1;1
2018-11-14 03:30:00;NORTE;4;0;4;1
2018-11-14 04:00:00;NORTE;1;0;1;1
2018-11-14 04:30:00;NORTE;5;0;5;1
2018-11-14 05:00:00;NORTE;12;0;12;1
2018-11-14 05:30:00;NORTE;14;0;14;1
2018-11-14 06:00:00;NORTE;20;0;20;1
2018-11-14 06:30:00;NORTE;35;0;35;1
2018-11-14 07:00:00;NORTE;21;0;21;1
2018-11-14 07:30:00;NORTE;26;0;26;1
2018-11-14 08:00:00;NORTE;31;0;31;1
2018-11-14 08:30:00;NORTE;27;0;27;1
2018-11-14 09:00:00;NORTE;41;0;41;1
2018-11-14 09:30:00;NORTE;33;0;33;1
2018-11-14 10:00:00;NORTE;20;0;20;1
2018-11-14 10:30:00;NORTE;37;0;37;1
2018-11-14 11:00:00;NORTE;32;0;32;1
2018-11-14 11:30:00;NORTE;33;0;33;1
2018-11-14 12:00:00;NORTE;27;0;27;1
2018-11-14 12:30:00;NORTE;27;0;27;1
2018-11-14 13:00:00;NORTE;28;0;28;1
2018-11-14 13:30:00;NORTE;30;0;30;1
2018-11-14 14:00:00;NORTE;36;0;36;1
2018-11-14 14:30:00;NORTE;31;0;31;1
2018-11-14 15:00:00;NORTE;34;0;34;1
2018-11-14 15:30:00;NORTE;33;0;33;1
2018-11-14 16:00:00;NORTE;16;0;16;1
2018-11-14 16:18:00;NORTE;9;0;9;1
2018-11-14 16:30:00;NORTE;12;0;12;1
2018-11-14 17:00:00;NORTE;29;0;29;1
2018-11-14 17:30:00;NORTE;29;0;29;1
2018-11-14 18:00:00;NORTE;30;0;30;1
2018-11-14 18:30:00;NORTE;27;0;27;1
2018-11-14 19:00:00;NORTE;35;0;35;1
2018-11-14 19:30:00;NORTE;33;0;33;1
2018-11-14 20:00:00;NORTE;24;0;24;1
2018-11-14 20:30:00;NORTE;33;0;33;1
2018-11-14 21:00:00;NORTE;31;0;31;1
2018-11-14 21:30:00;NORTE;23;0;23;1
2018-11-14 22:00:00;NORTE;13;0;13;1
2018-11-14 22:30:00;NORTE;8;0;8;1
2018-11-14 23:00:00;NORTE;12;0;12;1
2018-11-14 23:30:00;NORTE;5;0;5;1
2018-11-15 00:30:00;NORTE;1;0;1;1
2018-11-15 01:30:00;NORTE;2;0;2;1
2018-11-15 02:30:00;NORTE;1;0;1;1
2018-11-15 03:00:00;NORTE;4;0;4;1
2018-11-15 03:30:00;NORTE;3;0;3;1
2018-11-15 04:00:00;NORTE;4;0;4;1
2018-11-15 04:30:00;NORTE;5;0;5;1
2018-11-15 05:00:00;NORTE;10;0;10;1
2018-11-15 05:30:00;NORTE;15;0;15;1
2018-11-15 06:00:00;NORTE;19;0;19;1
2018-11-15 06:30:00;NORTE;40;0;40;1
2018-11-15 07:00:00;NORTE;18;0;18;1
2018-11-15 07:30:00;NORTE;26;0;26;1
2018-11-15 08:00:00;NORTE;31;0;31;1
2018-11-15 08:30:00;NORTE;21;0;21;1
2018-11-15 09:00:00;NORTE;29;0;29;1
2018-11-15 09:30:00;NORTE;15;0;15;1
2018-11-15 10:00:00;NORTE;9;0;9;1
2018-11-15 10:30:00;NORTE;27;0;27;1
2018-11-15 11:00:00;NORTE;32;0;32;1
2018-11-15 11:30:00;NORTE;24;0;24;1
2018-11-15 12:00:00;NORTE;36;0;36;1
2018-11-15 12:30:00;NORTE;23;0;23;1
2018-11-15 13:00:00;NORTE;30;0;30;1
2018-11-15 13:30:00;NORTE;33;0;33;1
2018-11-15 14:00:00;NORTE;33;0;33;1
2018-11-15 14:30:00;NORTE;34;0;34;1
2018-11-15 15:00:00;NORTE;45;0;45;1
2018-11-15 15:30:00;NORTE;19;0;19;1
2018-11-15 16:00:00;SUR;0;18;18;1
2018-11-15 16:19:00;SUR;0;7;7;1
2018-11-15 16:30:00;SUR;0;16;16;1
2018-11-15 17:00:00;CONFLICTIVA;16;2;18;2
2018-11-15 17:30:00;NORTE;41;0;41;1
2018-11-15 18:00:00;NORTE;26;0;26;1
2018-11-15 18:30:00;NORTE;34;0;34;1
2018-11-15 19:00:00;NORTE;41;0;41;1
2018-11-15 19:30:00;NORTE;33;0;33;1
2018-11-15 20:00:00;NORTE;34;0;34;1
2018-11-15 20:30:00;NORTE;29;0;29;1
2018-11-15 21:00:00;NORTE;31;0;31;1
2018-11-15 21:30:00;NORTE;26;0;26;1
2018-11-15 22:00:00;NORTE;14;0;14;1
2018-11-15 22:30:00;NORTE;11;0;11;1
2018-11-15 23:00:00;NORTE;12;0;12;1
2018-11-15 23:30:00;NORTE;6;0;6;1
2018-11-16 00:00:00;NORTE;1;0;1;1
2018-11-16 00:30:00;NORTE;3;0;3;1
2018-11-16 01:30:00;NORTE;1;0;1;1
2018-11-16 02:00:00;NORTE;1;0;1;1
2018-11-16 02:30:00;NORTE;1;0;1;1
2018-11-16 03:00:00;NORTE;3;0;3;1
2018-11-16 03:30:00;NORTE;2;0;2;1
2018-11-16 04:00:00;NORTE;3;0;3;1
2018-11-16 04:30:00;NORTE;8;0;8;1
2018-11-16 05:00:00;NORTE;8;0;8;1
2018-11-16 05:30:00;NORTE;16;0;16;1
2018-11-16 06:00:00;NORTE;22;0;22;1
2018-11-16 06:30:00;NORTE;28;0;28;1
2018-11-16 07:00:00;NORTE;25;0;25;1
2018-11-16 07:30:00;NORTE;19;0;19;1
2018-11-16 08:00:00;NORTE;43;0;43;1
2018-11-16 08:30:00;NORTE;33;0;33;1
2018-11-16 09:00:00;NORTE;32;0;32;1
2018-11-16 09:30:00;NORTE;27;0;27;1
2018-11-16 10:00:00;NORTE;27;0;27;1
2018-11-16 10:30:00;NORTE;35;0;35;1
2018-11-16 11:00:00;NORTE;32;0;32;1
2018-11-16 11:30:00;NORTE;39;0;39;1
2018-11-16 12:00:00;NORTE;25;0;25;1
2018-11-16 12:30:00;NORTE;23;0;23;1
2018-11-16 13:00:00;NORTE;32;0;32;1
2018-11-16 13:30:00;NORTE;29;0;29;1
2018-11-16 14:00:00;NORTE;39;0;39;1
2018-11-16 14:30:00;NORTE;35;0;35;1
2018-11-16 15:00:00;NORTE;37;0;37;1
2018-11-16 15:30:00;NORTE;37;0;37;1
2018-11-16 16:00:00;NORTE;25;0;25;1
2018-11-16 16:30:00;NORTE;26;0;26;1
2018-11-16 17:00:00;NORTE;24;0;24;1
2018-11-16 17:30:00;NORTE;28;0;28;1
2018-11-16 18:00:00;NORTE;29;0;29;1
2018-11-16 18:30:00;NORTE;36;0;36;1
2018-11-16 19:00:00;NORTE;37;0;37;1
2018-11-16 19:30:00;NORTE;28;0;28;1
2018-11-16 20:00:00;NORTE;35;0;35;1
2018-11-16 20:30:00;NORTE;25;0;25;1
2018-11-16 21:00:00;NORTE;29;0;29;1
2018-11-16 21:30:00;NORTE;28;0;28;1
2018-11-16 22:00:00;NORTE;11;0;11;1
2018-11-16 22:30:00;NORTE;6;0;6;1
2018-11-16 23:00:00;NORTE;17;0;17;1
2018-11-16 23:30:00;NORTE;3;0;3;1
2018-11-17 00:00:00;NORTE;1;0;1;1
2018-11-17 01:00:00;NORTE;2;0;2;1
2018-11-17 01:30:00;NORTE;1;0;1;1
2018-11-17 02:30:00;NORTE;3;0;3;1
2018-11-17 03:00:00;NORTE;4;0;4;1
2018-11-17 03:30:00;NORTE;3;0;3;1
2018-11-17 04:00:00;NORTE;1;0;1;1
2018-11-17 04:30:00;NORTE;6;0;6;1
2018-11-17 05:00:00;NORTE;10;0;10;1
2018-11-17 05:30:00;NORTE;14;0;14;1
2018-11-17 06:00:00;NORTE;20;0;20;1
2018-11-17 06:30:00;NORTE;28;0;28;1
2018-11-17 07:00:00;NORTE;12;0;12;1
2018-11-17 07:30:00;NORTE;19;0;19;1
2018-11-17 08:00:00;NORTE;39;0;39;1
2018-11-17 08:30:00;NORTE;25;0;25;1
2018-11-17 09:00:00;NORTE;40;0;40;1
2018-11-17 09:30:00;NORTE;29;0;29;1
2018-11-17 10:00:00;NORTE;18;0;18;1
2018-11-17 10:30:00;NORTE;37;0;37;1
2018-11-17 11:00:00;NORTE;33;0;33;1
2018-11-17 11:30:00;NORTE;26;0;26;1
2018-11-17 12:00:00;NORTE;32;0;32;1
2018-11-17 12:30:00;NORTE;30;0;30;1
2018-11-17 13:00:00;NORTE;21;0;21;1
2018-11-17 13:30:00;NORTE;27;0;27;1
2018-11-17 14:00:00;NORTE;34;0;34;1
2018-11-17 14:30:00;NORTE;26;0;26;1
2018-11-17 15:00:00;NORTE;36;0;36;1
2018-11-17 15:30:00;NORTE;23;0;23;1
2018-11-17 16:00:00;NORTE;28;0;28;1
2018-11-17 16:30:00;NORTE;21;0;21;1
2018-11-17 17:00:00;NORTE;18;0;18;1
2018-11-17 17:30:00;NORTE;32;0;32;1
2018-11-17 18:00:00;NORTE;15;0;15;1
2018-11-17 18:30:00;NORTE;24;0;24;1
2018-11-17 19:00:00;NORTE;34;0;34;1
2018-11-17 19:30:00;NORTE;21;0;21;1
2018-11-17 20:00:00;NORTE;19;0;19;1
2018-11-17 20:30:00;NORTE;20;0;20;1
2018-11-17 21:00:00;NORTE;14;0;14;1
2018-11-17 21:30:00;NORTE;16;0;16;1
2018-11-17 22:00:00;NORTE;6;0;6;1
2018-11-17 22:30:00;NORTE;5;0;5;1
2018-11-17 23:00:00;NORTE;11;0;11;1
2018-11-17 23:30:00;NORTE;2;0;2;1
2018-11-18 00:00:00;NORTE;1;0;1;1
2018-11-18 00:30:00;NORTE;3;0;3;1
2018-11-18 01:00:00;NORTE;1;0;1;1
2018-11-18 01:30:00;NORTE;1;0;1;1
2018-11-18 02:00:00;NORTE;1;0;1;1
2018-11-18 02:30:00;NORTE;1;0;1;1
2018-11-18 03:00:00;NORTE;3;0;3;1
2018-11-18 03:30:00;NORTE;1;0;1;1
2018-11-18 04:00:00;NORTE;6;0;6;1
2018-11-18 04:30:00;NORTE;3;0;3;1
2018-11-18 05:00:00;NORTE;9;0;9;1
2018-11-18 05:30:00;NORTE;10;0;10;1
2018-11-18 06:00:00;NORTE;18;0;18;1
2018-11-18 06:30:00;NORTE;22;0;22;1
2018-11-18 07:00:00;NORTE;13;0;13;1
2018-11-18 07:30:00;NORTE;17;0;17;1
2018-11-18 08:00:00;NORTE;28;0;28;1
2018-11-18 08:30:00;NORTE;27;0;27;1
2018-11-18 09:00:00;NORTE;34;0;34;1
2018-11-18 09:30:00;NORTE;27;0;27;1
2018-11-18 10:00:00;NORTE;26;0;26;1
2018-11-18 10:30:00;NORTE;34;0;34;1
2018-11-18 11:00:00;NORTE;37;0;37;1
2018-11-18 11:30:00;NORTE;32;0;32;1
2018-11-18 12:00:00;CONFLICTIVA;10;7;17;2
2018-11-18 12:30:00;SUR;0;37;37;1
2018-11-18 13:00:00;SUR;0;28;28;1
2018-11-18 13:30:00;SUR;0;28;28;1
2018-11-18 14:00:00;SUR;0;35;35;1
2018-11-18 14:30:00;SUR;0;16;16;1
2018-11-18 14:47:00;SUR;0;19;19;1
2018-11-18 15:00:00;SUR;0;31;31;1
2018-11-18 15:30:00;SUR;0;9;9;1
2018-11-18 15:36:00;SUR;0;23;23;1
2018-11-18 16:00:00;SUR;0;23;23;1
2018-11-18 16:30:00;SUR;0;23;23;1
2018-11-18 17:00:00;CONFLICTIVA;7;15;22;2
2018-11-18 17:30:00;NORTE;32;0;32;1
2018-11-18 18:00:00;NORTE;29;0;29;1
2018-11-18 18:30:00;NORTE;30;0;30;1
2018-11-18 19:00:00;NORTE;37;0;37;1
2018-11-18 19:30:00;NORTE;18;0;18;1
2018-11-18 19:46:00;NORTE;16;0;16;1
2018-11-18 20:00:00;NORTE;13;0;13;1
2018-11-18 20:12:00;NORTE;15;0;15;1
2018-11-18 20:30:00;NORTE;33;0;33;1
2018-11-18 21:00:00;NORTE;26;0;26;1
2018-11-18 21:30:00;NORTE;28;0;28;1
2018-11-18 22:00:00;NORTE;14;0;14;1
2018-11-18 22:30:00;NORTE;5;0;5;1
2018-11-18 22:44:00;NORTE;8;0;8;1
2018-11-18 23:00:00;NORTE;10;0;10;1
2018-11-18 23:30:00;NORTE;8;0;8;1
2018-11-19 00:30:00;NORTE;1;0;1;1
2018-11-19 01:00:00;NORTE;1;0;1;1
2018-11-19 01:30:00;NORTE;1;0;1;1
2018-11-19 02:00:00;NORTE;1;0;1;1
2018-11-19 02:30:00;NORTE;1;0;1;1
2018-11-19 03:00:00;NORTE;4;0;4;1
2018-11-19 03:30:00;NORTE;4;0;4;1
2018-11-19 04:00:00;NORTE;3;0;3;1
2018-11-19 04:30:00;NORTE;5;0;5;1
2018-11-19 05:00:00;NORTE;9;0;9;1
2018-11-19 05:30:00;NORTE;10;0;10;1
2018-11-19 06:00:00;NORTE;20;0;20;1
2018-11-19 06:30:00;NORTE;41;0;41;1
2018-11-19 07:00:00;NORTE;19;0;19;1
2018-11-19 07:30:00;NORTE;24;0;24;1
2018-11-19 08:00:00;NORTE;39;0;39;1
2018-11-19 08:30:00;NORTE;30;0;30;1
2018-11-19 09:00:00;NORTE;38;0;38;1
2018-11-19 09:30:00;NORTE;34;0;34;1
2018-11-19 10:00:00;NORTE;22;0;22;1
2018-11-19 10:30:00;NORTE;40;0;40;1
2018-11-19 11:00:00;NORTE;33;0;33;1
2018-11-19 11:30:00;NORTE;32;0;32;1
2018-11-19 12:00:00;NORTE;24;0;24;1
2018-11-19 12:30:00;NORTE;32;0;32;1
2018-11-19 13:00:00;NORTE;30;0;30;1
2018-11-19 13:30:00;NORTE;30;0;30;1
2018-11-19 14:00:00;NORTE;37;0;37;1
2018-11-19 14:30:00;NORTE;25;0;25;1
2018-11-19 15:00:00;NORTE;40;0;40;1
2018-11-19 15:30:00;NORTE;35;0;35;1
2018-11-19 16:00:00;NORTE;27;0;27;1
2018-11-19 16:30:00;NORTE;22;0;22;1
2018-11-19 17:00:00;NORTE;24;0;24;1
2018-11-19 17:30:00;NORTE;36;0;36;1
2018-11-19 18:00:00;NORTE;29;0;29;1
2018-11-19 18:30:00;NORTE;30;0;30;1
2018-11-19 19:00:00;NORTE;41;0;41;1
2018-11-19 19:30:00;NORTE;28;0;28;1
2018-11-19 20:00:00;NORTE;23;0;23;1
2018-11-19 20:30:00;NORTE;29;0;29;1
2018-11-19 21:00:00;NORTE;31;0;31;1
2018-11-19 21:30:00;NORTE;22;0;22;1
2018-11-19 22:00:00;NORTE;14;0;14;1
2018-11-19 22:30:00;NORTE;8;0;8;1
2018-11-19 23:00:00;NORTE;12;0;12;1
2018-11-19 23:30:00;NORTE;3;0;3;1
2018-11-20 00:30:00;NORTE;1;0;1;1
2018-11-20 02:00:00;NORTE;2;0;2;1
2018-11-20 03:00:00;NORTE;3;0;3;1
2018-11-20 03:30:00;NORTE;4;0;4;1
2018-11-20 04:00:00;NORTE;3;0;3;1
2018-11-20 04:30:00;NORTE;9;0;9;1
2018-11-20 05:00:00;NORTE;10;0;10;1
2018-11-20 05:30:00;SUR;0;11;11;1
2018-11-20 06:00:00;SUR;0;19;19;1
2018-11-20 06:30:00;SUR;0;38;38;1
2018-11-20 07:00:00;SUR;0;19;19;1
2018-11-20 07:30:00;SUR;0;20;20;1
2018-11-20 08:00:00;SUR;0;31;31;1
2018-11-20 08:30:00;SUR;0;23;23;1
2018-11-20 09:00:00;SUR;0;33;33;1
2018-11-20 09:30:00;SUR;0;24;24;1
2018-11-20 10:00:00;SUR;0;30;30;1
2018-11-20 10:30:00;SUR;0;28;28;1
2018-11-20 11:00:00;NORTE;34;1;35;1
2018-11-20 11:30:00;NORTE;32;0;32;1
2018-11-20 12:00:00;NORTE;29;0;29;1
2018-11-20 12:30:00;NORTE;29;0;29;1
2018-11-20 13:00:00;NORTE;23;0;23;1
2018-11-20 13:30:00;SUR;1;27;28;1
2018-11-20 14:00:00;SUR;0;34;34;1
2018-11-20 14:30:00;SUR;0;28;28;1
2018-11-20 15:00:00;SUR;0;32;32;1
2018-11-20 15:30:00;SUR;0;28;28;1
2018-11-20 16:00:00;SUR;0;25;25;1
2018-11-20 16:30:00;SUR;0;14;14;1
2018-11-20 17:00:00;SUR;0;18;18;1
2018-11-20 17:30:00;SUR;0;28;28;1
2018-11-20 18:00:00;SUR;0;22;22;1
2018-11-20 18:30:00;SUR;0;30;30;1
2018-11-20 19:00:00;SUR;0;32;32;1
2018-11-20 19:30:00;SUR;0;29;29;1
2018-11-20 20:00:00;SUR;0;22;22;1
2018-11-20 20:30:00;SUR;0;22;22;1
2018-11-20 21:00:00;SUR;0;32;32;1
2018-11-20 21:30:00;SUR;0;22;22;1
2018-11-20 22:00:00;SUR;0;15;15;1
2018-11-20 22:30:00;SUR;0;3;3;1
2018-11-20 23:00:00;SUR;0;11;11;1
2018-11-20 23:30:00;SUR;0;3;3;1
2018-11-21 00:00:00;SUR;0;2;2;1
2018-11-21 00:30:00;SUR;0;1;1;1
2018-11-21 01:00:00;SUR;0;1;1;1
2018-11-21 01:30:00;SUR;0;1;1;1
2018-11-21 02:00:00;SUR;0;1;1;1
2018-11-21 02:30:00;SUR;0;1;1;1
2018-11-21 03:00:00;SUR;0;3;3;1
2018-11-21 03:30:00;SUR;0;2;2;1
2018-11-21 04:00:00;SUR;0;2;2;1
2018-11-21 04:30:00;SUR;0;11;11;1
2018-11-21 05:00:00;SUR;0;8;8;1
2018-11-21 05:30:00;SUR;0;14;14;1
2018-11-21 06:00:00;SUR;0;20;20;1
2018-11-21 06:30:00;SUR;0;36;36;1
2018-11-21 07:00:00;SUR;0;22;22;1
2018-11-21 07:30:00;SUR;0;17;17;1
2018-11-21 08:00:00;SUR;0;34;34;1
2018-11-21 08:30:00;SUR;0;25;25;1
2018-11-21 09:00:00;SUR;0;38;38;1
2018-11-21 09:30:00;SUR;0;32;32;1
2018-11-21 10:00:00;SUR;0;26;26;1
2018-11-21 10:30:00;SUR;0;34;34;1
2018-11-21 11:00:00;SUR;0;38;38;1
2018-11-21 11:30:00;SUR;0;30;30;1
2018-11-21 12:00:00;SUR;0;28;28;1
2018-11-21 12:30:00;SUR;0;21;21;1
2018-11-21 13:00:00;SUR;0;25;25;1
2018-11-21 13:30:00;SUR;0;27;27;1
2018-11-21 14:00:00;SUR;0;36;36;1
2018-11-21 14:30:00;SUR;0;29;29;1
2018-11-21 15:00:00;SUR;0;33;33;1
2018-11-21 15:30:00;SUR;0;27;27;1
2018-11-21 15:51:00;SUR;0;10;10;1
2018-11-21 16:00:00;SUR;0;23;23;1
2018-11-21 16:30:00;SUR;0;12;12;1
2018-11-21 17:00:00;SUR;0;18;18;1
2018-11-21 17:30:00;SUR;0;26;26;1
2018-11-21 18:00:00;SUR;0;29;29;1
2018-11-21 18:30:00;SUR;0;24;24;1
2018-11-21 19:00:00;SUR;0;37;37;1
2018-11-21 19:30:00;SUR;0;32;32;1
2018-11-21 20:00:00;CONFLICTIVA;14;5;19;2
2018-11-21 20:30:00;NORTE;31;0;31;1
2018-11-21 21:00:00;NORTE;36;0;36;1
2018-11-21 21:30:00;NORTE;22;0;22;1
2018-11-21 22:00:00;NORTE;14;0;14;1
2018-11-21 22:30:00;NORTE;12;0;12;1
2018-11-21 23:00:00;NORTE;11;0;11;1
2018-11-21 23:30:00;NORTE;3;0;3;1
2018-11-22 00:00:00;NORTE;2;0;2;1
2018-11-22 01:00:00;NORTE;2;0;2;1
2018-11-22 01:30:00;NORTE;1;0;1;1
2018-11-22 02:30:00;NORTE;2;0;2;1
2018-11-22 03:00:00;NORTE;6;0;6;1
2018-11-22 03:30:00;NORTE;2;0;2;1
2018-11-22 04:00:00;NORTE;1;0;1;1
2018-11-22 04:30:00;NORTE;9;0;9;1
2018-11-22 05:00:00;NORTE;8;0;8;1
2018-11-22 05:30:00;NORTE;17;0;17;1
2018-11-22 06:00:00;NORTE;19;0;19;1
2018-11-22 06:30:00;NORTE;35;0;35;1
2018-11-22 07:00:00;NORTE;22;0;22;1
2018-11-22 07:30:00;NORTE;28;0;28;1
2018-11-22 08:00:00;NORTE;31;0;31;1
2018-11-22 08:30:00;NORTE;27;0;27;1
2018-11-22 09:00:00;NORTE;34;0;34;1
2018-11-22 09:30:00;NORTE;34;0;34;1
2018-11-22 10:00:00;NORTE;24;0;24;1
2018-11-22 10:30:00;NORTE;28;0;28;1
2018-11-22 11:00:00;NORTE;42;0;42;1
2018-11-22 11:30:00;NORTE;26;0;26;1
2018-11-22 12:00:00;NORTE;33;0;33;1
2018-11-22 12:30:00;NORTE;31;0;31;1
2018-11-22 13:00:00;NORTE;25;0;25;1
2018-11-22 13:30:00;NORTE;32;0;32;1
2018-11-22 14:00:00;NORTE;36;0;36;1
2018-11-22 14:30:00;NORTE;18;0;18;1
2018-11-22 14:49:00;NORTE;10;0;10;1
2018-11-22 15:00:00;NORTE;40;0;40;1
2018-11-22 15:30:00;NORTE;32;0;32;1
2018-11-22 16:00:00;NORTE;22;0;22;1
2018-11-22 16:30:00;NORTE;22;0;22;1
2018-11-22 17:00:00;NORTE;20;0;20;1
2018-11-22 17:30:00;NORTE;36;0;36;1
2018-11-22 18:00:00;NORTE;32;0;32;1
2018-11-22 18:30:00;NORTE;31;0;31;1
2018-11-22 19:00:00;NORTE;38;0;38;1
2018-11-22 19:30:00;NORTE;36;0;36;1
2018-11-22 20:00:00;NORTE;30;0;30;1
2018-11-22 20:30:00;NORTE;28;0;28;1
2018-11-22 21:00:00;NORTE;33;0;33;1
2018-11-22 21:30:00;NORTE;24;0;24;1
2018-11-22 22:00:00;NORTE;14;0;14;1
2018-11-22 22:30:00;NORTE;10;0;10;1
2018-11-22 23:00:00;NORTE;11;0;11;1
2018-11-22 23:30:00;NORTE;9;0;9;1
2018-11-23 00:00:00;NORTE;2;0;2;1
2018-11-23 01:30:00;NORTE;1;0;1;1
2018-11-23 02:00:00;NORTE;2;0;2;1
2018-11-23 02:30:00;NORTE;5;0;5;1
2018-11-23 03:00:00;NORTE;2;0;2;1
2018-11-23 04:00:00;NORTE;7;0;7;1
2018-11-23 04:30:00;NORTE;10;0;10;1
2018-11-23 05:00:00;NORTE;7;0;7;1
2018-11-23 05:30:00;SUR;0;7;7;1
2018-11-23 06:00:00;NORTE;21;0;21;1
2018-11-23 06:30:00;NORTE;37;0;37;1
2018-11-23 07:00:00;NORTE;21;0;21;1
2018-11-23 07:30:00;NORTE;14;0;14;1
2018-11-23 08:00:00;NORTE;40;0;40;1
2018-11-23 08:30:00;NORTE;23;0;23;1
2018-11-23 09:00:00;NORTE;40;0;40;1
2018-11-23 09:30:00;NORTE;32;0;32;1
2018-11-23 10:00:00;NORTE;24;0;24;1
2018-11-23 10:30:00;NORTE;36;0;36;1
2018-11-23 11:00:59;NORTE;1;0;1;1
2018-11-23 11:01:55;NORTE;1;0;1;1
2018-11-23 11:03:50;NORTE;2;0;2;1
2018-11-23 11:04:21;NORTE;1;0;1;1
2018-11-23 11:05:49;NORTE;1;0;1;1
2018-11-23 11:06:05;NORTE;1;0;1;1
2018-11-23 11:06:11;NORTE;1;0;1;1
2018-11-23 11:06:35;NORTE;1;0;1;1
2018-11-23 11:07:16;NORTE;1;0;1;1
2018-11-23 11:08:17;NORTE;1;0;1;1
2018-11-23 11:09:38;NORTE;1;0;1;1
2018-11-23 11:11:03;NORTE;1;0;1;1
2018-11-23 11:13:49;NORTE;1;0;1;1
2018-11-23 11:14:00;NORTE;1;0;1;1
2018-11-23 11:15:18;NORTE;1;0;1;1
2018-11-23 11:15:38;NORTE;1;0;1;1
2018-11-23 11:15:56;NORTE;1;0;1;1
2018-11-23 11:16:32;NORTE;1;0;1;1
2018-11-23 11:16:36;NORTE;1;0;1;1
2018-11-23 11:17:07;NORTE;1;0;1;1
2018-11-23 11:18:37;NORTE;1;0;1;1
2018-11-23 11:18:57;NORTE;1;0;1;1
2018-11-23 11:19:02;NORTE;1;0;1;1
2018-11-23 11:20:16;NORTE;1;0;1;1
2018-11-23 11:20:45;NORTE;1;0;1;1
2018-11-23 11:20:47;NORTE;1;0;1;1
2018-11-23 11:21:08;NORTE;1;0;1;1
2018-11-23 11:22:31;NORTE;1;0;1;1
2018-11-23 11:22:37;NORTE;1;0;1;1
2018-11-23 11:23:55;NORTE;1;0;1;1
2018-11-23 11:24:50;NORTE;1;0;1;1
2018-11-23 11:26:40;NORTE;1;0;1;1
2018-11-23 11:27:56;NORTE;1;0;1;1
2018-11-23 11:29:45;NORTE;1;0;1;1
2018-11-23 11:30:00;NORTE;22;0;22;1
2018-11-23 12:00:00;NORTE;29;0;29;1
2018-11-23 12:30:00;NORTE;26;0;26;1
2018-11-23 13:00:00;NORTE;24;0;24;1
2018-11-23 13:30:00;NORTE;34;0;34;1
2018-11-23 14:00:41;NORTE;1;0;1;1
2018-11-23 14:02:17;NORTE;1;0;1;1
2018-11-23 14:02:58;NORTE;1;0;1;1
2018-11-23 14:04:38;NORTE;1;0;1;1
2018-11-23 14:05:00;NORTE;1;0;1;1
2018-11-23 14:05:41;NORTE;1;0;1;1
2018-11-23 14:05:51;NORTE;1;0;1;1
2018-11-23 14:06:12;NORTE;1;0;1;1
2018-11-23 14:07:33;NORTE;1;0;1;1
2018-11-23 14:08:38;NORTE;2;0;2;1
2018-11-23 14:10:18;NORTE;1;0;1;1
2018-11-23 14:11:38;NORTE;1;0;1;1
2018-11-23 14:11:44;NORTE;1;0;1;1
2018-11-23 14:11:52;NORTE;1;0;1;1
2018-11-23 14:12:58;NORTE;1;0;1;1
2018-11-23 14:13:06;NORTE;1;0;1;1
2018-11-23 14:14:36;NORTE;1;0;1;1
2018-11-23 14:15:36;NORTE;1;0;1;1
2018-11-23 14:15:44;NORTE;1;0;1;1
2018-11-23 14:16:40;NORTE;1;0;1;1
2018-11-23 14:18:06;NORTE;1;0;1;1
2018-11-23 14:19:24;NORTE;1;0;1;1
2018-11-23 14:19:52;NORTE;1;0;1;1
2018-11-23 14:20:01;NORTE;1;0;1;1
2018-11-23 14:22:05;NORTE;1;0;1;1
2018-11-23 14:24:00;NORTE;1;0;1;1
2018-11-23 14:24:04;NORTE;1;0;1;1
2018-11-23 14:26:12;NORTE;1;0;1;1
2018-11-23 14:26:38;NORTE;1;0;1;1
2018-11-23 14:27:11;NORTE;1;0;1;1
2018-11-23 14:29:12;NORTE;1;0;1;1
2018-11-23 14:31:04;NORTE;1;0;1;1
2018-11-23 14:33:04;NORTE;1;0;1;1
2018-11-23 14:34:00;NORTE;1;0;1;1
2018-11-23 14:34:04;NORTE;1;0;1;1
2018-11-23 14:35:02;NORTE;1;0;1;1
2018-11-23 14:35:49;NORTE;1;0;1;1
2018-11-23 14:36:13;NORTE;1;0;1;1
2018-11-23 14:37:08;NORTE;1;0;1;1
2018-11-23 14:38:26;NORTE;1;0;1;1
2018-11-23 14:38:35;NORTE;1;0;1;1
2018-11-23 14:38:49;NORTE;1;0;1;1
2018-11-23 14:39:55;NORTE;1;0;1;1
2018-11-23 14:40:11;NORTE;1;0;1;1
2018-11-23 14:40:32;NORTE;1;0;1;1
2018-11-23 14:42:14;NORTE;1;0;1;1
2018-11-23 14:42:41;NORTE;1;0;1;1
2018-11-23 14:44:07;NORTE;1;0;1;1
2018-11-23 14:44:10;NORTE;1;0;1;1
2018-11-23 14:44:19;NORTE;1;0;1;1
2018-11-23 14:45:37;NORTE;1;0;1;1
2018-11-23 14:45:41;NORTE;1;0;1;1
2018-11-23 14:47:00;NORTE;1;0;1;1
2018-11-23 14:48:25;NORTE;1;0;1;1
2018-11-23 14:48:38;NORTE;1;0;1;1
2018-11-23 14:48:54;NORTE;1;0;1;1
2018-11-23 14:50:40;NORTE;1;0;1;1
2018-11-23 14:50:51;NORTE;1;0;1;1
2018-11-23 14:51:07;NORTE;1;0;1;1
2018-11-23 14:52:20;NORTE;1;0;1;1
2018-11-23 14:53:02;NORTE;1;0;1;1
2018-11-23 14:53:27;NORTE;1;0;1;1
2018-11-23 14:55:40;NORTE;1;0;1;1
2018-11-23 14:57:27;NORTE;1;0;1;1
2018-11-23 14:59:04;NORTE;1;0;1;1
2018-11-23 14:59:31;NORTE;1;0;1;1
2018-11-23 15:01:02;NORTE;1;0;1;1
2018-11-23 15:01:42;NORTE;1;0;1;1
2018-11-23 15:02:49;NORTE;1;0;1;1
2018-11-23 15:03:20;NORTE;1;0;1;1
2018-11-23 15:04:00;NORTE;1;0;1;1
2018-11-23 15:04:01;NORTE;1;0;1;1
2018-11-23 15:05:04;NORTE;1;0;1;1
2018-11-23 15:05:12;NORTE;1;0;1;1
2018-11-23 15:06:16;NORTE;1;0;1;1
2018-11-23 15:07:08;NORTE;1;0;1;1
2018-11-23 15:07:22;NORTE;1;0;1;1
2018-11-23 15:08:02;NORTE;1;0;1;1
2018-11-23 15:09:19;NORTE;1;0;1;1
2018-11-23 15:09:48;NORTE;1;0;1;1
2018-11-23 15:12:06;NORTE;1;0;1;1
2018-11-23 15:12:21;NORTE;1;0;1;1
2018-11-23 15:13:43;NORTE;1;0;1;1
2018-11-23 15:14:14;NORTE;1;0;1;1
2018-11-23 15:15:15;NORTE;1;0;1;1
2018-11-23 15:15:28;NORTE;1;0;1;1
2018-11-23 15:16:30;NORTE;1;0;1;1
2018-11-23 15:16:49;NORTE;1;0;1;1
2018-11-23 15:17:13;NORTE;1;0;1;1
2018-11-23 15:17:37;NORTE;1;0;1;1
2018-11-23 15:17:51;NORTE;1;0;1;1
2018-11-23 15:20:07;NORTE;1;0;1;1
2018-11-23 15:20:24;NORTE;1;0;1;1
2018-11-23 15:21:53;NORTE;1;0;1;1
2018-11-23 15:22:36;NORTE;1;0;1;1
2018-11-23 15:22:54;NORTE;1;0;1;1
2018-11-23 15:23:06;NORTE;1;0;1;1
2018-11-23 15:24:02;NORTE;1;0;1;1
2018-11-23 15:25:04;NORTE;1;0;1;1
2018-11-23 15:25:13;NORTE;1;0;1;1
2018-11-23 15:26:51;NORTE;1;0;1;1
2018-11-23 15:27:31;NORTE;1;0;1;1
2018-11-23 15:28:53;NORTE;1;0;1;1
2018-11-23 15:29:11;NORTE;1;0;1;1
2018-11-23 15:31:33;NORTE;1;0;1;1
2018-11-23 15:31:53;NORTE;1;0;1;1
2018-11-23 15:33:14;NORTE;1;0;1;1
2018-11-23 15:34:24;NORTE;1;0;1;1
2018-11-23 15:36:06;NORTE;1;0;1;1
2018-11-23 15:36:12;NORTE;1;0;1;1
2018-11-23 15:37:26;NORTE;1;0;1;1
2018-11-23 15:37:49;NORTE;1;0;1;1
2018-11-23 15:39:19;NORTE;1;0;1;1
2018-11-23 15:39:26;NORTE;1;0;1;1
2018-11-23 15:40:36;NORTE;1;0;1;1
2018-11-23 15:41:02;NORTE;1;0;1;1
2018-11-23 15:41:41;NORTE;1;0;1;1
2018-11-23 15:42:34;NORTE;1;0;1;1
2018-11-23 15:43:38;NORTE;2;0;2;1
2018-11-23 15:43:49;NORTE;1;0;1;1
2018-11-23 15:45:21;NORTE;1;0;1;1
2018-11-23 15:47:40;NORTE;1;0;1;1
2018-11-23 15:48:35;NORTE;1;0;1;1
2018-11-23 15:49:22;NORTE;1;0;1;1
2018-11-23 15:49:46;NORTE;1;0;1;1
2018-11-23 15:50:24;NORTE;1;0;1;1
2018-11-23 15:51:21;NORTE;1;0;1;1
2018-11-23 15:51:30;NORTE;1;0;1;1
2018-11-23 15:52:05;NORTE;1;0;1;1
2018-11-23 15:52:33;NORTE;1;0;1;1
2018-11-23 15:54:22;NORTE;1;0;1;1
2018-11-23 15:55:05;NORTE;1;0;1;1
2018-11-23 15:56:52;NORTE;1;0;1;1
2018-11-23 15:57:55;NORTE;1;0;1;1
2018-11-23 15:59:13;NORTE;1;0;1;1
2018-11-23 16:00:20;NORTE;1;0;1;1
2018-11-23 16:02:19;NORTE;1;0;1;1
2018-11-23 16:03:56;NORTE;1;0;1;1
2018-11-23 16:04:30;NORTE;1;0;1;1
2018-11-23 16:07:05;NORTE;1;0;1;1
2018-11-23 16:08:30;NORTE;1;0;1;1
2018-11-23 16:10:14;NORTE;1;0;1;1
2018-11-23 16:10:37;NORTE;1;0;1;1
2018-11-23 16:12:03;NORTE;1;0;1;1
2018-11-23 16:12:36;NORTE;1;0;1;1
2018-11-23 16:14:09;NORTE;1;0;1;1
2018-11-23 16:15:54;NORTE;1;0;1;1
2018-11-23 16:16:23;NORTE;1;0;1;1
2018-11-23 16:17:37;NORTE;1;0;1;1
2018-11-23 16:19:29;NORTE;1;0;1;1
2018-11-23 16:19:36;NORTE;1;0;1;1
2018-11-23 16:21:18;NORTE;1;0;1;1
2018-11-23 16:22:02;NORTE;1;0;1;1
2018-11-23 16:23:17;NORTE;1;0;1;1
2018-11-23 16:24:03;NORTE;1;0;1;1
2018-11-23 16:25:49;NORTE;1;0;1;1
2018-11-23 16:26:46;NORTE;1;0;1;1
2018-11-23 16:27:27;NORTE;1;0;1;1
2018-11-23 16:29:16;NORTE;1;0;1;1
2018-11-23 16:30:40;NORTE;1;0;1;1
2018-11-23 16:31:16;NORTE;1;0;1;1
2018-11-23 16:31:57;NORTE;1;0;1;1
2018-11-23 16:34:24;NORTE;1;0;1;1
2018-11-23 16:37:57;NORTE;1;0;1;1
2018-11-23 16:43:48;NORTE;1;0;1;1
2018-11-23 16:44:48;NORTE;1;0;1;1
2018-11-23 16:44:55;NORTE;1;0;1;1
2018-11-23 16:45:30;NORTE;1;0;1;1
2018-11-23 16:46:56;NORTE;1;0;1;1
2018-11-23 16:47:09;NORTE;1;0;1;1
2018-11-23 16:48:58;NORTE;1;0;1;1
2018-11-23 16:49:55;NORTE;1;0;1;1
2018-11-23 16:51:18;NORTE;1;0;1;1
2018-11-23 16:51:39;NORTE;1;0;1;1
2018-11-23 16:52:28;NORTE;1;0;1;1
2018-11-23 16:53:07;NORTE;1;0;1;1
2018-11-23 16:54:56;NORTE;1;0;1;1
2018-11-23 16:57:15;NORTE;1;0;1;1
2018-11-23 16:58:38;NORTE;1;0;1;1
2018-11-23 17:00:28;NORTE;2;0;2;1
2018-11-23 17:00:48;NORTE;1;0;1;1
2018-11-23 17:01:21;NORTE;1;0;1;1
2018-11-23 17:02:48;NORTE;1;0;1;1
2018-11-23 17:13:41;NORTE;1;0;1;1
2018-11-23 17:14:12;NORTE;1;0;1;1
2018-11-23 17:16:16;NORTE;1;0;1;1
2018-11-23 17:17:16;NORTE;1;0;1;1
2018-11-23 17:17:45;NORTE;1;0;1;1
2018-11-23 17:19:25;NORTE;1;0;1;1
2018-11-23 17:21:34;NORTE;1;0;1;1
2018-11-23 17:22:06;NORTE;1;0;1;1
2018-11-23 17:22:32;NORTE;1;0;1;1
2018-11-23 17:23:26;NORTE;1;0;1;1
2018-11-23 17:24:28;NORTE;1;0;1;1
2018-11-23 17:24:34;NORTE;1;0;1;1
2018-11-23 17:24:59;NORTE;1;0;1;1
2018-11-23 17:26:05;NORTE;1;0;1;1
2018-11-23 17:27:33;NORTE;1;0;1;1
2018-11-23 17:28:57;NORTE;1;0;1;1
2018-11-23 17:29:01;NORTE;1;0;1;1
2018-11-23 17:30:12;NORTE;1;0;1;1
2018-11-23 17:31:13;NORTE;1;0;1;1
2018-11-23 17:31:58;NORTE;1;0;1;1
2018-11-23 17:32:18;NORTE;1;0;1;1
2018-11-23 17:33:42;NORTE;1;0;1;1
2018-11-23 17:34:16;NORTE;1;0;1;1
2018-11-23 17:34:43;NORTE;1;0;1;1
2018-11-23 17:36:11;NORTE;1;0;1;1
2018-11-23 17:36:44;NORTE;1;0;1;1
2018-11-23 17:37:22;NORTE;1;0;1;1
2018-11-23 17:37:56;NORTE;1;0;1;1
2018-11-23 17:38:10;NORTE;1;0;1;1
2018-11-23 17:39:53;NORTE;1;0;1;1
2018-11-23 17:40:45;NORTE;1;0;1;1
2018-11-23 17:42:21;NORTE;1;0;1;1
2018-11-23 17:43:11;NORTE;1;0;1;1
2018-11-23 17:46:19;NORTE;1;0;1;1
2018-11-23 17:46:32;NORTE;1;0;1;1
2018-11-23 17:47:28;NORTE;1;0;1;1
2018-11-23 17:47:40;NORTE;1;0;1;1
2018-11-23 17:48:45;NORTE;1;0;1;1
2018-11-23 17:50:04;NORTE;1;0;1;1
2018-11-23 17:52:28;NORTE;1;0;1;1
2018-11-23 17:53:20;NORTE;1;0;1;1
2018-11-23 17:53:33;NORTE;1;0;1;1
2018-11-23 17:53:45;NORTE;1;0;1;1
2018-11-23 17:54:51;NORTE;1;0;1;1
2018-11-23 17:56:00;NORTE;1;0;1;1
2018-11-23 17:57:01;NORTE;1;0;1;1
2018-11-23 17:57:54;NORTE;1;0;1;1
2018-11-23 17:59:16;NORTE;1;0;1;1
2018-11-23 18:00:04;NORTE;1;0;1;1
2018-11-23 18:01:29;NORTE;1;0;1;1
2018-11-23 18:01:41;NORTE;1;0;1;1
2018-11-23 18:03:08;NORTE;1;0;1;1
2018-11-23 18:03:32;NORTE;1;0;1;1
2018-11-23 18:04:15;NORTE;1;0;1;1
2018-11-23 18:05:12;NORTE;1;0;1;1
2018-11-23 18:05:29;NORTE;1;0;1;1
2018-11-23 18:06:47;NORTE;1;0;1;1
2018-11-23 18:07:32;NORTE;1;0;1;1
2018-11-23 18:08:18;NORTE;1;0;1;1
2018-11-23 18:08:58;NORTE;1;0;1;1
2018-11-23 18:09:16;NORTE;1;0;1;1
2018-11-23 18:10:45;NORTE;1;0;1;1
2018-11-23 18:11:22;NORTE;1;0;1;1
2018-11-23 18:13:10;NORTE;1;0;1;1
2018-11-23 18:13:49;NORTE;1;0;1;1
2018-11-23 18:16:22;NORTE;1;0;1;1
2018-11-23 18:16:28;NORTE;1;0;1;1
2018-11-23 18:18:08;NORTE;1;0;1;1
2018-11-23 18:19:55;NORTE;1;0;1;1
2018-11-23 18:20:39;NORTE;1;0;1;1
2018-11-23 18:22:34;NORTE;1;0;1;1
2018-11-23 18:23:03;NORTE;1;0;1;1
2018-11-23 18:24:50;NORTE;1;0;1;1
2018-11-23 18:25:46;NORTE;1;0;1;1
2018-11-23 18:26:01;NORTE;1;0;1;1
2018-11-23 18:26:43;NORTE;1;0;1;1
2018-11-23 18:28:08;NORTE;1;0;1;1
2018-11-23 18:30:00;NORTE;29;0;29;1
2018-11-23 19:00:00;NORTE;42;0;42;1
2018-11-23 19:30:00;NORTE;32;0;32;1
2018-11-23 20:00:00;NORTE;29;0;29;1
2018-11-23 20:30:00;NORTE;23;0;23;1
2018-11-23 21:00:00;NORTE;34;0;34;1
2018-11-23 21:30:00;NORTE;27;0;27;1
2018-11-23 22:00:00;NORTE;13;0;13;1
2018-11-23 22:30:00;NORTE;8;0;8;1
2018-11-23 23:00:00;NORTE;14;0;14;1
2018-11-23 23:30:00;NORTE;3;0;3;1
2018-11-24 00:00:00;NORTE;1;0;1;1
2018-11-24 02:30:00;NORTE;3;0;3;1
2018-11-24 03:00:00;NORTE;5;0;5;1
2018-11-24 03:30:00;NORTE;1;0;1;1
2018-11-24 04:00:00;NORTE;3;0;3;1
2018-11-24 04:30:00;NORTE;5;0;5;1
2018-11-24 05:00:00;NORTE;4;0;4;1
2018-11-24 05:18:00;NORTE;3;0;3;1
2018-11-24 05:30:00;NORTE;12;0;12;1
2018-11-24 06:00:00;NORTE;12;0;12;1
2018-11-24 06:24:00;NORTE;2;0;2;1
2018-11-24 06:30:00;NORTE;17;0;17;1
2018-11-24 06:44:00;NORTE;14;0;14;1
2018-11-24 07:00:00;NORTE;7;0;7;1
2018-11-24 07:15:00;NORTE;11;0;11;1
2018-11-24 07:30:00;NORTE;16;0;16;1
2018-11-24 08:00:00;NORTE;37;0;37;1
2018-11-24 08:30:00;NORTE;11;0;11;1
2018-11-24 08:44:00;NORTE;8;0;8;1
2018-11-24 09:00:00;NORTE;29;0;29;1
2018-11-24 09:30:00;NORTE;29;0;29;1
2018-11-24 10:00:00;NORTE;25;0;25;1
2018-11-24 10:30:00;NORTE;41;0;41;1
2018-11-24 11:00:00;NORTE;36;0;36;1
2018-11-24 11:30:00;NORTE;37;0;37;1
2018-11-24 12:00:00;NORTE;27;0;27;1
2018-11-24 12:30:00;NORTE;30;0;30;1
2018-11-24 13:00:00;NORTE;27;0;27;1
2018-11-24 13:30:00;NORTE;31;0;31;1
2018-11-24 14:00:00;NORTE;33;0;33;1
2018-11-24 14:30:00;NORTE;30;0;30;1
2018-11-24 15:00:00;NORTE;34;0;34;1
2018-11-24 15:30:00;NORTE;24;0;24;1
2018-11-24 16:00:00;NORTE;18;0;18;1
2018-11-24 16:30:00;NORTE;21;0;21;1
2018-11-24 17:00:00;NORTE;21;0;21;1
2018-11-24 17:30:00;NORTE;31;0;31;1
2018-11-24 18:00:00;NORTE;14;0;14;1
2018-11-24 18:30:00;NORTE;20;0;20;1
2018-11-24 19:00:15;NORTE;1;0;1;1
2018-11-24 19:00:42;NORTE;1;0;1;1
2018-11-24 19:00:56;NORTE;1;0;1;1
2018-11-24 19:02:31;NORTE;1;0;1;1
2018-11-24 19:03:41;NORTE;1;0;1;1
2018-11-24 19:04:39;NORTE;1;0;1;1
2018-11-24 19:05:05;NORTE;1;0;1;1
2018-11-24 19:05:38;NORTE;1;0;1;1
2018-11-24 19:06:00;NORTE;1;0;1;1
2018-11-24 19:07:03;NORTE;1;0;1;1
2018-11-24 19:07:45;NORTE;1;0;1;1
2018-11-24 19:07:53;NORTE;1;0;1;1
2018-11-24 19:08:28;NORTE;1;0;1;1
2018-11-24 19:09:00;NORTE;1;0;1;1
2018-11-24 19:10:00;NORTE;1;0;1;1
2018-11-24 19:10:03;NORTE;1;0;1;1
2018-11-24 19:10:23;NORTE;1;0;1;1
2018-11-24 19:11:32;NORTE;1;0;1;1
2018-11-24 19:11:47;NORTE;1;0;1;1
2018-11-24 19:13:15;NORTE;1;0;1;1
2018-11-24 19:13:35;NORTE;1;0;1;1
2018-11-24 19:14:21;NORTE;1;0;1;1
2018-11-24 19:15:16;NORTE;1;0;1;1
2018-11-24 19:15:53;NORTE;1;0;1;1
2018-11-24 19:16:52;NORTE;1;0;1;1
2018-11-24 19:17:55;NORTE;1;0;1;1
2018-11-24 19:18:37;NORTE;1;0;1;1
2018-11-24 19:20:13;NORTE;1;0;1;1
2018-11-24 19:21:55;NORTE;1;0;1;1
2018-11-24 19:22:06;NORTE;1;0;1;1
2018-11-24 19:24:07;NORTE;1;0;1;1
2018-11-24 19:26:26;NORTE;1;0;1;1
2018-11-24 19:27:22;NORTE;1;0;1;1
2018-11-24 19:29:15;NORTE;1;0;1;1
2018-11-24 19:30:00;NORTE;17;0;17;1
2018-11-24 20:00:00;NORTE;18;0;18;1
2018-11-24 20:30:00;NORTE;22;0;22;1
2018-11-24 21:00:00;NORTE;15;0;15;1
2018-11-24 21:30:00;NORTE;17;0;17;1
2018-11-24 22:00:00;NORTE;9;0;9;1
2018-11-24 22:30:00;NORTE;4;0;4;1
2018-11-24 23:00:00;NORTE;12;0;12;1
2018-11-24 23:30:00;NORTE;3;0;3;1
2018-11-25 00:00:00;NORTE;1;0;1;1
2018-11-25 00:30:00;NORTE;1;0;1;1
2018-11-25 02:00:00;NORTE;3;0;3;1
2018-11-25 03:00:00;NORTE;2;0;2;1
2018-11-25 03:30:00;NORTE;1;0;1;1
2018-11-25 04:00:00;NORTE;2;0;2;1
2018-11-25 04:30:00;NORTE;5;0;5;1
2018-11-25 05:00:00;NORTE;8;0;8;1
2018-11-25 05:30:00;NORTE;10;0;10;1
2018-11-25 06:00:00;NORTE;17;0;17;1
2018-11-25 06:30:00;NORTE;27;0;27;1
2018-11-25 07:00:00;NORTE;9;0;9;1
2018-11-25 07:30:00;NORTE;20;0;20;1
2018-11-25 08:00:00;NORTE;15;0;15;1
2018-11-25 08:16:00;NORTE;13;0;13;1
2018-11-25 08:30:00;NORTE;12;0;12;1
2018-11-25 08:45:00;NORTE;10;0;10;1
2018-11-25 09:00:00;CONFLICTIVA;11;20;31;2
2018-11-25 09:30:00;SUR;0;35;35;1
2018-11-25 10:00:00;SUR;0;28;28;1
2018-11-25 10:30:00;SUR;0;29;29;1
2018-11-25 11:00:00;SUR;0;31;31;1
2018-11-25 11:30:00;SUR;0;27;27;1
2018-11-25 12:00:00;SUR;0;25;25;1
2018-11-25 12:30:00;SUR;0;30;30;1
2018-11-25 13:00:00;SUR;0;30;30;1
2018-11-25 13:30:00;SUR;0;23;23;1
2018-11-25 14:00:00;SUR;0;38;38;1
2018-11-25 14:30:00;SUR;0;32;32;1
2018-11-25 15:00:00;SUR;0;37;37;1
2018-11-25 15:30:00;SUR;0;30;30;1
2018-11-25 16:00:00;SUR;0;24;24;1
2018-11-25 16:30:00;SUR;0;18;18;1
2018-11-25 17:00:00;SUR;0;18;18;1
2018-11-25 17:30:00;SUR;0;32;32;1
2018-11-25 18:00:00;SUR;0;29;29;1
2018-11-25 18:30:00;SUR;0;30;30;1
2018-11-25 19:00:00;SUR;0;40;40;1
2018-11-25 19:30:00;SUR;0;39;39;1
2018-11-25 20:00:00;SUR;0;28;28;1
2018-11-25 20:30:00;SUR;0;29;29;1
2018-11-25 21:00:00;SUR;0;25;25;1
2018-11-25 21:30:00;SUR;0;28;28;1
2018-11-25 22:00:00;SUR;0;17;17;1
2018-11-25 22:30:00;SUR;0;19;19;1
2018-11-25 23:00:00;SUR;0;10;10;1
2018-11-25 23:30:00;SUR;0;6;6;1
2018-11-26 00:00:00;SUR;0;3;3;1
2018-11-26 00:30:00;SUR;0;2;2;1
2018-11-26 01:08:00;SUR;0;1;1;1
2018-11-26 01:30:00;SUR;0;2;2;1
2018-11-26 02:00:00;NORTE;2;0;2;1
2018-11-26 03:00:00;NORTE;5;0;5;1
2018-11-26 03:30:00;NORTE;3;0;3;1
2018-11-26 04:00:00;NORTE;4;0;4;1
2018-11-26 04:30:00;NORTE;7;0;7;1
2018-11-26 05:00:00;NORTE;5;0;5;1
2018-11-26 05:30:00;NORTE;10;0;10;1
2018-11-26 06:00:00;NORTE;24;0;24;1
2018-11-26 06:30:00;NORTE;44;0;44;1
2018-11-26 07:00:00;NORTE;16;0;16;1
2018-11-26 07:30:00;NORTE;21;0;21;1
2018-11-26 08:00:00;NORTE;30;0;30;1
2018-11-26 08:30:00;NORTE;23;0;23;1
2018-11-26 09:00:00;NORTE;34;0;34;1
2018-11-26 09:30:00;NORTE;33;0;33;1
2018-11-26 10:00:00;NORTE;25;0;25;1
2018-11-26 10:30:00;NORTE;39;0;39;1
2018-11-26 11:00:00;NORTE;38;0;38;1
2018-11-26 11:30:00;NORTE;30;0;30;1
2018-11-26 12:00:00;NORTE;28;0;28;1
2018-11-26 12:30:00;NORTE;27;0;27;1
2018-11-26 13:00:00;NORTE;28;0;28;1
2018-11-26 13:30:00;NORTE;28;0;28;1
2018-11-26 14:00:00;NORTE;34;0;34;1
2018-11-26 14:30:00;NORTE;32;0;32;1
2018-11-26 15:00:00;NORTE;36;0;36;1
2018-11-26 15:30:00;NORTE;29;0;29;1
2018-11-26 16:00:00;NORTE;27;0;27;1
2018-11-26 16:30:00;NORTE;21;0;21;1
2018-11-26 17:00:00;NORTE;18;0;18;1
2018-11-26 17:30:00;NORTE;38;0;38;1
2018-11-26 18:00:00;NORTE;30;0;30;1
2018-11-26 18:30:00;NORTE;35;0;35;1
2018-11-26 19:00:00;NORTE;33;0;33;1
2018-11-26 19:30:00;NORTE;35;0;35;1
2018-11-26 20:00:00;NORTE;23;0;23;1
2018-11-26 20:30:00;NORTE;31;0;31;1
2018-11-26 21:00:00;NORTE;27;0;27;1
2018-11-26 21:30:00;NORTE;23;0;23;1
2018-11-26 22:00:00;NORTE;17;0;17;1
2018-11-26 22:30:00;NORTE;8;0;8;1
2018-11-26 23:00:00;NORTE;7;0;7;1
2018-11-26 23:30:00;NORTE;4;0;4;1
2018-11-27 00:00:00;NORTE;1;0;1;1
2018-11-27 02:00:00;NORTE;1;0;1;1
2018-11-27 03:00:00;NORTE;6;0;6;1
2018-11-27 03:30:00;NORTE;3;0;3;1
2018-11-27 04:00:00;NORTE;2;0;2;1
2018-11-27 04:30:00;NORTE;6;0;6;1
2018-11-27 05:00:00;NORTE;10;0;10;1
2018-11-27 05:30:00;NORTE;18;0;18;1
2018-11-27 06:00:00;NORTE;19;0;19;1
2018-11-27 06:30:00;NORTE;37;0;37;1
2018-11-27 07:00:00;NORTE;24;0;24;1
2018-11-27 07:30:00;NORTE;24;0;24;1
2018-11-27 08:00:00;NORTE;27;0;27;1
2018-11-27 08:30:00;NORTE;25;0;25;1
2018-11-27 09:00:00;NORTE;35;0;35;1
2018-11-27 09:30:00;NORTE;38;0;38;1
2018-11-27 10:00:00;NORTE;25;0;25;1
2018-11-27 10:30:00;NORTE;36;0;36;1
2018-11-27 11:00:00;NORTE;31;0;31;1
2018-11-27 11:30:00;NORTE;26;0;26;1
2018-11-27 12:00:00;NORTE;32;0;32;1
2018-11-27 12:30:00;NORTE;22;0;22;1
2018-11-27 13:00:00;NORTE;26;0;26;1
2018-11-27 13:30:00;NORTE;26;0;26;1
2018-11-27 14:00:00;NORTE;34;0;34;1
2018-11-27 14:30:00;NORTE;28;0;28;1
2018-11-27 15:00:00;NORTE;36;0;36;1
2018-11-27 15:30:00;NORTE;30;0;30;1
2018-11-27 16:00:00;NORTE;33;0;33;1
2018-11-27 16:30:00;NORTE;15;0;15;1
2018-11-27 17:00:00;NORTE;22;0;22;1
2018-11-27 17:30:00;NORTE;34;0;34;1
2018-11-27 18:00:00;NORTE;24;0;24;1
2018-11-27 18:30:00;NORTE;24;0;24;1
2018-11-27 19:00:00;NORTE;35;0;35;1
2018-11-27 19:30:00;NORTE;27;0;27;1
2018-11-27 20:00:00;NORTE;24;0;24;1
2018-11-27 20:30:00;NORTE;26;0;26;1
2018-11-27 21:00:00;NORTE;29;0;29;1
2018-11-27 21:30:00;NORTE;21;0;21;1
2018-11-27 22:00:00;NORTE;18;0;18;1
2018-11-27 22:30:00;NORTE;7;0;7;1
2018-11-27 23:00:00;NORTE;9;0;9;1
2018-11-27 23:30:00;NORTE;2;0;2;1
2018-11-28 00:00:00;NORTE;3;0;3;1
2018-11-28 00:30:00;NORTE;1;0;1;1
2018-11-28 02:00:00;NORTE;1;0;1;1
2018-11-28 02:30:00;NORTE;2;0;2;1
2018-11-28 03:00:00;NORTE;3;0;3;1
2018-11-28 03:30:00;NORTE;1;0;1;1
2018-11-28 04:00:00;NORTE;2;0;2;1
2018-11-28 04:30:00;NORTE;7;0;7;1
2018-11-28 05:00:00;NORTE;9;0;9;1
2018-11-28 05:30:00;NORTE;15;0;15;1
2018-11-28 06:00:00;NORTE;17;0;17;1
2018-11-28 06:30:00;NORTE;33;0;33;1
2018-11-28 07:00:00;NORTE;25;0;25;1
2018-11-28 07:30:00;NORTE;26;0;26;1
2018-11-28 08:00:00;NORTE;32;0;32;1
2018-11-28 08:30:00;NORTE;27;0;27;1
2018-11-28 09:00:00;NORTE;36;0;36;1
2018-11-28 09:30:00;NORTE;30;0;30;1
2018-11-28 10:00:00;NORTE;21;0;21;1
2018-11-28 10:30:00;NORTE;36;0;36;1
2018-11-28 11:00:00;NORTE;36;0;36;1
2018-11-28 11:30:00;NORTE;28;0;28;1
2018-11-28 12:00:00;NORTE;28;0;28;1
2018-11-28 12:30:00;NORTE;33;0;33;1
2018-11-28 13:00:00;NORTE;21;0;21;1
2018-11-28 13:30:00;NORTE;29;0;29;1
2018-11-28 14:00:00;NORTE;37;0;37;1
2018-11-28 14:30:00;NORTE;38;0;38;1
2018-11-28 15:00:00;NORTE;37;0;37;1
2018-11-28 15:30:00;NORTE;31;0;31;1
2018-11-28 16:00:00;NORTE;20;0;20;1
2018-11-28 16:30:00;NORTE;12;0;12;1
2018-11-28 17:00:00;NORTE;26;0;26;1
2018-11-28 17:30:00;NORTE;29;0;29;1
2018-11-28 18:00:00;NORTE;25;0;25;1
2018-11-28 18:30:00;NORTE;26;0;26;1
2018-11-28 19:00:00;NORTE;39;0;39;1
2018-11-28 19:30:00;NORTE;32;0;32;1
2018-11-28 20:00:00;NORTE;24;0;24;1
2018-11-28 20:30:00;NORTE;31;0;31;1
2018-11-28 21:00:00;NORTE;33;0;33;1
2018-11-28 21:30:00;NORTE;26;0;26;1
2018-11-28 22:00:00;NORTE;12;0;12;1
2018-11-28 22:30:00;NORTE;9;0;9;1
2018-11-28 23:00:00;NORTE;10;0;10;1
2018-11-28 23:30:00;NORTE;5;0;5;1
2018-11-29 00:00:00;NORTE;2;0;2;1
2018-11-29 01:00:00;NORTE;2;0;2;1
2018-11-29 01:30:00;NORTE;1;0;1;1
2018-11-29 02:00:00;NORTE;1;0;1;1
2018-11-29 02:30:00;NORTE;2;0;2;1
2018-11-29 03:00:00;NORTE;3;0;3;1
2018-11-29 03:30:00;NORTE;2;0;2;1
2018-11-29 04:00:00;NORTE;4;0;4;1
2018-11-29 04:30:00;NORTE;6;0;6;1
2018-11-29 05:00:00;NORTE;9;0;9;1
2018-11-29 05:30:00;NORTE;17;0;17;1
2018-11-29 06:00:00;NORTE;19;0;19;1
2018-11-29 06:30:00;NORTE;35;0;35;1
2018-11-29 07:00:00;NORTE;19;0;19;1
2018-11-29 07:30:00;NORTE;25;0;25;1
2018-11-29 08:00:00;NORTE;28;0;28;1
2018-11-29 08:30:00;NORTE;26;0;26;1
2018-11-29 09:00:00;NORTE;36;0;36;1
2018-11-29 09:30:00;NORTE;2;0;2;1
2018-11-29 10:30:00;NORTE;33;0;33;1
2018-11-29 11:00:00;NORTE;36;0;36;1
2018-11-29 11:30:00;NORTE;32;0;32;1
2018-11-29 12:00:00;NORTE;28;0;28;1
2018-11-29 12:30:00;NORTE;31;0;31;1
2018-11-29 13:00:00;NORTE;25;0;25;1
2018-11-29 13:30:00;NORTE;36;0;36;1
2018-11-29 14:00:00;NORTE;39;0;39;1
2018-11-29 14:30:00;NORTE;30;0;30;1
2018-11-29 15:00:00;NORTE;10;0;10;1
2018-11-29 15:30:00;NORTE;2;0;2;1
2018-11-29 16:00:00;NORTE;26;0;26;1
2018-11-29 16:30:00;NORTE;22;0;22;1
2018-11-29 17:00:00;NORTE;23;0;23;1
2018-11-29 17:30:00;NORTE;34;0;34;1
2018-11-29 18:00:00;NORTE;29;0;29;1
2018-11-29 18:30:00;NORTE;29;0;29;1
2018-11-29 19:00:00;NORTE;42;0;42;1
2018-11-29 19:30:00;NORTE;31;0;31;1
2018-11-29 20:00:00;NORTE;29;0;29;1
2018-11-29 20:30:00;NORTE;14;0;14;1
2018-11-29 20:48:00;NORTE;13;0;13;1
2018-11-29 21:00:00;NORTE;3;0;3;1
2018-11-29 21:05:00;NORTE;30;0;30;1
2018-11-29 21:30:00;NORTE;25;0;25;1
2018-11-29 22:00:00;NORTE;11;0;11;1
2018-11-29 22:30:00;NORTE;14;0;14;1
2018-11-29 23:00:00;NORTE;14;0;14;1
2018-11-29 23:30:00;NORTE;7;0;7;1
2018-11-30 01:00:00;NORTE;1;0;1;1
2018-11-30 02:00:00;NORTE;2;0;2;1
2018-11-30 02:30:00;NORTE;1;0;1;1
2018-11-30 03:00:00;NORTE;4;0;4;1
2018-11-30 03:30:00;NORTE;3;0;3;1
2018-11-30 04:30:00;NORTE;9;0;9;1
2018-11-30 05:00:00;NORTE;11;0;11;1
2018-11-30 05:30:00;NORTE;15;0;15;1
2018-11-30 06:00:00;NORTE;13;0;13;1
2018-11-30 06:22:00;NORTE;7;0;7;1
2018-11-30 06:30:00;NORTE;37;1;38;1
2018-11-30 07:00:00;NORTE;11;0;11;1
2018-11-30 07:18:00;NORTE;7;0;7;1
2018-11-30 07:30:00;NORTE;24;0;24;1
2018-11-30 08:00:00;NORTE;15;0;15;1
2018-11-30 08:13:00;NORTE;21;0;21;1
2018-11-30 08:30:00;NORTE;6;0;6;1
2018-11-30 08:38:00;NORTE;23;0;23;1
2018-11-30 09:00:00;NORTE;26;0;26;1
2018-11-30 09:30:00;NORTE;13;0;13;1
2018-11-30 09:42:00;NORTE;19;0;19;1
2018-11-30 10:00:00;NORTE;29;0;29;1
2018-11-30 10:30:00;NORTE;37;0;37;1
2018-11-30 11:00:00;NORTE;36;0;36;1
2018-11-30 11:30:00;NORTE;33;0;33;1
2018-11-30 12:00:00;NORTE;29;0;29;1
2018-11-30 12:30:00;NORTE;31;0;31;1
2018-11-30 13:00:00;NORTE;23;0;23;1
2018-11-30 13:30:00;NORTE;30;0;30;1
2018-11-30 14:00:00;NORTE;32;0;32;1
2018-11-30 14:30:00;NORTE;26;1;27;1
2018-11-30 15:00:00;NORTE;50;0;50;1
2018-11-30 15:30:00;NORTE;25;0;25;1
2018-11-30 16:00:00;NORTE;30;0;30;1
2018-11-30 16:30:00;NORTE;21;0;21;1
2018-11-30 17:00:00;NORTE;26;0;26;1
2018-11-30 17:30:00;NORTE;35;0;35;1
2018-11-30 18:00:00;NORTE;26;0;26;1
2018-11-30 18:30:00;NORTE;32;0;32;1
2018-11-30 19:00:00;NORTE;41;0;41;1
2018-11-30 19:30:00;NORTE;31;0;31;1
2018-11-30 20:00:00;NORTE;28;0;28;1
2018-11-30 20:30:00;NORTE;23;0;23;1
2018-11-30 21:00:00;NORTE;31;0;31;1
2018-11-30 21:30:00;NORTE;24;0;24;1
2018-11-30 22:00:00;NORTE;5;0;5;1
2018-11-30 22:30:00;NORTE;11;0;11;1
2018-11-30 23:00:00;NORTE;16;0;16;1
2018-11-30 23:30:00;NORTE;6;0;6;1
2018-12-01 00:00:00;NORTE;1;0;1;1
2018-12-01 01:30:00;NORTE;1;0;1;1
2018-12-01 02:30:00;NORTE;1;0;1;1
2018-12-01 03:00:00;NORTE;2;0;2;1
2018-12-01 03:30:00;NORTE;5;0;5;1
2018-12-01 04:00:00;NORTE;2;0;2;1
2018-12-01 04:30:00;NORTE;7;0;7;1
2018-12-01 05:00:00;NORTE;9;0;9;1
2018-12-01 05:30:00;NORTE;10;0;10;1
2018-12-01 06:00:00;NORTE;20;0;20;1
2018-12-01 06:30:00;NORTE;29;0;29;1
2018-12-01 07:00:00;NORTE;15;0;15;1
2018-12-01 07:30:00;NORTE;24;0;24;1
2018-12-01 08:00:00;NORTE;35;0;35;1
2018-12-01 08:30:00;NORTE;28;0;28;1
2018-12-01 09:00:00;NORTE;33;0;33;1
2018-12-01 09:30:00;NORTE;30;0;30;1
2018-12-01 10:00:00;NORTE;25;0;25;1
2018-12-01 10:30:00;NORTE;36;0;36;1
2018-12-01 11:00:00;NORTE;32;0;32;1
2018-12-01 11:30:00;NORTE;29;0;29;1
2018-12-01 12:00:00;NORTE;25;0;25;1
2018-12-01 12:30:00;NORTE;23;0;23;1
2018-12-01 13:00:00;NORTE;28;0;28;1
2018-12-01 13:30:00;NORTE;32;0;32;1
2018-12-01 14:00:00;NORTE;30;0;30;1
2018-12-01 14:30:00;NORTE;23;0;23;1
2018-12-01 15:00:00;NORTE;36;0;36;1
2018-12-01 15:30:00;NORTE;26;0;26;1
2018-12-01 16:00:00;NORTE;22;0;22;1
2018-12-01 16:30:00;NORTE;15;0;15;1
2018-12-01 17:00:00;NORTE;21;0;21;1
2018-12-01 17:30:00;NORTE;25;0;25;1
2018-12-01 18:00:00;NORTE;22;0;22;1
2018-12-01 18:30:00;NORTE;21;0;21;1
2018-12-01 19:00:00;NORTE;31;0;31;1
2018-12-01 19:30:00;NORTE;16;0;16;1
2018-12-01 20:00:00;NORTE;17;0;17;1
2018-12-01 20:30:00;NORTE;23;0;23;1
2018-12-01 21:00:00;NORTE;19;0;19;1
2018-12-01 21:30:00;NORTE;14;0;14;1
2018-12-01 22:00:00;NORTE;12;0;12;1
2018-12-01 22:30:00;NORTE;6;0;6;1
2018-12-01 23:00:00;NORTE;7;0;7;1
2018-12-01 23:30:00;NORTE;7;0;7;1
2018-12-02 00:30:00;NORTE;1;0;1;1
2018-12-02 01:30:00;NORTE;2;0;2;1
2018-12-02 02:00:00;NORTE;1;0;1;1
2018-12-02 02:30:00;NORTE;1;0;1;1
2018-12-02 03:30:00;NORTE;4;0;4;1
2018-12-02 04:00:00;NORTE;1;0;1;1
2018-12-02 04:30:00;NORTE;5;0;5;1
2018-12-02 05:00:00;NORTE;5;0;5;1
2018-12-02 05:30:00;NORTE;7;0;7;1
2018-12-02 05:46:00;NORTE;7;0;7;1
2018-12-02 06:00:00;NORTE;14;0;14;1
2018-12-02 06:30:00;NORTE;31;0;31;1
2018-12-02 07:00:00;NORTE;10;0;10;1
2018-12-02 07:30:00;NORTE;16;0;16;1
2018-12-02 08:00:00;NORTE;29;0;29;1
2018-12-02 08:30:00;NORTE;25;0;25;1
2018-12-02 09:00:00;NORTE;25;0;25;1
2018-12-02 09:30:00;NORTE;28;0;28;1
2018-12-02 10:00:00;NORTE;35;0;35;1
2018-12-02 10:30:00;NORTE;35;0;35;1
2018-12-02 11:00:00;NORTE;37;0;37;1
2018-12-02 11:30:00;NORTE;34;0;34;1
2018-12-02 12:00:00;NORTE;20;0;20;1
2018-12-02 12:17:00;NORTE;14;0;14;1
2018-12-02 12:30:00;NORTE;21;0;21;1
2018-12-02 13:00:00;NORTE;27;0;27;1
2018-12-02 13:30:00;NORTE;29;0;29;1
2018-12-02 14:00:00;NORTE;37;0;37;1
2018-12-02 14:30:00;NORTE;36;0;36;1
2018-12-02 15:00:00;NORTE;35;0;35;1
2018-12-02 15:30:00;NORTE;28;0;28;1
2018-12-02 16:00:00;NORTE;30;0;30;1
2018-12-02 16:30:00;NORTE;14;0;14;1
2018-12-02 17:00:00;NORTE;24;0;24;1
2018-12-02 17:30:00;NORTE;37;0;37;1
2018-12-02 18:00:00;NORTE;25;0;25;1
2018-12-02 18:30:00;NORTE;32;0;32;1
2018-12-02 19:00:00;NORTE;40;0;40;1
2018-12-02 19:30:00;NORTE;36;0;36;1
2018-12-02 20:00:00;NORTE;27;0;27;1
2018-12-02 20:30:00;NORTE;26;0;26;1
2018-12-02 21:00:00;NORTE;28;0;28;1
2018-12-02 21:30:00;NORTE;25;0;25;1
2018-12-02 22:00:00;NORTE;18;0;18;1
2018-12-02 22:30:00;NORTE;11;0;11;1
2018-12-02 23:00:00;NORTE;11;0;11;1
2018-12-02 23:30:00;NORTE;8;0;8;1
2018-12-03 00:00:00;NORTE;1;0;1;1
2018-12-03 01:00:00;NORTE;1;0;1;1
2018-12-03 01:30:00;NORTE;1;0;1;1
2018-12-03 02:00:00;NORTE;3;0;3;1
2018-12-03 03:00:00;NORTE;4;0;4;1
2018-12-03 03:30:00;NORTE;3;0;3;1
2018-12-03 04:00:00;NORTE;1;0;1;1
2018-12-03 04:30:00;NORTE;7;0;7;1
2018-12-03 05:00:00;NORTE;6;0;6;1
2018-12-03 05:30:00;NORTE;15;0;15;1
2018-12-03 06:00:00;NORTE;19;0;19;1
2018-12-03 06:30:00;NORTE;41;0;41;1
2018-12-03 07:00:00;NORTE;20;0;20;1
2018-12-03 07:30:00;NORTE;22;0;22;1
2018-12-03 08:00:00;NORTE;35;0;35;1
2018-12-03 08:30:00;NORTE;24;0;24;1
2018-12-03 09:00:00;NORTE;26;0;26;1
2018-12-03 09:30:00;NORTE;36;0;36;1
2018-12-03 10:00:00;NORTE;28;0;28;1
2018-12-03 10:30:00;NORTE;42;0;42;1
2018-12-03 11:00:00;NORTE;39;0;39;1
2018-12-03 11:30:00;NORTE;30;0;30;1
2018-12-03 12:00:00;NORTE;22;0;22;1
2018-12-03 12:30:00;NORTE;26;0;26;1
2018-12-03 13:00:00;NORTE;30;0;30;1
2018-12-03 13:30:00;NORTE;26;0;26;1
2018-12-03 14:00:00;NORTE;36;0;36;1
2018-12-03 14:30:00;NORTE;20;0;20;1
2018-12-03 14:47:00;NORTE;14;0;14;1
2018-12-03 15:00:00;NORTE;39;0;39;1
2018-12-03 15:30:00;NORTE;28;0;28;1
2018-12-03 16:00:00;NORTE;20;0;20;1
2018-12-03 16:30:00;NORTE;21;0;21;1
2018-12-03 17:00:00;NORTE;24;0;24;1
2018-12-03 17:30:00;NORTE;32;0;32;1
2018-12-03 18:00:00;NORTE;32;0;32;1
2018-12-03 18:30:00;NORTE;30;0;30;1
2018-12-03 19:00:00;NORTE;33;0;33;1
2018-12-03 19:30:00;NORTE;34;0;34;1
2018-12-03 20:00:00;NORTE;20;0;20;1
2018-12-03 20:19:00;NORTE;11;0;11;1
2018-12-03 20:30:00;NORTE;28;0;28;1
2018-12-03 21:00:00;NORTE;37;0;37;1
2018-12-03 21:30:00;NORTE;15;0;15;1
2018-12-03 22:00:00;NORTE;17;0;17;1
2018-12-03 22:30:00;NORTE;5;0;5;1
2018-12-03 22:43:00;NORTE;4;0;4;1
2018-12-03 23:00:00;NORTE;4;0;4;1
2018-12-03 23:11:00;NORTE;5;0;5;1
2018-12-03 23:30:00;NORTE;3;0;3;1
2018-12-04 00:00:00;NORTE;1;0;1;1
2018-12-04 00:30:00;NORTE;1;0;1;1
2018-12-04 02:30:00;NORTE;1;0;1;1
2018-12-04 03:00:00;NORTE;4;0;4;1
2018-12-04 03:30:00;NORTE;2;0;2;1
2018-12-04 04:00:00;NORTE;3;0;3;1
2018-12-04 04:30:00;NORTE;3;0;3;1
2018-12-04 04:37:00;NORTE;7;0;7;1
2018-12-04 05:00:00;NORTE;8;0;8;1
2018-12-04 05:30:00;NORTE;12;0;12;1
2018-12-04 06:00:00;NORTE;17;0;17;1
2018-12-04 06:30:00;NORTE;23;0;23;1
2018-12-04 06:50:00;NORTE;12;0;12;1
2018-12-04 07:00:00;NORTE;27;0;27;1
2018-12-04 07:30:00;NORTE;11;0;11;1
2018-12-04 07:47:00;NORTE;13;0;13;1
2018-12-04 08:00:00;NORTE;34;0;34;1
2018-12-04 08:30:00;NORTE;21;0;21;1
2018-12-04 09:00:00;NORTE;33;0;33;1
2018-12-04 09:30:00;NORTE;32;0;32;1
2018-12-04 10:00:00;NORTE;29;0;29;1
2018-12-04 10:30:00;NORTE;36;0;36;1
2018-12-04 11:00:00;NORTE;34;0;34;1
2018-12-04 11:30:00;NORTE;33;0;33;1
2018-12-04 12:00:00;NORTE;26;0;26;1
2018-12-04 12:30:00;NORTE;31;0;31;1
2018-12-04 13:00:00;NORTE;28;0;28;1
2018-12-04 13:30:00;NORTE;29;0;29;1
2018-12-04 14:00:00;NORTE;30;0;30;1
2018-12-04 14:30:00;NORTE;33;0;33;1
2018-12-04 15:00:00;NORTE;37;0;37;1
2018-12-04 15:30:00;NORTE;29;0;29;1
2018-12-04 16:00:00;NORTE;29;0;29;1
2018-12-04 16:30:00;NORTE;18;0;18;1
2018-12-04 17:00:00;NORTE;17;0;17;1
2018-12-04 17:30:00;NORTE;34;0;34;1
2018-12-04 18:00:00;NORTE;25;0;25;1
2018-12-04 18:30:00;NORTE;25;0;25;1
2018-12-04 19:00:00;NORTE;39;0;39;1
2018-12-04 19:30:00;NORTE;30;0;30;1
2018-12-04 20:00:00;NORTE;23;0;23;1
2018-12-04 20:30:00;NORTE;26;0;26;1
2018-12-04 21:00:00;NORTE;29;0;29;1
2018-12-04 21:30:00;NORTE;19;0;19;1
2018-12-04 22:00:00;NORTE;14;0;14;1
2018-12-04 22:30:00;NORTE;6;0;6;1
2018-12-04 23:00:00;NORTE;9;0;9;1
2018-12-04 23:30:00;NORTE;4;0;4;1
2018-12-05 00:00:00;NORTE;2;0;2;1
2018-12-05 00:30:00;NORTE;1;0;1;1
2018-12-05 01:00:00;NORTE;1;0;1;1
2018-12-05 01:30:00;NORTE;1;0;1;1
2018-12-05 02:30:00;NORTE;1;0;1;1
2018-12-05 03:00:00;NORTE;3;0;3;1
2018-12-05 03:30:00;NORTE;3;0;3;1
2018-12-05 04:00:00;NORTE;2;0;2;1
2018-12-05 04:30:00;NORTE;7;0;7;1
2018-12-05 05:00:00;NORTE;5;0;5;1
2018-12-05 05:30:00;NORTE;14;0;14;1
2018-12-05 06:00:00;NORTE;17;0;17;1
2018-12-05 06:30:00;NORTE;38;0;38;1
2018-12-05 07:00:00;NORTE;20;0;20;1
2018-12-05 07:30:00;NORTE;25;0;25;1
2018-12-05 08:00:00;NORTE;32;0;32;1
2018-12-05 08:30:00;NORTE;23;0;23;1
2018-12-05 09:00:00;NORTE;36;0;36;1
2018-12-05 09:30:00;NORTE;28;0;28;1
2018-12-05 10:00:00;NORTE;28;0;28;1
2018-12-05 10:30:00;NORTE;40;0;40;1
2018-12-05 11:00:00;NORTE;36;0;36;1
2018-12-05 11:30:00;NORTE;34;0;34;1
2018-12-05 12:00:00;NORTE;28;0;28;1
2018-12-05 12:30:00;NORTE;31;0;31;1
2018-12-05 13:00:00;NORTE;26;0;26;1
2018-12-05 13:30:00;NORTE;30;0;30;1
2018-12-05 14:00:00;NORTE;37;0;37;1
2018-12-05 14:30:00;NORTE;35;0;35;1
2018-12-05 15:00:00;NORTE;37;0;37;1
2018-12-05 15:30:00;NORTE;32;0;32;1
2018-12-05 16:00:00;NORTE;30;0;30;1
2018-12-05 16:30:00;NORTE;17;0;17;1
2018-12-05 17:00:00;NORTE;24;0;24;1
2018-12-05 17:30:00;NORTE;26;0;26;1
2018-12-05 18:00:00;NORTE;20;0;20;1
2018-12-05 18:30:00;NORTE;31;0;31;1
2018-12-05 19:00:00;NORTE;40;0;40;1
2018-12-05 19:30:00;NORTE;21;0;21;1
2018-12-05 20:00:00;NORTE;31;0;31;1
2018-12-05 20:30:00;NORTE;24;0;24;1
2018-12-05 21:00:00;NORTE;29;0;29;1
2018-12-05 21:30:00;NORTE;28;0;28;1
2018-12-05 22:00:00;NORTE;18;0;18;1
2018-12-05 22:30:00;NORTE;12;0;12;1
2018-12-05 23:00:00;NORTE;11;0;11;1
2018-12-05 23:30:00;NORTE;8;0;8;1
2018-12-06 00:00:00;NORTE;2;0;2;1
2018-12-06 00:30:00;NORTE;1;0;1;1
2018-12-06 01:30:00;NORTE;2;0;2;1
2018-12-06 02:00:00;NORTE;1;0;1;1
2018-12-06 03:00:00;NORTE;2;0;2;1
2018-12-06 03:30:00;NORTE;3;0;3;1
2018-12-06 04:00:00;NORTE;5;0;5;1
2018-12-06 04:30:00;NORTE;8;0;8;1
2018-12-06 05:00:00;NORTE;7;0;7;1
2018-12-06 05:30:00;NORTE;12;0;12;1
2018-12-06 06:00:00;NORTE;18;0;18;1
2018-12-06 06:30:00;NORTE;33;0;33;1
2018-12-06 07:00:00;NORTE;20;0;20;1
2018-12-06 07:30:00;NORTE;28;0;28;1
2018-12-06 08:00:00;NORTE;31;0;31;1
2018-12-06 08:30:00;NORTE;30;0;30;1
2018-12-06 09:00:00;NORTE;34;0;34;1
2018-12-06 09:30:00;NORTE;31;0;31;1
2018-12-06 10:00:00;NORTE;16;0;16;1
2018-12-06 10:30:00;NORTE;36;0;36;1
2018-12-06 11:00:00;NORTE;35;0;35;1
2018-12-06 11:30:00;NORTE;34;0;34;1
2018-12-06 12:00:00;NORTE;31;0;31;1
2018-12-06 12:30:00;NORTE;32;0;32;1
2018-12-06 13:00:00;NORTE;22;0;22;1
2018-12-06 13:30:00;NORTE;32;0;32;1
2018-12-06 14:00:00;NORTE;35;0;35;1
2018-12-06 14:30:00;NORTE;33;0;33;1
2018-12-06 15:00:00;NORTE;34;0;34;1
2018-12-06 15:30:00;NORTE;33;0;33;1
2018-12-06 16:00:00;NORTE;25;0;25;1
2018-12-06 16:30:00;NORTE;10;0;10;1
2018-12-06 17:00:00;NORTE;26;0;26;1
2018-12-06 17:30:00;NORTE;28;0;28;1
2018-12-06 18:00:00;NORTE;34;0;34;1
2018-12-06 18:30:00;NORTE;34;0;34;1
2018-12-06 19:00:00;NORTE;25;1;26;1
2018-12-06 19:30:00;NORTE;29;0;29;1
2018-12-06 20:00:00;NORTE;24;0;24;1
2018-12-06 20:30:00;NORTE;28;0;28;1
2018-12-06 21:00:00;NORTE;26;0;26;1
2018-12-06 21:30:00;NORTE;15;0;15;1
2018-12-06 22:00:00;NORTE;15;0;15;1
2018-12-06 22:30:00;NORTE;10;0;10;1
2018-12-06 23:00:00;NORTE;10;0;10;1
2018-12-06 23:30:00;NORTE;3;0;3;1
2018-12-07 01:00:00;NORTE;1;0;1;1
2018-12-07 01:30:00;NORTE;3;0;3;1
2018-12-07 02:00:00;NORTE;1;0;1;1
2018-12-07 02:30:00;NORTE;1;0;1;1
2018-12-07 03:00:00;NORTE;5;0;5;1
2018-12-07 04:00:00;NORTE;3;0;3;1
2018-12-07 04:30:00;NORTE;10;0;10;1
2018-12-07 05:00:00;NORTE;9;0;9;1
2018-12-07 05:30:00;NORTE;11;0;11;1
2018-12-07 06:00:00;NORTE;25;0;25;1
2018-12-07 06:30:00;NORTE;23;0;23;1
2018-12-07 07:00:00;NORTE;23;0;23;1
2018-12-07 07:30:00;NORTE;19;0;19;1
2018-12-07 08:00:00;NORTE;32;0;32;1
2018-12-07 08:30:00;NORTE;28;0;28;1
2018-12-07 09:00:00;NORTE;34;0;34;1
2018-12-07 09:30:00;NORTE;31;0;31;1
2018-12-07 10:00:00;NORTE;30;0;30;1
2018-12-07 10:30:00;NORTE;39;0;39;1
2018-12-07 11:00:00;NORTE;31;0;31;1
2018-12-07 11:30:00;NORTE;27;0;27;1
2018-12-07 12:00:00;NORTE;20;0;20;1
2018-12-07 12:30:00;NORTE;26;0;26;1
2018-12-07 13:00:00;NORTE;28;0;28;1
2018-12-07 13:30:00;NORTE;32;0;32;1
2018-12-07 14:00:00;NORTE;37;0;37;1
2018-12-07 14:30:00;NORTE;25;0;25;1
2018-12-07 15:00:00;NORTE;38;0;38;1
2018-12-07 15:30:00;NORTE;30;0;30;1
2018-12-07 16:00:00;NORTE;29;0;29;1
2018-12-07 16:30:00;NORTE;20;0;20;1
2018-12-07 17:00:00;NORTE;21;0;21;1
2018-12-07 17:30:00;NORTE;26;0;26;1
2018-12-07 18:00:00;NORTE;25;0;25;1
2018-12-07 18:30:00;NORTE;26;0;26;1
2018-12-07 19:00:00;NORTE;35;0;35;1
2018-12-07 19:30:00;NORTE;33;0;33;1
2018-12-07 20:00:00;NORTE;31;0;31;1
2018-12-07 20:30:00;NORTE;24;0;24;1
2018-12-07 21:00:00;NORTE;25;0;25;1
2018-12-07 21:30:00;NORTE;21;0;21;1
2018-12-07 22:00:00;NORTE;10;0;10;1
2018-12-07 22:30:00;NORTE;10;0;10;1
2018-12-07 23:00:00;NORTE;9;0;9;1
2018-12-07 23:30:00;NORTE;3;0;3;1
2018-12-07 23:38:00;NORTE;1;0;1;1
2018-12-08 00:00:00;NORTE;2;0;2;1
2018-12-08 00:30:00;NORTE;1;0;1;1
2018-12-08 01:30:00;NORTE;1;0;1;1
2018-12-08 02:30:00;NORTE;1;0;1;1
2018-12-08 03:00:00;NORTE;1;0;1;1
2018-12-08 03:30:00;NORTE;4;0;4;1
2018-12-08 04:00:00;NORTE;1;0;1;1
2018-12-08 04:30:00;NORTE;6;0;6;1
2018-12-08 05:00:00;NORTE;8;0;8;1
2018-12-08 05:30:00;NORTE;9;0;9;1
2018-12-08 06:00:00;NORTE;14;0;14;1
2018-12-08 06:30:00;NORTE;28;0;28;1
2018-12-08 07:00:00;NORTE;18;0;18;1
2018-12-08 07:30:00;NORTE;18;0;18;1
2018-12-08 08:00:00;NORTE;23;0;23;1
2018-12-08 08:30:00;NORTE;8;0;8;1
2018-12-08 08:41:00;NORTE;20;0;20;1
2018-12-08 09:00:00;NORTE;28;0;28;1
2018-12-08 09:30:00;NORTE;29;0;29;1
2018-12-08 10:00:00;NORTE;24;0;24;1
2018-12-08 10:30:00;NORTE;36;0;36;1
2018-12-08 11:00:00;NORTE;33;0;33;1
2018-12-08 11:30:00;NORTE;33;0;33;1
2018-12-08 12:00:00;NORTE;28;0;28;1
2018-12-08 12:30:00;NORTE;35;0;35;1
2018-12-08 13:00:00;NORTE;28;0;28;1
2018-12-08 13:30:00;NORTE;27;0;27;1
2018-12-08 14:00:00;NORTE;37;0;37;1
2018-12-08 14:30:00;NORTE;32;0;32;1
2018-12-08 15:00:00;NORTE;41;0;41;1
2018-12-08 15:30:00;NORTE;16;0;16;1
2018-12-08 16:00:00;NORTE;26;0;26;1
2018-12-08 16:30:00;NORTE;14;0;14;1
2018-12-08 17:00:00;NORTE;23;0;23;1
2018-12-08 17:30:00;NORTE;30;0;30;1
2018-12-08 18:00:00;NORTE;16;0;16;1
2018-12-08 18:30:00;NORTE;21;0;21;1
2018-12-08 19:00:00;NORTE;35;0;35;1
2018-12-08 19:30:00;NORTE;15;0;15;1
2018-12-08 20:00:00;NORTE;14;0;14;1
2018-12-08 20:30:00;NORTE;29;0;29;1
2018-12-08 21:00:00;NORTE;12;0;12;1
2018-12-08 21:30:00;NORTE;22;0;22;1
2018-12-08 22:00:00;NORTE;5;0;5;1
2018-12-08 22:30:00;NORTE;9;0;9;1
2018-12-08 23:00:00;NORTE;10;0;10;1
2018-12-08 23:30:00;NORTE;3;0;3;1
2018-12-09 01:00:00;NORTE;1;0;1;1
2018-12-09 02:00:00;NORTE;1;0;1;1
2018-12-09 02:30:00;NORTE;1;0;1;1
2018-12-09 03:00:00;NORTE;1;0;1;1
2018-12-09 03:30:00;NORTE;3;0;3;1
2018-12-09 04:00:00;NORTE;5;0;5;1
2018-12-09 04:30:00;NORTE;4;0;4;1
2018-12-09 05:00:00;NORTE;6;0;6;1
2018-12-09 05:30:00;NORTE;12;0;12;1
2018-12-09 06:00:00;NORTE;19;0;19;1
2018-12-09 06:30:00;NORTE;22;0;22;1
2018-12-09 07:00:00;NORTE;14;0;14;1
2018-12-09 07:30:00;NORTE;17;0;17;1
2018-12-09 08:00:00;NORTE;29;0;29;1
2018-12-09 08:30:00;NORTE;30;0;30;1
2018-12-09 09:00:00;NORTE;38;0;38;1
2018-12-09 09:30:00;NORTE;27;0;27;1
2018-12-09 10:00:00;NORTE;27;0;27;1
2018-12-09 10:30:00;NORTE;38;0;38;1
2018-12-09 11:00:00;NORTE;38;0;38;1
2018-12-09 11:30:00;NORTE;35;0;35;1
2018-12-09 12:00:00;NORTE;24;0;24;1
2018-12-09 12:30:00;NORTE;35;0;35;1
2018-12-09 13:00:00;NORTE;28;0;28;1
2018-12-09 13:30:00;NORTE;32;0;32;1
2018-12-09 14:00:00;NORTE;32;0;32;1
2018-12-09 14:30:00;NORTE;37;0;37;1
2018-12-09 15:00:00;NORTE;38;0;38;1
2018-12-09 15:30:00;NORTE;35;0;35;1
2018-12-09 16:00:00;NORTE;23;0;23;1
2018-12-09 16:30:00;NORTE;18;0;18;1
2018-12-09 17:00:00;NORTE;27;0;27;1
2018-12-09 17:30:00;NORTE;31;0;31;1
2018-12-09 18:00:00;NORTE;33;0;33;1
2018-12-09 18:30:00;NORTE;31;0;31;1
2018-12-09 19:00:00;NORTE;40;0;40;1
2018-12-09 19:30:00;NORTE;40;0;40;1
2018-12-09 20:00:00;NORTE;35;0;35;1
2018-12-09 20:30:00;NORTE;30;0;30;1
2018-12-09 21:00:00;NORTE;33;0;33;1
2018-12-09 21:30:00;NORTE;23;0;23;1
2018-12-09 22:00:00;NORTE;13;0;13;1
2018-12-09 22:30:00;NORTE;13;0;13;1
2018-12-09 23:00:00;NORTE;16;0;16;1
2018-12-09 23:30:00;NORTE;6;0;6;1
2018-12-10 00:00:00;NORTE;6;0;6;1
2018-12-10 00:30:00;NORTE;1;0;1;1
2018-12-10 01:00:00;NORTE;2;0;2;1
2018-12-10 01:30:00;NORTE;2;0;2;1
2018-12-10 02:00:00;NORTE;2;0;2;1
2018-12-10 02:30:00;NORTE;1;0;1;1
2018-12-10 03:00:00;NORTE;4;0;4;1
2018-12-10 03:30:00;NORTE;2;0;2;1
2018-12-10 04:00:00;NORTE;4;0;4;1
2018-12-10 04:30:00;NORTE;6;0;6;1
2018-12-10 05:00:00;NORTE;10;0;10;1
2018-12-10 05:30:00;NORTE;11;0;11;1
2018-12-10 06:00:00;NORTE;17;0;17;1
2018-12-10 06:30:00;NORTE;41;0;41;1
2018-12-10 07:00:00;NORTE;21;0;21;1
2018-12-10 07:30:00;NORTE;26;1;27;1
2018-12-10 08:00:00;NORTE;37;0;37;1
2018-12-10 08:30:00;NORTE;23;0;23;1
2018-12-10 09:00:00;NORTE;35;0;35;1
2018-12-10 09:30:00;NORTE;39;0;39;1
2018-12-10 10:00:00;NORTE;24;0;24;1
2018-12-10 10:30:00;NORTE;29;0;29;1
2018-12-10 11:00:00;NORTE;41;0;41;1
2018-12-10 11:30:00;NORTE;28;0;28;1
2018-12-10 12:00:00;NORTE;30;0;30;1
2018-12-10 12:30:00;NORTE;29;0;29;1
2018-12-10 13:00:00;NORTE;32;0;32;1
2018-12-10 13:30:00;NORTE;34;0;34;1
2018-12-10 14:00:00;NORTE;35;0;35;1
2018-12-10 14:30:00;NORTE;27;0;27;1
2018-12-10 15:00:00;NORTE;32;0;32;1
2018-12-10 15:30:00;NORTE;37;0;37;1
2018-12-10 16:00:00;NORTE;25;0;25;1
2018-12-10 16:30:00;NORTE;24;0;24;1
2018-12-10 17:00:00;NORTE;26;0;26;1
2018-12-10 17:30:00;NORTE;36;0;36;1
2018-12-10 18:00:00;NORTE;23;0;23;1
2018-12-10 18:30:00;NORTE;35;0;35;1
2018-12-10 19:00:00;NORTE;34;0;34;1
2018-12-10 19:30:00;NORTE;27;1;28;1
2018-12-10 20:00:00;NORTE;20;0;20;1
2018-12-10 20:30:00;NORTE;29;0;29;1
2018-12-10 21:00:00;NORTE;28;0;28;1
2018-12-10 21:30:00;NORTE;23;0;23;1
2018-12-10 22:00:00;NORTE;15;0;15;1
2018-12-10 22:30:00;NORTE;7;0;7;1
2018-12-10 23:00:00;NORTE;10;0;10;1
2018-12-10 23:30:00;NORTE;5;0;5;1
2018-12-11 01:30:00;NORTE;1;0;1;1
2018-12-11 02:00:00;NORTE;1;0;1;1
2018-12-11 03:00:00;NORTE;3;0;3;1
2018-12-11 03:30:00;NORTE;4;0;4;1
2018-12-11 04:00:00;NORTE;5;0;5;1
2018-12-11 04:30:00;NORTE;5;0;5;1
2018-12-11 05:00:00;NORTE;6;0;6;1
2018-12-11 05:30:00;NORTE;17;0;17;1
2018-12-11 06:00:00;NORTE;15;0;15;1
2018-12-11 06:30:00;NORTE;45;0;45;1
2018-12-11 07:00:00;NORTE;21;0;21;1
2018-12-11 07:30:00;NORTE;22;0;22;1
2018-12-11 08:00:00;NORTE;32;0;32;1
2018-12-11 08:30:00;NORTE;28;0;28;1
2018-12-11 09:00:00;NORTE;34;0;34;1
2018-12-11 09:30:00;NORTE;34;0;34;1
2018-12-11 10:00:00;NORTE;27;0;27;1
2018-12-11 10:30:00;NORTE;32;0;32;1
2018-12-11 11:00:00;NORTE;35;0;35;1
2018-12-11 11:30:00;NORTE;26;0;26;1
2018-12-11 12:00:00;NORTE;24;0;24;1
2018-12-11 12:30:00;NORTE;31;0;31;1
2018-12-11 13:00:00;NORTE;24;0;24;1
2018-12-11 13:30:00;NORTE;30;0;30;1
2018-12-11 14:00:00;NORTE;30;0;30;1
2018-12-11 14:30:00;NORTE;39;0;39;1
2018-12-11 15:00:00;NORTE;34;0;34;1
2018-12-11 15:30:00;NORTE;29;0;29;1
2018-12-11 16:00:00;NORTE;25;0;25;1
2018-12-11 16:30:00;NORTE;14;0;14;1
2018-12-11 17:00:00;NORTE;21;0;21;1
2018-12-11 17:30:00;NORTE;33;0;33;1
2018-12-11 18:00:00;NORTE;25;0;25;1
2018-12-11 18:30:00;NORTE;32;1;33;1
2018-12-11 19:00:00;NORTE;37;0;37;1
2018-12-11 19:30:00;NORTE;29;0;29;1
2018-12-11 20:00:00;NORTE;18;0;18;1
2018-12-11 20:30:00;NORTE;27;0;27;1
2018-12-11 21:00:00;NORTE;34;0;34;1
2018-12-11 21:30:00;NORTE;21;0;21;1
2018-12-11 22:00:00;NORTE;16;0;16;1
2018-12-11 22:30:00;NORTE;3;0;3;1
2018-12-11 23:00:00;NORTE;10;0;10;1
2018-12-11 23:30:00;NORTE;3;0;3;1
2018-12-12 00:00:00;NORTE;1;0;1;1
2018-12-12 00:30:00;NORTE;1;0;1;1
2018-12-12 01:00:00;NORTE;1;0;1;1
2018-12-12 02:30:00;NORTE;1;0;1;1
2018-12-12 03:00:00;NORTE;1;0;1;1
2018-12-12 03:30:00;NORTE;5;0;5;1
2018-12-12 04:00:00;NORTE;4;0;4;1
2018-12-12 04:30:00;NORTE;7;0;7;1
2018-12-12 05:00:00;NORTE;8;0;8;1
2018-12-12 05:30:00;NORTE;3;0;3;1
2018-12-12 05:38:00;NORTE;1;0;1;1
2018-12-12 05:42:00;NORTE;6;0;6;1
2018-12-12 06:00:00;NORTE;21;0;21;1
2018-12-12 06:30:00;NORTE;25;0;25;1
2018-12-12 07:00:00;NORTE;27;0;27;1
2018-12-12 07:30:00;NORTE;26;0;26;1
2018-12-12 08:00:00;NORTE;33;0;33;1
2018-12-12 08:30:00;NORTE;8;0;8;1
2018-12-12 08:40:00;NORTE;22;0;22;1
2018-12-12 09:00:00;NORTE;22;0;22;1
2018-12-12 09:30:00;NORTE;25;0;25;1
2018-12-12 10:00:00;NORTE;8;0;8;1
2018-12-12 10:11:00;NORTE;20;0;20;1
2018-12-12 10:30:00;NORTE;29;0;29;1
2018-12-12 11:00:00;NORTE;39;0;39;1
2018-12-12 11:30:00;NORTE;34;0;34;1
2018-12-12 12:00:00;NORTE;16;0;16;1
2018-12-12 12:15:00;NORTE;16;0;16;1
2018-12-12 12:30:00;NORTE;33;0;33;1
2018-12-12 13:00:00;NORTE;25;0;25;1
2018-12-12 13:30:00;NORTE;21;0;21;1
2018-12-12 14:00:00;NORTE;28;0;28;1
2018-12-12 14:30:00;NORTE;37;0;37;1
2018-12-12 15:00:00;NORTE;40;0;40;1
2018-12-12 15:30:00;NORTE;32;0;32;1
2018-12-12 16:00:00;NORTE;26;0;26;1
2018-12-12 16:30:00;NORTE;16;0;16;1
2018-12-12 17:00:00;NORTE;21;0;21;1
2018-12-12 17:30:00;NORTE;20;0;20;1
2018-12-12 18:00:00;NORTE;31;0;31;1
2018-12-12 18:30:00;NORTE;25;0;25;1
2018-12-12 19:00:00;NORTE;36;0;36;1
2018-12-12 19:30:00;NORTE;32;0;32;1
2018-12-12 20:00:00;NORTE;23;0;23;1
2018-12-12 20:30:00;NORTE;24;0;24;1
2018-12-12 21:00:00;NORTE;28;0;28;1
2018-12-12 21:30:00;NORTE;24;0;24;1
2018-12-12 22:00:00;NORTE;16;0;16;1
2018-12-12 22:30:00;NORTE;8;0;8;1
2018-12-12 23:00:00;NORTE;14;0;14;1
2018-12-12 23:30:00;NORTE;2;0;2;1
2018-12-12 23:36:00;NORTE;4;0;4;1
2018-12-13 01:00:00;NORTE;3;0;3;1
2018-12-13 01:30:00;NORTE;1;0;1;1
2018-12-13 02:30:00;NORTE;2;0;2;1
2018-12-13 03:30:00;NORTE;4;0;4;1
2018-12-13 04:00:00;NORTE;1;0;1;1
2018-12-13 04:14:00;NORTE;2;0;2;1
2018-12-13 04:30:00;NORTE;7;0;7;1
2018-12-13 05:00:00;CONFLICTIVA;3;7;10;2
2018-12-13 05:30:00;SUR;0;6;6;1
2018-12-13 05:45:00;SUR;0;7;7;1
2018-12-13 06:00:00;SUR;0;21;21;1
2018-12-13 06:30:00;SUR;0;27;27;1
2018-12-13 06:55:00;SUR;0;6;6;1
2018-12-13 07:00:00;SUR;0;10;10;1
2018-12-13 07:11:00;SUR;0;16;16;1
2018-12-13 07:30:00;SUR;0;15;15;1
2018-12-13 07:48:00;SUR;0;8;8;1
2018-12-13 08:00:00;SUR;0;15;15;1
2018-12-13 08:13:00;SUR;0;20;20;1
2018-12-13 08:30:00;SUR;0;3;3;1
2018-12-13 08:35:00;SUR;0;4;4;1
2018-12-13 08:42:00;SUR;0;11;11;1
2018-12-13 09:00:00;NORTE;34;0;34;1
2018-12-13 09:30:00;NORTE;33;0;33;1
2018-12-13 10:00:00;NORTE;27;0;27;1
2018-12-13 10:30:00;NORTE;32;0;32;1
2018-12-13 11:00:00;NORTE;37;1;38;1
2018-12-13 11:30:00;NORTE;9;0;9;1
2018-12-13 12:30:00;NORTE;21;0;21;1
2018-12-13 13:00:00;NORTE;31;0;31;1
2018-12-13 13:30:00;NORTE;25;0;25;1
2018-12-13 14:00:00;NORTE;31;0;31;1
2018-12-13 14:30:00;NORTE;30;0;30;1
2018-12-13 15:00:00;NORTE;37;0;37;1
2018-12-13 15:30:00;NORTE;31;0;31;1
2018-12-13 16:00:00;NORTE;23;0;23;1
2018-12-13 16:30:00;NORTE;15;0;15;1
2018-12-13 17:00:00;NORTE;23;0;23;1
2018-12-13 17:30:00;NORTE;34;0;34;1
2018-12-13 18:00:00;NORTE;30;0;30;1
2018-12-13 18:30:00;NORTE;28;0;28;1
2018-12-13 19:00:00;NORTE;39;0;39;1
2018-12-13 19:30:00;NORTE;35;0;35;1
2018-12-13 20:00:00;NORTE;27;0;27;1
2018-12-13 20:30:00;NORTE;24;0;24;1
2018-12-13 21:00:00;NORTE;28;0;28;1
2018-12-13 21:30:00;NORTE;27;0;27;1
2018-12-13 22:00:00;NORTE;14;0;14;1
2018-12-13 22:30:00;NORTE;7;0;7;1
2018-12-13 23:00:00;NORTE;14;0;14;1
2018-12-13 23:30:00;NORTE;5;0;5;1
2018-12-14 00:00:00;NORTE;1;0;1;1
2018-12-14 01:00:00;NORTE;3;0;3;1
2018-12-14 02:00:00;NORTE;1;0;1;1
2018-12-14 02:30:00;NORTE;1;0;1;1
2018-12-14 03:00:00;NORTE;3;0;3;1
2018-12-14 03:30:00;NORTE;1;0;1;1
2018-12-14 04:00:00;NORTE;3;0;3;1
2018-12-14 04:30:00;NORTE;7;0;7;1
2018-12-14 05:00:00;NORTE;10;0;10;1
2018-12-14 05:30:00;NORTE;9;0;9;1
2018-12-14 06:00:00;NORTE;17;0;17;1
2018-12-14 06:30:00;NORTE;31;0;31;1
2018-12-14 07:00:00;NORTE;21;0;21;1
2018-12-14 07:30:00;NORTE;24;0;24;1
2018-12-14 08:00:00;NORTE;36;0;36;1
2018-12-14 08:30:00;NORTE;27;0;27;1
2018-12-14 09:00:00;NORTE;30;0;30;1
2018-12-14 09:30:00;NORTE;38;0;38;1
2018-12-14 10:00:00;NORTE;28;0;28;1
2018-12-14 10:30:00;NORTE;35;0;35;1
2018-12-14 11:00:00;NORTE;40;0;40;1
2018-12-14 11:30:00;NORTE;35;0;35;1
2018-12-14 12:00:00;NORTE;17;0;17;1
2018-12-14 12:30:00;NORTE;30;0;30;1
2018-12-14 13:00:00;NORTE;30;0;30;1
2018-12-14 13:30:00;NORTE;25;0;25;1
2018-12-14 14:00:00;NORTE;43;0;43;1
2018-12-14 14:30:00;NORTE;28;0;28;1
2018-12-14 15:00:00;NORTE;34;0;34;1
2018-12-14 15:30:00;NORTE;37;1;38;1
2018-12-14 16:00:00;NORTE;31;0;31;1
2018-12-14 16:30:00;NORTE;22;0;22;1
2018-12-14 17:00:00;NORTE;26;0;26;1
2018-12-14 17:30:00;NORTE;30;0;30;1
2018-12-14 18:00:00;NORTE;33;0;33;1
2018-12-14 18:30:00;NORTE;32;0;32;1
2018-12-14 19:00:00;NORTE;43;0;43;1
2018-12-14 19:30:00;NORTE;31;0;31;1
2018-12-14 20:00:00;NORTE;29;0;29;1
2018-12-14 20:30:00;NORTE;22;0;22;1
2018-12-14 21:00:00;NORTE;37;0;37;1
2018-12-14 21:30:00;NORTE;28;0;28;1
2018-12-14 22:00:00;NORTE;14;0;14;1
2018-12-14 22:30:00;NORTE;5;0;5;1
2018-12-14 23:00:00;NORTE;13;0;13;1
2018-12-14 23:30:00;NORTE;9;0;9;1
2018-12-15 00:00:00;NORTE;3;0;3;1
2018-12-15 00:30:00;NORTE;1;0;1;1
2018-12-15 01:30:00;NORTE;1;0;1;1
2018-12-15 02:30:00;NORTE;1;0;1;1
2018-12-15 03:30:00;NORTE;4;0;4;1
2018-12-15 04:00:00;NORTE;2;0;2;1
2018-12-15 04:30:00;NORTE;4;0;4;1
2018-12-15 05:00:00;NORTE;7;0;7;1
2018-12-15 05:30:00;NORTE;12;0;12;1
2018-12-15 06:00:00;NORTE;22;0;22;1
2018-12-15 06:30:00;NORTE;28;0;28;1
2018-12-15 07:00:00;NORTE;14;0;14;1
2018-12-15 07:30:00;NORTE;17;0;17;1
2018-12-15 08:00:00;NORTE;31;0;31;1
2018-12-15 08:30:00;NORTE;24;0;24;1
2018-12-15 09:00:00;NORTE;34;0;34;1
2018-12-15 09:30:00;NORTE;31;0;31;1
2018-12-15 10:00:00;NORTE;18;0;18;1
2018-12-15 10:30:00;NORTE;40;0;40;1
2018-12-15 11:00:00;NORTE;34;0;34;1
2018-12-15 11:30:00;NORTE;24;0;24;1
2018-12-15 12:00:00;NORTE;31;0;31;1
2018-12-15 12:30:00;NORTE;21;0;21;1
2018-12-15 13:00:00;NORTE;34;0;34;1
2018-12-15 13:30:00;NORTE;32;0;32;1
2018-12-15 14:00:00;NORTE;29;0;29;1
2018-12-15 14:30:00;NORTE;28;0;28;1
2018-12-15 15:00:00;NORTE;40;0;40;1
2018-12-15 15:30:00;NORTE;24;0;24;1
2018-12-15 16:00:00;NORTE;17;0;17;1
2018-12-15 16:30:00;NORTE;15;0;15;1
2018-12-15 16:50:00;NORTE;5;0;5;1
2018-12-15 17:00:00;NORTE;13;0;13;1
2018-12-15 17:30:00;NORTE;26;0;26;1
2018-12-15 18:00:00;NORTE;18;0;18;1
2018-12-15 18:30:00;NORTE;22;0;22;1
2018-12-15 19:00:00;NORTE;33;0;33;1
2018-12-15 19:30:00;NORTE;19;0;19;1
2018-12-15 20:00:00;NORTE;17;0;17;1
2018-12-15 20:30:00;NORTE;12;0;12;1
2018-12-15 20:52:00;NORTE;6;0;6;1
2018-12-15 21:00:00;NORTE;21;0;21;1
2018-12-15 21:30:00;NORTE;17;0;17;1
2018-12-15 22:00:00;NORTE;9;0;9;1
2018-12-15 22:30:00;NORTE;9;0;9;1
2018-12-15 23:00:00;NORTE;10;0;10;1
2018-12-15 23:30:00;NORTE;7;0;7;1
2018-12-16 00:00:00;NORTE;1;0;1;1
2018-12-16 00:30:00;NORTE;3;0;3;1
2018-12-16 01:00:00;NORTE;2;0;2;1
2018-12-16 01:30:00;NORTE;1;0;1;1
2018-12-16 02:00:00;NORTE;2;0;2;1
2018-12-16 02:30:00;NORTE;1;0;1;1
2018-12-16 03:30:00;NORTE;4;0;4;1
2018-12-16 04:00:00;NORTE;3;0;3;1
2018-12-16 04:30:00;SUR;0;3;3;1
2018-12-16 05:00:00;SUR;0;10;10;1
2018-12-16 05:30:00;SUR;0;3;3;1
2018-12-16 05:42:00;SUR;0;7;7;1
2018-12-16 06:00:00;SUR;0;17;17;1
2018-12-16 06:30:00;SUR;0;22;22;1
2018-12-16 07:00:00;SUR;0;15;15;1
2018-12-16 07:30:00;SUR;0;3;3;1
2018-12-16 07:34:00;SUR;0;10;10;1
2018-12-16 08:00:00;SUR;0;15;15;1
2018-12-16 08:12:00;SUR;0;16;16;1
2018-12-16 08:30:00;SUR;0;21;21;1
2018-12-16 09:00:00;SUR;0;25;25;1
2018-12-16 09:30:00;SUR;0;29;29;1
2018-12-16 10:00:00;SUR;0;23;23;1
2018-12-16 10:30:00;SUR;0;35;35;1
2018-12-16 11:00:00;SUR;0;32;32;1
2018-12-16 11:30:00;SUR;0;32;32;1
2018-12-16 12:00:00;SUR;0;26;26;1
2018-12-16 12:30:00;SUR;0;28;28;1
2018-12-16 13:00:00;SUR;0;22;22;1
2018-12-16 13:30:00;SUR;0;21;21;1
2018-12-16 14:00:00;SUR;0;41;41;1
2018-12-16 14:30:00;SUR;0;39;39;1
2018-12-16 15:00:00;SUR;0;37;37;1
2018-12-16 15:30:00;CONFLICTIVA;9;19;28;2
2018-12-16 16:00:00;NORTE;33;0;33;1
2018-12-16 16:30:00;NORTE;14;0;14;1
2018-12-16 17:00:00;NORTE;26;0;26;1
2018-12-16 17:30:00;NORTE;30;0;30;1
2018-12-16 18:00:00;NORTE;31;0;31;1
2018-12-16 18:30:00;NORTE;25;0;25;1
2018-12-16 19:00:00;NORTE;46;0;46;1
2018-12-16 19:30:00;NORTE;37;0;37;1
2018-12-16 20:00:00;NORTE;32;0;32;1
2018-12-16 20:30:00;NORTE;27;0;27;1
2018-12-16 21:00:00;NORTE;29;0;29;1
2018-12-16 21:30:00;NORTE;24;0;24;1
2018-12-16 22:00:00;NORTE;18;0;18;1
2018-12-16 22:30:00;NORTE;10;0;10;1
2018-12-16 23:00:00;NORTE;10;0;10;1
2018-12-16 23:30:00;NORTE;15;0;15;1
2018-12-17 00:00:00;NORTE;4;0;4;1
2018-12-17 00:30:00;NORTE;1;0;1;1
2018-12-17 01:00:00;NORTE;2;0;2;1
2018-12-17 01:30:00;NORTE;1;0;1;1
2018-12-17 02:00:00;NORTE;1;0;1;1
2018-12-17 02:30:00;NORTE;2;0;2;1
2018-12-17 03:00:00;NORTE;3;0;3;1
2018-12-17 03:30:00;NORTE;3;0;3;1
2018-12-17 04:00:00;NORTE;3;0;3;1
2018-12-17 04:30:00;NORTE;6;0;6;1
2018-12-17 05:00:00;NORTE;9;0;9;1
2018-12-17 05:30:00;NORTE;9;0;9;1
2018-12-17 06:00:00;NORTE;21;0;21;1
2018-12-17 06:30:00;NORTE;36;0;36;1
2018-12-17 07:00:00;NORTE;23;0;23;1
2018-12-17 07:30:00;NORTE;26;0;26;1
2018-12-17 08:00:00;NORTE;36;0;36;1
2018-12-17 08:30:00;NORTE;17;0;17;1
2018-12-17 09:00:00;NORTE;15;0;15;1
2018-12-17 09:30:00;NORTE;36;0;36;1
2018-12-17 10:00:00;NORTE;28;0;28;1
2018-12-17 10:30:00;NORTE;36;0;36;1
2018-12-17 11:00:00;NORTE;33;0;33;1
2018-12-17 11:30:00;NORTE;35;0;35;1
2018-12-17 12:00:00;NORTE;28;0;28;1
2018-12-17 12:30:00;NORTE;29;0;29;1
2018-12-17 13:00:00;NORTE;33;0;33;1
2018-12-17 13:30:00;NORTE;30;0;30;1
2018-12-17 14:00:00;NORTE;40;0;40;1
2018-12-17 14:30:00;NORTE;29;0;29;1
2018-12-17 15:00:00;NORTE;41;0;41;1
2018-12-17 15:30:00;NORTE;34;0;34;1
2018-12-17 16:00:00;NORTE;28;0;28;1
2018-12-17 16:30:00;NORTE;16;0;16;1
2018-12-17 17:00:00;NORTE;25;0;25;1
2018-12-17 17:30:00;NORTE;32;0;32;1
2018-12-17 18:00:00;NORTE;28;0;28;1
2018-12-17 18:30:00;NORTE;35;0;35;1
2018-12-17 19:00:00;NORTE;38;0;38;1
2018-12-17 19:30:00;NORTE;28;0;28;1
2018-12-17 20:00:00;NORTE;29;0;29;1
2018-12-17 20:30:00;NORTE;28;0;28;1
2018-12-17 21:00:00;NORTE;36;0;36;1
2018-12-17 21:30:00;NORTE;18;0;18;1
2018-12-17 22:00:00;NORTE;13;0;13;1
2018-12-17 22:30:00;NORTE;12;0;12;1
2018-12-17 23:00:00;NORTE;9;0;9;1
2018-12-17 23:30:00;NORTE;8;0;8;1
2018-12-18 01:30:00;NORTE;1;0;1;1
2018-12-18 02:30:00;NORTE;1;0;1;1
2018-12-18 03:00:00;NORTE;1;0;1;1
2018-12-18 03:30:00;NORTE;6;0;6;1
2018-12-18 04:00:00;NORTE;2;0;2;1
2018-12-18 04:30:00;NORTE;11;0;11;1
2018-12-18 05:00:00;NORTE;8;0;8;1
2018-12-18 05:30:00;NORTE;13;0;13;1
2018-12-18 06:00:00;NORTE;22;0;22;1
2018-12-18 06:30:00;NORTE;34;0;34;1
2018-12-18 07:00:00;NORTE;32;0;32;1
2018-12-18 07:30:00;NORTE;18;0;18;1
2018-12-18 08:00:00;NORTE;43;0;43;1
2018-12-18 08:30:00;NORTE;31;0;31;1
2018-12-18 09:00:00;NORTE;34;0;34;1
2018-12-18 09:30:00;NORTE;30;0;30;1
2018-12-18 10:00:00;NORTE;27;0;27;1
2018-12-18 10:30:00;NORTE;39;1;40;1
2018-12-18 11:00:00;NORTE;37;0;37;1
2018-12-18 11:30:00;NORTE;27;0;27;1
2018-12-18 12:00:00;NORTE;23;0;23;1
2018-12-18 12:30:00;NORTE;31;0;31;1
2018-12-18 13:00:00;NORTE;25;0;25;1
2018-12-18 13:30:00;NORTE;33;0;33;1
2018-12-18 14:00:00;NORTE;33;0;33;1
2018-12-18 14:30:00;NORTE;38;0;38;1
2018-12-18 15:00:00;NORTE;42;0;42;1
2018-12-18 15:30:00;NORTE;32;0;32;1
2018-12-18 16:00:00;NORTE;29;0;29;1
2018-12-18 16:30:00;NORTE;16;0;16;1
2018-12-18 17:00:00;NORTE;17;0;17;1
2018-12-18 17:30:00;NORTE;37;0;37;1
2018-12-18 18:00:00;NORTE;16;0;16;1
2018-12-18 18:30:00;NORTE;28;0;28;1
2018-12-18 19:00:00;NORTE;42;0;42;1
2018-12-18 19:30:00;NORTE;28;0;28;1
2018-12-18 20:00:00;NORTE;23;0;23;1
2018-12-18 20:30:00;NORTE;29;0;29;1
2018-12-18 21:00:00;NORTE;36;0;36;1
2018-12-18 21:30:00;NORTE;26;0;26;1
2018-12-18 22:00:00;NORTE;10;0;10;1
2018-12-18 22:30:00;NORTE;12;0;12;1
2018-12-18 23:00:00;NORTE;12;0;12;1
2018-12-18 23:30:00;NORTE;3;0;3;1
2018-12-19 00:00:00;NORTE;3;0;3;1
2018-12-19 01:00:00;NORTE;1;0;1;1
2018-12-19 01:30:00;NORTE;2;0;2;1
2018-12-19 02:30:00;NORTE;2;0;2;1
2018-12-19 03:00:00;NORTE;1;0;1;1
2018-12-19 03:30:00;NORTE;5;0;5;1
2018-12-19 04:00:00;NORTE;3;0;3;1
2018-12-19 04:30:00;NORTE;5;0;5;1
2018-12-19 05:00:00;NORTE;10;0;10;1
2018-12-19 05:30:00;NORTE;14;0;14;1
2018-12-19 06:00:00;NORTE;20;0;20;1
2018-12-19 06:30:00;NORTE;41;0;41;1
2018-12-19 07:00:00;NORTE;17;0;17;1
2018-12-19 07:30:00;NORTE;21;0;21;1
2018-12-19 08:00:00;NORTE;30;0;30;1
2018-12-19 08:30:00;NORTE;24;0;24;1
2018-12-19 09:00:00;NORTE;29;0;29;1
2018-12-19 09:30:00;NORTE;40;0;40;1
2018-12-19 10:00:00;NORTE;29;0;29;1
2018-12-19 10:30:00;NORTE;44;0;44;1
2018-12-19 11:00:00;NORTE;38;0;38;1
2018-12-19 11:30:00;NORTE;29;0;29;1
2018-12-19 12:00:00;NORTE;29;0;29;1
2018-12-19 12:30:00;NORTE;30;0;30;1
2018-12-19 13:00:00;SUR;0;29;29;1
2018-12-19 13:30:00;SUR;0;26;26;1
2018-12-19 14:00:00;SUR;0;38;38;1
2018-12-19 14:30:00;SUR;0;36;36;1
2018-12-19 15:00:00;SUR;0;40;40;1
2018-12-19 15:30:00;SUR;0;33;33;1
2018-12-19 16:00:00;SUR;0;31;31;1
2018-12-19 16:30:00;SUR;0;17;17;1
2018-12-19 17:00:00;SUR;0;19;19;1
2018-12-19 17:30:00;SUR;0;28;28;1
2018-12-19 18:00:00;SUR;0;24;24;1
2018-12-19 18:30:00;SUR;0;28;28;1
2018-12-19 19:00:00;SUR;0;41;41;1
2018-12-19 19:30:00;SUR;1;26;27;1
2018-12-19 20:00:00;CONFLICTIVA;8;18;26;2
2018-12-19 20:30:00;NORTE;25;0;25;1
2018-12-19 21:00:00;NORTE;35;0;35;1
2018-12-19 21:30:00;NORTE;25;0;25;1
2018-12-19 22:00:00;NORTE;19;0;19;1
2018-12-19 22:30:00;NORTE;13;0;13;1
2018-12-19 23:00:00;NORTE;10;0;10;1
2018-12-19 23:30:00;NORTE;5;0;5;1
2018-12-20 00:00:00;NORTE;4;0;4;1
2018-12-20 00:30:00;NORTE;1;0;1;1
2018-12-20 01:00:00;NORTE;1;0;1;1
2018-12-20 01:30:00;NORTE;3;0;3;1
2018-12-20 02:30:00;NORTE;2;0;2;1
2018-12-20 03:30:00;NORTE;3;0;3;1
2018-12-20 04:00:00;NORTE;4;0;4;1
2018-12-20 04:30:00;NORTE;7;0;7;1
2018-12-20 05:00:00;NORTE;10;0;10;1
2018-12-20 05:30:00;NORTE;16;0;16;1
2018-12-20 06:00:00;NORTE;19;0;19;1
2018-12-20 06:30:00;NORTE;34;0;34;1
2018-12-20 07:00:00;NORTE;25;0;25;1
2018-12-20 07:30:00;NORTE;23;0;23;1
2018-12-20 08:00:00;NORTE;30;0;30;1
2018-12-20 08:30:00;NORTE;26;0;26;1
2018-12-20 09:00:00;NORTE;37;0;37;1
2018-12-20 09:30:00;NORTE;37;0;37;1
2018-12-20 10:00:00;NORTE;27;0;27;1
2018-12-20 10:30:00;NORTE;34;0;34;1
2018-12-20 11:00:00;NORTE;33;0;33;1
2018-12-20 11:30:00;NORTE;35;0;35;1
2018-12-20 12:00:00;NORTE;33;0;33;1
2018-12-20 12:30:00;NORTE;30;0;30;1
2018-12-20 13:00:00;NORTE;23;0;23;1
2018-12-20 13:30:00;NORTE;35;0;35;1
2018-12-20 14:00:00;NORTE;37;0;37;1
2018-12-20 14:30:00;NORTE;31;0;31;1
2018-12-20 15:00:00;NORTE;40;0;40;1
2018-12-20 15:30:00;NORTE;43;0;43;1
2018-12-20 16:00:00;NORTE;27;0;27;1
2018-12-20 16:30:00;NORTE;17;0;17;1
2018-12-20 17:00:00;NORTE;24;0;24;1
2018-12-20 17:30:00;NORTE;26;0;26;1
2018-12-20 18:00:00;NORTE;32;0;32;1
2018-12-20 18:30:00;NORTE;31;0;31;1
2018-12-20 19:00:00;NORTE;39;0;39;1
2018-12-20 19:30:00;NORTE;31;0;31;1
2018-12-20 20:00:00;NORTE;27;0;27;1
2018-12-20 20:30:00;NORTE;25;0;25;1
2018-12-20 21:00:00;NORTE;35;0;35;1
2018-12-20 21:30:00;NORTE;27;0;27;1
2018-12-20 22:00:00;NORTE;13;0;13;1
2018-12-20 22:30:00;NORTE;9;0;9;1
2018-12-20 23:00:00;NORTE;9;0;9;1
2018-12-20 23:30:00;NORTE;8;0;8;1
2018-12-21 00:00:00;NORTE;3;0;3;1
2018-12-21 01:00:00;NORTE;2;0;2;1
2018-12-21 02:00:00;NORTE;1;0;1;1
2018-12-21 02:30:00;NORTE;1;0;1;1
2018-12-21 03:30:00;NORTE;1;0;1;1
2018-12-21 03:44:00;NORTE;1;0;1;1
2018-12-21 04:00:00;NORTE;6;0;6;1
2018-12-21 04:30:00;NORTE;1;0;1;1
2018-12-21 04:35:00;NORTE;8;0;8;1
2018-12-21 05:00:00;NORTE;9;0;9;1
2018-12-21 05:30:00;NORTE;14;0;14;1
2018-12-21 06:00:00;NORTE;15;0;15;1
2018-12-21 06:30:00;NORTE;35;0;35;1
2018-12-21 07:00:00;NORTE;24;0;24;1
2018-12-21 07:30:00;NORTE;24;0;24;1
2018-12-21 08:00:00;NORTE;38;0;38;1
2018-12-21 08:30:00;NORTE;25;0;25;1
2018-12-21 09:00:00;NORTE;29;0;29;1
2018-12-21 09:30:00;NORTE;27;0;27;1
2018-12-21 10:00:00;NORTE;32;0;32;1
2018-12-21 10:30:00;NORTE;39;0;39;1
2018-12-21 11:00:00;NORTE;39;0;39;1
2018-12-21 11:30:00;NORTE;32;0;32;1
2018-12-21 12:00:00;NORTE;32;0;32;1
2018-12-21 12:30:00;NORTE;29;1;30;1
2018-12-21 13:00:00;NORTE;27;0;27;1
2018-12-21 13:30:00;NORTE;35;0;35;1
2018-12-21 14:00:00;NORTE;33;0;33;1
2018-12-21 14:30:00;NORTE;33;0;33;1
2018-12-21 15:00:00;NORTE;14;0;14;1
2018-12-21 15:11:00;NORTE;26;0;26;1
2018-12-21 15:30:00;NORTE;36;0;36;1
2018-12-21 16:00:00;NORTE;30;0;30;1
2018-12-21 16:30:00;NORTE;20;0;20;1
2018-12-21 17:00:00;NORTE;27;0;27;1
2018-12-21 17:30:00;NORTE;29;0;29;1
2018-12-21 18:00:00;NORTE;34;0;34;1
2018-12-21 18:30:00;NORTE;28;0;28;1
2018-12-21 19:00:00;NORTE;26;0;26;1
2018-12-21 19:21:00;NORTE;12;0;12;1
2018-12-21 19:30:00;NORTE;26;0;26;1
2018-12-21 20:00:00;NORTE;33;0;33;1
2018-12-21 20:30:00;NORTE;29;0;29;1
2018-12-21 21:00:00;NORTE;28;0;28;1
2018-12-21 21:30:00;NORTE;29;0;29;1
2018-12-21 22:00:00;NORTE;20;0;20;1
2018-12-21 22:30:00;NORTE;17;0;17;1
2018-12-21 23:00:00;NORTE;13;0;13;1
2018-12-21 23:30:00;NORTE;11;0;11;1
2018-12-22 00:00:00;NORTE;2;0;2;1
2018-12-22 00:30:00;NORTE;2;0;2;1
2018-12-22 01:00:00;NORTE;4;0;4;1
2018-12-22 01:30:00;NORTE;1;0;1;1
2018-12-22 02:00:00;NORTE;1;0;1;1
2018-12-22 02:30:00;NORTE;1;0;1;1
2018-12-22 03:00:00;NORTE;4;0;4;1
2018-12-22 03:30:00;NORTE;2;0;2;1
2018-12-22 04:00:00;NORTE;1;0;1;1
2018-12-22 04:30:00;NORTE;5;0;5;1
2018-12-22 05:00:00;NORTE;8;0;8;1
2018-12-22 05:30:00;NORTE;13;0;13;1
2018-12-22 06:00:00;NORTE;20;0;20;1
2018-12-22 06:30:00;NORTE;24;0;24;1
2018-12-22 07:00:00;NORTE;19;0;19;1
2018-12-22 07:30:00;NORTE;18;0;18;1
2018-12-22 08:00:00;NORTE;35;0;35;1
2018-12-22 08:30:00;NORTE;27;0;27;1
2018-12-22 09:00:00;NORTE;36;0;36;1
2018-12-22 09:30:00;NORTE;33;0;33;1
2018-12-22 10:00:00;NORTE;25;0;25;1
2018-12-22 10:30:00;NORTE;42;0;42;1
2018-12-22 11:00:00;NORTE;34;0;34;1
2018-12-22 11:30:00;NORTE;34;0;34;1
2018-12-22 12:00:00;NORTE;25;0;25;1
2018-12-22 12:30:00;NORTE;27;0;27;1
2018-12-22 13:00:00;NORTE;34;0;34;1
2018-12-22 13:30:00;NORTE;26;0;26;1
2018-12-22 14:00:00;NORTE;34;0;34;1
2018-12-22 14:30:00;NORTE;34;0;34;1
2018-12-22 15:00:00;NORTE;32;0;32;1
2018-12-22 15:30:00;NORTE;32;0;32;1
2018-12-22 16:00:00;NORTE;30;0;30;1
2018-12-22 16:30:00;NORTE;16;0;16;1
2018-12-22 17:00:00;NORTE;21;0;21;1
2018-12-22 17:30:00;NORTE;34;0;34;1
2018-12-22 18:00:00;NORTE;22;0;22;1
2018-12-22 18:30:00;NORTE;21;0;21;1
2018-12-22 19:00:00;NORTE;39;0;39;1
2018-12-22 19:30:00;NORTE;20;0;20;1
2018-12-22 20:00:00;NORTE;19;0;19;1
2018-12-22 20:30:00;NORTE;26;0;26;1
2018-12-22 21:00:00;NORTE;22;0;22;1
2018-12-22 21:30:00;NORTE;16;0;16;1
2018-12-22 22:00:00;NORTE;12;0;12;1
2018-12-22 22:30:00;NORTE;12;0;12;1
2018-12-22 23:00:00;NORTE;8;0;8;1
2018-12-22 23:30:00;NORTE;5;0;5;1
2018-12-22 23:41:00;NORTE;1;0;1;1
2018-12-23 00:00:00;NORTE;2;0;2;1
2018-12-23 01:00:00;NORTE;1;0;1;1
2018-12-23 01:30:00;NORTE;2;0;2;1
2018-12-23 02:00:00;NORTE;1;0;1;1
2018-12-23 03:00:00;NORTE;4;0;4;1
2018-12-23 03:30:00;NORTE;2;0;2;1
2018-12-23 04:00:00;NORTE;5;0;5;1
2018-12-23 04:30:00;NORTE;1;0;1;1
2018-12-23 05:00:00;NORTE;9;0;9;1
2018-12-23 05:30:00;NORTE;12;0;12;1
2018-12-23 06:00:00;NORTE;18;0;18;1
2018-12-23 06:30:00;NORTE;5;0;5;1
2018-12-23 06:38:00;NORTE;17;0;17;1
2018-12-23 07:00:00;NORTE;11;0;11;1
2018-12-23 07:30:00;NORTE;18;0;18;1
2018-12-23 08:00:00;NORTE;30;0;30;1
2018-12-23 08:30:00;NORTE;23;0;23;1
2018-12-23 09:00:00;NORTE;16;0;16;1
2018-12-23 09:18:00;NORTE;13;0;13;1
2018-12-23 09:30:00;NORTE;29;0;29;1
2018-12-23 10:00:00;NORTE;26;0;26;1
2018-12-23 10:30:00;NORTE;36;0;36;1
2018-12-23 11:00:00;NORTE;19;0;19;1
2018-12-23 11:16:00;NORTE;16;0;16;1
2018-12-23 11:30:00;NORTE;37;0;37;1
2018-12-23 12:00:00;NORTE;27;0;27;1
2018-12-23 12:30:00;NORTE;33;0;33;1
2018-12-23 13:00:00;NORTE;25;0;25;1
2018-12-23 13:30:00;NORTE;22;0;22;1
2018-12-23 14:00:00;NORTE;29;0;29;1
2018-12-23 14:30:00;NORTE;37;0;37;1
2018-12-23 15:00:00;NORTE;39;0;39;1
2018-12-23 15:30:00;NORTE;35;0;35;1
2018-12-23 16:00:00;NORTE;31;0;31;1
2018-12-23 16:30:00;NORTE;24;0;24;1
2018-12-23 17:00:00;NORTE;6;0;6;1
2018-12-23 17:17:00;NORTE;10;0;10;1
2018-12-23 17:30:00;NORTE;8;0;8;1
2018-12-23 17:44:00;NORTE;9;0;9;1
2018-12-23 18:00:00;NORTE;19;0;19;1
2018-12-23 18:30:00;NORTE;19;0;19;1
2018-12-23 19:00:00;NORTE;24;0;24;1
2018-12-23 19:30:00;NORTE;25;0;25;1
2018-12-23 20:00:00;NORTE;25;0;25;1
2018-12-23 20:30:00;NORTE;28;0;28;1
2018-12-23 21:00:00;NORTE;20;0;20;1
2018-12-23 21:30:00;NORTE;24;0;24;1
2018-12-23 22:00:00;NORTE;17;0;17;1
2018-12-23 22:30:00;NORTE;21;0;21;1
2018-12-23 23:00:00;NORTE;14;0;14;1
2018-12-23 23:30:00;NORTE;16;0;16;1
2018-12-24 00:00:00;NORTE;15;0;15;1
2018-12-24 00:30:00;NORTE;8;0;8;1
2018-12-24 01:00:00;NORTE;6;0;6;1
2018-12-24 01:30:00;NORTE;3;0;3;1
2018-12-24 02:00:00;NORTE;2;0;2;1
2018-12-24 02:30:00;NORTE;3;0;3;1
2018-12-24 03:00:00;NORTE;4;0;4;1
2018-12-24 03:30:00;NORTE;3;0;3;1
2018-12-24 04:00:00;NORTE;1;0;1;1
2018-12-24 04:30:00;NORTE;8;0;8;1
2018-12-24 05:00:00;NORTE;4;0;4;1
2018-12-24 05:30:00;NORTE;8;0;8;1
2018-12-24 06:00:00;NORTE;11;0;11;1
2018-12-24 06:23:00;NORTE;7;0;7;1
2018-12-24 06:30:00;NORTE;23;0;23;1
2018-12-24 07:00:00;NORTE;26;0;26;1
2018-12-24 07:30:00;NORTE;10;0;10;1
2018-12-24 07:43:00;NORTE;13;0;13;1
2018-12-24 08:00:00;NORTE;29;0;29;1
2018-12-24 08:30:00;NORTE;23;0;23;1
2018-12-24 09:00:00;NORTE;30;0;30;1
2018-12-24 09:30:00;NORTE;36;0;36;1
2018-12-24 10:00:00;NORTE;23;0;23;1
2018-12-24 10:30:00;NORTE;39;0;39;1
2018-12-24 11:00:00;NORTE;42;0;42;1
2018-12-24 11:30:00;NORTE;32;0;32;1
2018-12-24 12:00:00;NORTE;32;0;32;1
2018-12-24 12:30:00;NORTE;29;0;29;1
2018-12-24 13:00:00;NORTE;24;0;24;1
2018-12-24 13:30:00;NORTE;33;0;33;1
2018-12-24 14:00:00;NORTE;31;0;31;1
2018-12-24 14:30:00;NORTE;30;0;30;1
2018-12-24 15:00:00;NORTE;30;0;30;1
2018-12-24 15:30:00;NORTE;26;0;26;1
2018-12-24 16:00:00;NORTE;23;0;23;1
2018-12-24 16:30:00;NORTE;19;0;19;1
2018-12-24 17:00:00;NORTE;19;0;19;1
2018-12-24 17:30:00;NORTE;23;0;23;1
2018-12-24 18:00:00;NORTE;16;0;16;1
2018-12-24 18:30:00;NORTE;21;0;21;1
2018-12-24 19:00:00;NORTE;21;0;21;1
2018-12-24 19:30:00;NORTE;19;0;19;1
2018-12-24 20:00:00;NORTE;15;0;15;1
2018-12-24 20:30:00;NORTE;12;0;12;1
2018-12-24 21:00:00;NORTE;14;0;14;1
2018-12-24 21:30:00;NORTE;4;0;4;1
2018-12-24 22:00:00;NORTE;5;0;5;1
2018-12-24 22:30:00;NORTE;1;0;1;1
2018-12-24 23:00:00;NORTE;9;0;9;1
2018-12-24 23:30:00;NORTE;2;0;2;1
2018-12-25 02:00:00;NORTE;1;0;1;1
2018-12-25 02:30:00;NORTE;1;0;1;1
2018-12-25 03:00:00;NORTE;1;0;1;1
2018-12-25 03:30:00;NORTE;3;0;3;1
2018-12-25 04:00:00;NORTE;2;0;2;1
2018-12-25 04:30:00;NORTE;8;0;8;1
2018-12-25 05:00:00;NORTE;5;0;5;1
2018-12-25 05:30:00;NORTE;2;0;2;1
2018-12-25 06:00:00;NORTE;11;0;11;1
2018-12-25 06:30:00;NORTE;21;0;21;1
2018-12-25 07:00:00;NORTE;13;0;13;1
2018-12-25 07:30:00;NORTE;17;0;17;1
2018-12-25 08:00:00;NORTE;19;0;19;1
2018-12-25 08:30:00;NORTE;19;0;19;1
2018-12-25 09:00:00;NORTE;24;0;24;1
2018-12-25 09:30:00;NORTE;17;0;17;1
2018-12-25 10:00:00;NORTE;19;0;19;1
2018-12-25 10:30:00;NORTE;25;0;25;1
2018-12-25 11:00:00;NORTE;21;0;21;1
2018-12-25 11:30:00;NORTE;20;0;20;1
2018-12-25 12:00:00;NORTE;28;0;28;1
2018-12-25 12:30:00;NORTE;12;0;12;1
2018-12-25 13:00:00;NORTE;19;0;19;1
2018-12-25 13:30:00;NORTE;16;0;16;1
2018-12-25 14:00:00;NORTE;21;0;21;1
2018-12-25 14:30:00;NORTE;27;0;27;1
2018-12-25 15:00:00;NORTE;32;0;32;1
2018-12-25 15:30:00;NORTE;17;0;17;1
2018-12-25 16:00:00;NORTE;14;0;14;1
2018-12-25 16:30:00;NORTE;11;0;11;1
2018-12-25 17:00:00;NORTE;14;0;14;1
2018-12-25 17:30:00;NORTE;32;0;32;1
2018-12-25 18:00:00;NORTE;13;0;13;1
2018-12-25 18:30:00;NORTE;21;0;21;1
2018-12-25 19:00:00;NORTE;30;0;30;1
2018-12-25 19:30:00;NORTE;19;0;19;1
2018-12-25 20:00:00;NORTE;19;0;19;1
2018-12-25 20:30:00;NORTE;19;0;19;1
2018-12-25 21:00:00;NORTE;20;0;20;1
2018-12-25 21:30:00;NORTE;9;0;9;1
2018-12-25 22:00:00;NORTE;6;0;6;1
2018-12-25 22:30:00;NORTE;3;0;3;1
2018-12-25 23:00:00;NORTE;9;0;9;1
2018-12-25 23:30:00;NORTE;3;0;3;1
2018-12-26 00:00:00;NORTE;2;0;2;1
2018-12-26 00:30:00;NORTE;1;0;1;1
2018-12-26 02:30:00;NORTE;1;0;1;1
2018-12-26 03:30:00;NORTE;5;0;5;1
2018-12-26 04:00:00;NORTE;2;0;2;1
2018-12-26 04:30:00;NORTE;6;0;6;1
2018-12-26 05:00:00;NORTE;8;0;8;1
2018-12-26 05:30:00;NORTE;5;0;5;1
2018-12-26 06:00:00;NORTE;16;0;16;1
2018-12-26 06:30:00;NORTE;31;0;31;1
2018-12-26 07:00:00;NORTE;20;0;20;1
2018-12-26 07:30:00;NORTE;25;0;25;1
2018-12-26 08:00:00;NORTE;30;0;30;1
2018-12-26 08:30:00;NORTE;24;0;24;1
2018-12-26 09:00:00;NORTE;38;0;38;1
2018-12-26 09:30:00;NORTE;33;0;33;1
2018-12-26 10:00:00;NORTE;22;0;22;1
2018-12-26 10:30:00;NORTE;39;0;39;1
2018-12-26 11:00:00;NORTE;30;0;30;1
2018-12-26 11:30:00;NORTE;37;0;37;1
2018-12-26 12:00:00;NORTE;25;0;25;1
2018-12-26 12:30:00;NORTE;32;0;32;1
2018-12-26 13:00:00;NORTE;29;0;29;1
2018-12-26 13:30:00;NORTE;30;0;30;1
2018-12-26 14:00:00;NORTE;34;0;34;1
2018-12-26 14:30:00;NORTE;35;0;35;1
2018-12-26 15:00:00;NORTE;43;0;43;1
2018-12-26 15:30:00;NORTE;29;0;29;1
2018-12-26 16:00:00;NORTE;21;0;21;1
2018-12-26 16:30:00;NORTE;14;0;14;1
2018-12-26 17:00:00;NORTE;21;0;21;1
2018-12-26 17:30:00;NORTE;40;0;40;1
2018-12-26 18:00:00;NORTE;17;0;17;1
2018-12-26 18:30:00;NORTE;29;1;30;1
2018-12-26 19:00:00;NORTE;40;0;40;1
2018-12-26 19:30:00;NORTE;26;0;26;1
2018-12-26 20:00:00;NORTE;20;0;20;1
2018-12-26 20:30:00;NORTE;30;0;30;1
2018-12-26 21:00:00;NORTE;32;0;32;1
2018-12-26 21:30:00;NORTE;19;0;19;1
2018-12-26 22:00:00;NORTE;16;0;16;1
2018-12-26 22:30:00;NORTE;13;0;13;1
2018-12-26 23:00:00;NORTE;11;0;11;1
2018-12-26 23:30:00;NORTE;3;0;3;1
2018-12-27 00:00:00;NORTE;1;0;1;1
2018-12-27 01:00:00;NORTE;3;0;3;1
2018-12-27 01:30:00;NORTE;2;0;2;1
2018-12-27 02:30:00;NORTE;1;0;1;1
2018-12-27 03:00:00;NORTE;2;0;2;1
2018-12-27 03:30:00;NORTE;4;0;4;1
2018-12-27 04:00:00;NORTE;2;0;2;1
2018-12-27 04:30:00;NORTE;7;0;7;1
2018-12-27 05:00:00;NORTE;7;0;7;1
2018-12-27 05:30:00;NORTE;10;0;10;1
2018-12-27 06:00:00;NORTE;19;0;19;1
2018-12-27 06:30:00;NORTE;29;0;29;1
2018-12-27 07:00:00;NORTE;21;0;21;1
2018-12-27 07:30:00;NORTE;23;0;23;1
2018-12-27 08:00:00;NORTE;33;0;33;1
2018-12-27 08:30:00;NORTE;31;0;31;1
2018-12-27 09:00:00;NORTE;38;0;38;1
2018-12-27 09:30:00;NORTE;23;0;23;1
2018-12-27 10:00:00;NORTE;23;0;23;1
2018-12-27 10:30:00;NORTE;38;0;38;1
2018-12-27 11:00:00;NORTE;38;0;38;1
2018-12-27 11:30:00;NORTE;30;0;30;1
2018-12-27 12:00:00;NORTE;30;0;30;1
2018-12-27 12:30:00;NORTE;32;0;32;1
2018-12-27 13:00:00;NORTE;34;0;34;1
2018-12-27 13:30:00;NORTE;35;0;35;1
2018-12-27 14:00:00;NORTE;26;0;26;1
2018-12-27 14:30:00;NORTE;35;0;35;1
2018-12-27 15:00:00;NORTE;37;0;37;1
2018-12-27 15:30:00;NORTE;32;0;32;1
2018-12-27 16:00:00;NORTE;23;0;23;1
2018-12-27 16:30:00;NORTE;16;0;16;1
2018-12-27 17:00:00;NORTE;27;0;27;1
2018-12-27 17:30:00;NORTE;27;0;27;1
2018-12-27 18:00:00;NORTE;26;0;26;1
2018-12-27 18:30:00;NORTE;40;0;40;1
2018-12-27 19:00:00;NORTE;37;0;37;1
2018-12-27 19:30:00;NORTE;34;0;34;1
2018-12-27 20:00:00;NORTE;26;0;26;1
2018-12-27 20:30:00;NORTE;31;0;31;1
2018-12-27 21:00:00;NORTE;27;0;27;1
2018-12-27 21:30:00;NORTE;23;0;23;1
2018-12-27 22:00:00;NORTE;14;0;14;1
2018-12-27 22:30:00;NORTE;10;0;10;1
2018-12-27 23:00:00;NORTE;11;0;11;1
2018-12-27 23:30:00;NORTE;4;0;4;1
2018-12-28 00:00:00;NORTE;2;0;2;1
2018-12-28 00:30:00;NORTE;1;0;1;1
2018-12-28 01:00:00;NORTE;2;0;2;1
2018-12-28 02:00:00;NORTE;1;0;1;1
2018-12-28 02:30:00;NORTE;2;0;2;1
2018-12-28 03:00:00;NORTE;5;0;5;1
2018-12-28 03:30:00;NORTE;2;0;2;1
2018-12-28 04:00:00;NORTE;4;0;4;1
2018-12-28 04:30:00;NORTE;8;0;8;1
2018-12-28 05:00:00;NORTE;8;0;8;1
2018-12-28 05:30:00;NORTE;10;0;10;1
2018-12-28 06:00:00;NORTE;19;0;19;1
2018-12-28 06:30:00;NORTE;27;0;27;1
2018-12-28 07:00:00;NORTE;19;0;19;1
2018-12-28 07:30:00;NORTE;26;0;26;1
2018-12-28 08:00:00;NORTE;37;0;37;1
2018-12-28 08:30:00;NORTE;33;0;33;1
2018-12-28 09:00:00;NORTE;33;0;33;1
2018-12-28 09:30:00;NORTE;29;0;29;1
2018-12-28 10:00:00;NORTE;29;0;29;1
2018-12-28 10:30:00;NORTE;39;0;39;1
2018-12-28 11:00:00;NORTE;30;0;30;1
2018-12-28 11:30:00;NORTE;32;0;32;1
2018-12-28 12:00:00;NORTE;31;0;31;1
2018-12-28 12:30:00;NORTE;26;0;26;1
2018-12-28 13:00:00;NORTE;32;0;32;1
2018-12-28 13:30:00;NORTE;28;1;29;1
2018-12-28 14:00:00;NORTE;35;0;35;1
2018-12-28 14:30:00;NORTE;38;0;38;1
2018-12-28 15:00:00;NORTE;34;0;34;1
2018-12-28 15:30:00;NORTE;31;0;31;1
2018-12-28 16:00:00;NORTE;26;0;26;1
2018-12-28 16:30:00;NORTE;20;0;20;1
2018-12-28 17:00:00;NORTE;27;0;27;1
2018-12-28 17:30:00;NORTE;33;0;33;1
2018-12-28 18:00:00;NORTE;24;0;24;1
2018-12-28 18:30:00;NORTE;37;0;37;1
2018-12-28 19:00:00;NORTE;33;0;33;1
2018-12-28 19:30:00;NORTE;31;0;31;1
2018-12-28 20:00:00;NORTE;33;0;33;1
2018-12-28 20:30:00;NORTE;27;0;27;1
2018-12-28 21:00:00;NORTE;30;0;30;1
2018-12-28 21:30:00;NORTE;20;0;20;1
2018-12-28 22:00:00;NORTE;12;0;12;1
2018-12-28 22:30:00;NORTE;11;0;11;1
2018-12-28 23:00:00;NORTE;14;0;14;1
2018-12-28 23:30:00;NORTE;2;0;2;1
2018-12-29 00:00:00;NORTE;2;0;2;1
2018-12-29 00:30:00;NORTE;1;0;1;1
2018-12-29 02:30:00;NORTE;2;0;2;1
2018-12-29 03:00:00;NORTE;3;0;3;1
2018-12-29 03:30:00;NORTE;3;0;3;1
2018-12-29 04:30:00;NORTE;5;0;5;1
2018-12-29 05:00:00;NORTE;10;0;10;1
2018-12-29 05:30:00;NORTE;12;0;12;1
2018-12-29 06:00:00;NORTE;15;0;15;1
2018-12-29 06:30:00;NORTE;26;0;26;1
2018-12-29 07:00:00;NORTE;22;0;22;1
2018-12-29 07:30:00;NORTE;26;0;26;1
2018-12-29 08:00:00;NORTE;34;0;34;1
2018-12-29 08:30:00;NORTE;29;0;29;1
2018-12-29 09:00:00;NORTE;37;0;37;1
2018-12-29 09:30:00;NORTE;34;0;34;1
2018-12-29 10:00:00;NORTE;22;0;22;1
2018-12-29 10:30:00;NORTE;42;0;42;1
2018-12-29 11:00:00;NORTE;34;0;34;1
2018-12-29 11:30:00;NORTE;28;0;28;1
2018-12-29 12:00:00;NORTE;30;0;30;1
2018-12-29 12:30:00;NORTE;24;0;24;1
2018-12-29 13:00:00;NORTE;32;0;32;1
2018-12-29 13:30:00;NORTE;31;0;31;1
2018-12-29 14:00:00;NORTE;29;0;29;1
2018-12-29 14:30:00;NORTE;30;0;30;1
2018-12-29 15:00:00;NORTE;36;0;36;1
2018-12-29 15:30:00;NORTE;25;0;25;1
2018-12-29 16:00:00;NORTE;24;0;24;1
2018-12-29 16:30:00;NORTE;17;0;17;1
2018-12-29 17:00:00;NORTE;20;0;20;1
2018-12-29 17:30:00;NORTE;33;0;33;1
2018-12-29 18:00:00;NORTE;16;0;16;1
2018-12-29 18:30:00;NORTE;22;0;22;1
2018-12-29 19:00:00;NORTE;35;0;35;1
2018-12-29 19:30:00;NORTE;18;0;18;1
2018-12-29 20:00:00;NORTE;21;0;21;1
2018-12-29 20:30:00;NORTE;24;0;24;1
2018-12-29 21:00:00;NORTE;20;0;20;1
2018-12-29 21:30:00;NORTE;22;0;22;1
2018-12-29 22:00:00;NORTE;9;0;9;1
2018-12-29 22:30:00;NORTE;6;0;6;1
2018-12-29 23:00:00;NORTE;12;0;12;1
2018-12-29 23:30:00;NORTE;4;0;4;1
2018-12-30 00:30:00;NORTE;2;0;2;1
2018-12-30 01:30:00;NORTE;2;0;2;1
2018-12-30 02:00:00;NORTE;1;0;1;1
2018-12-30 03:30:00;NORTE;6;0;6;1
2018-12-30 04:00:00;NORTE;3;0;3;1
2018-12-30 04:30:00;NORTE;1;0;1;1
2018-12-30 05:00:00;NORTE;10;0;10;1
2018-12-30 05:30:00;NORTE;11;0;11;1
2018-12-30 06:00:00;NORTE;21;0;21;1
2018-12-30 06:30:00;NORTE;23;0;23;1
2018-12-30 07:00:00;NORTE;11;0;11;1
2018-12-30 07:30:00;NORTE;22;0;22;1
2018-12-30 08:00:00;NORTE;27;0;27;1
2018-12-30 08:30:00;NORTE;27;0;27;1
2018-12-30 09:00:00;NORTE;30;0;30;1
2018-12-30 09:30:00;NORTE;27;0;27;1
2018-12-30 10:00:00;NORTE;26;0;26;1
2018-12-30 10:30:00;NORTE;38;0;38;1
2018-12-30 11:00:00;NORTE;40;0;40;1
2018-12-30 11:30:00;NORTE;32;0;32;1
2018-12-30 12:00:00;NORTE;30;0;30;1
2018-12-30 12:30:00;NORTE;29;0;29;1
2018-12-30 13:00:00;NORTE;33;0;33;1
2018-12-30 13:30:00;NORTE;30;0;30;1
2018-12-30 14:00:00;NORTE;32;0;32;1
2018-12-30 14:30:00;NORTE;30;0;30;1
2018-12-30 15:00:00;NORTE;36;0;36;1
2018-12-30 15:30:00;NORTE;27;0;27;1
2018-12-30 16:00:00;NORTE;25;0;25;1
2018-12-30 16:30:00;NORTE;18;0;18;1
2018-12-30 17:00:00;NORTE;26;0;26;1
2018-12-30 17:30:00;NORTE;31;0;31;1
2018-12-30 18:00:00;NORTE;26;0;26;1
2018-12-30 18:30:00;NORTE;38;0;38;1
2018-12-30 19:00:00;NORTE;33;0;33;1
2018-12-30 19:30:00;NORTE;32;0;32;1
2018-12-30 20:00:00;NORTE;31;0;31;1
2018-12-30 20:30:00;NORTE;25;0;25;1
2018-12-30 21:00:00;NORTE;29;0;29;1
2018-12-30 21:30:00;NORTE;18;0;18;1
2018-12-30 22:00:00;NORTE;11;0;11;1
2018-12-30 22:30:00;NORTE;8;0;8;1
2018-12-30 23:00:00;NORTE;12;0;12;1
2018-12-30 23:30:00;NORTE;4;0;4;1
2018-12-31 01:00:00;NORTE;2;0;2;1
2018-12-31 02:30:00;NORTE;1;0;1;1
2018-12-31 03:00:00;NORTE;7;0;7;1
2018-12-31 04:00:00;NORTE;2;0;2;1
2018-12-31 04:30:00;NORTE;5;0;5;1
2018-12-31 05:00:00;NORTE;7;0;7;1
2018-12-31 05:30:00;NORTE;14;0;14;1
2018-12-31 06:00:00;NORTE;13;0;13;1
2018-12-31 06:30:00;NORTE;32;0;32;1
2018-12-31 07:00:00;NORTE;19;0;19;1
2018-12-31 07:30:00;NORTE;28;0;28;1
2018-12-31 08:00:00;NORTE;25;0;25;1
2018-12-31 08:30:00;NORTE;27;0;27;1
2018-12-31 09:00:00;NORTE;37;0;37;1
2018-12-31 09:30:00;NORTE;26;0;26;1
2018-12-31 10:00:00;NORTE;21;0;21;1
2018-12-31 10:30:00;NORTE;37;0;37;1
2018-12-31 11:00:00;NORTE;39;0;39;1
2018-12-31 11:30:00;NORTE;29;0;29;1
2018-12-31 12:00:00;NORTE;33;0;33;1
2018-12-31 12:30:00;NORTE;28;0;28;1
2018-12-31 13:00:00;NORTE;29;0;29;1
2018-12-31 13:30:00;NORTE;29;0;29;1
2018-12-31 14:00:00;NORTE;33;0;33;1
2018-12-31 14:30:00;NORTE;31;0;31;1
2018-12-31 15:00:00;NORTE;28;1;29;1
2018-12-31 15:30:00;NORTE;20;0;20;1
2018-12-31 16:00:00;NORTE;18;0;18;1
2018-12-31 16:30:00;NORTE;18;0;18;1
2018-12-31 17:00:00;NORTE;28;0;28;1
2018-12-31 17:30:00;NORTE;17;0;17;1
2018-12-31 18:00:00;NORTE;23;0;23;1
2018-12-31 18:30:00;NORTE;28;0;28;1
2018-12-31 19:00:00;NORTE;23;0;23;1
2018-12-31 19:30:00;NORTE;18;0;18;1
2018-12-31 20:00:00;NORTE;20;0;20;1
2018-12-31 20:30:00;NORTE;12;0;12;1
2018-12-31 21:00:00;NORTE;11;0;11;1
2018-12-31 21:30:00;NORTE;4;0;4;1
2018-12-31 22:00:00;NORTE;6;0;6;1
2018-12-31 22:30:00;NORTE;6;0;6;1
2018-12-31 23:00:00;NORTE;4;0;4;1
2018-12-31 23:30:00;NORTE;1;0;1;1
2019-01-01 03:00:00;NORTE;3;0;3;1
2019-01-01 03:30:00;NORTE;3;0;3;1
2019-01-01 04:00:00;NORTE;2;0;2;1
2019-01-01 04:30:00;NORTE;1;0;1;1
2019-01-01 05:00:00;NORTE;9;0;9;1
2019-01-01 05:30:00;NORTE;4;0;4;1
2019-01-01 06:00:00;NORTE;7;0;7;1
2019-01-01 06:30:00;NORTE;23;0;23;1
2019-01-01 07:00:00;NORTE;18;0;18;1
2019-01-01 07:30:00;NORTE;19;0;19;1
2019-01-01 08:00:00;NORTE;22;0;22;1
2019-01-01 08:30:00;NORTE;30;0;30;1
2019-01-01 09:00:00;NORTE;27;0;27;1
2019-01-01 09:30:00;NORTE;25;0;25;1
2019-01-01 10:00:00;NORTE;21;0;21;1
2019-01-01 10:30:00;NORTE;36;0;36;1
2019-01-01 11:00:00;NORTE;25;0;25;1
2019-01-01 11:30:00;NORTE;23;0;23;1
2019-01-01 12:00:00;NORTE;32;0;32;1
2019-01-01 12:30:00;NORTE;23;0;23;1
2019-01-01 13:00:00;NORTE;24;0;24;1
2019-01-01 13:30:00;NORTE;26;0;26;1
2019-01-01 14:00:00;NORTE;30;0;30;1
2019-01-01 14:30:00;NORTE;30;0;30;1
2019-01-01 15:00:00;NORTE;34;0;34;1
2019-01-01 15:30:00;NORTE;40;0;40;1
2019-01-01 16:00:00;NORTE;22;0;22;1
2019-01-01 16:30:00;NORTE;14;0;14;1
2019-01-01 17:00:00;NORTE;21;0;21;1
2019-01-01 17:30:00;NORTE;31;0;31;1
2019-01-01 18:00:00;NORTE;25;0;25;1
2019-01-01 18:30:00;NORTE;28;0;28;1
2019-01-01 19:00:00;NORTE;36;0;36;1
2019-01-01 19:30:00;NORTE;28;0;28;1
2019-01-01 20:00:00;NORTE;27;0;27;1
2019-01-01 20:30:00;NORTE;23;0;23;1
2019-01-01 21:00:00;NORTE;27;0;27;1
2019-01-01 21:30:00;NORTE;23;0;23;1
2019-01-01 22:00:00;NORTE;8;0;8;1
2019-01-01 22:30:00;NORTE;8;0;8;1
2019-01-01 23:00:00;NORTE;11;0;11;1
2019-01-01 23:30:00;NORTE;1;0;1;1
2019-01-02 01:30:00;NORTE;1;0;1;1
2019-01-02 02:30:00;NORTE;1;0;1;1
2019-01-02 03:00:00;NORTE;2;0;2;1
2019-01-02 03:30:00;NORTE;3;0;3;1
2019-01-02 04:00:00;NORTE;3;0;3;1
2019-01-02 04:30:00;NORTE;5;0;5;1
2019-01-02 05:00:00;NORTE;7;0;7;1
2019-01-02 05:30:00;NORTE;11;0;11;1
2019-01-02 06:00:00;NORTE;16;0;16;1
2019-01-02 06:30:00;NORTE;33;0;33;1
2019-01-02 07:00:00;NORTE;21;0;21;1
2019-01-02 07:30:00;NORTE;29;0;29;1
2019-01-02 08:00:00;NORTE;39;0;39;1
2019-01-02 08:30:00;NORTE;32;0;32;1
2019-01-02 09:00:00;NORTE;33;0;33;1
2019-01-02 09:30:00;NORTE;32;0;32;1
2019-01-02 10:00:00;NORTE;23;0;23;1
2019-01-02 10:30:00;NORTE;35;0;35;1
2019-01-02 11:00:00;NORTE;34;0;34;1
2019-01-02 11:30:00;NORTE;28;0;28;1
2019-01-02 12:00:00;NORTE;34;0;34;1
2019-01-02 12:30:00;NORTE;30;0;30;1
2019-01-02 13:00:00;NORTE;29;0;29;1
2019-01-02 13:30:00;NORTE;34;0;34;1
2019-01-02 14:00:00;NORTE;36;0;36;1
2019-01-02 14:30:00;NORTE;38;0;38;1
2019-01-02 15:00:00;NORTE;37;0;37;1
2019-01-02 15:30:00;NORTE;34;0;34;1
2019-01-02 16:00:00;NORTE;21;0;21;1
2019-01-02 16:30:00;NORTE;15;0;15;1
2019-01-02 17:00:00;NORTE;28;0;28;1
2019-01-02 17:30:00;NORTE;32;0;32;1
2019-01-02 18:00:00;NORTE;25;0;25;1
2019-01-02 18:30:00;NORTE;28;0;28;1
2019-01-02 19:00:00;NORTE;40;0;40;1
2019-01-02 19:30:00;NORTE;29;0;29;1
2019-01-02 20:00:00;NORTE;20;0;20;1
2019-01-02 20:30:00;NORTE;31;0;31;1
2019-01-02 21:00:00;NORTE;29;0;29;1
2019-01-02 21:30:00;NORTE;23;0;23;1
2019-01-02 22:00:00;NORTE;12;0;12;1
2019-01-02 22:30:00;NORTE;7;0;7;1
2019-01-02 23:00:00;NORTE;14;0;14;1
2019-01-02 23:30:00;NORTE;5;0;5;1
2019-01-03 00:00:00;NORTE;2;0;2;1
2019-01-03 00:30:00;NORTE;3;0;3;1
2019-01-03 01:30:00;NORTE;2;0;2;1
2019-01-03 02:30:00;NORTE;1;0;1;1
2019-01-03 03:00:00;NORTE;2;0;2;1
2019-01-03 03:30:00;NORTE;5;0;5;1
2019-01-03 04:00:00;NORTE;4;0;4;1
2019-01-03 04:30:00;NORTE;6;0;6;1
2019-01-03 05:00:00;NORTE;9;0;9;1
2019-01-03 05:30:00;NORTE;16;0;16;1
2019-01-03 06:00:00;NORTE;15;0;15;1
2019-01-03 06:30:00;NORTE;34;0;34;1
2019-01-03 07:00:00;NORTE;26;0;26;1
2019-01-03 07:30:00;NORTE;26;0;26;1
2019-01-03 08:00:00;NORTE;33;0;33;1
2019-01-03 08:30:00;NORTE;33;0;33;1
2019-01-03 09:00:00;NORTE;33;0;33;1
2019-01-03 09:30:00;NORTE;34;0;34;1
2019-01-03 10:00:00;NORTE;26;0;26;1
2019-01-03 10:30:00;NORTE;31;0;31;1
2019-01-03 11:00:00;NORTE;37;0;37;1
2019-01-03 11:30:00;NORTE;36;0;36;1
2019-01-03 12:00:00;NORTE;31;0;31;1
2019-01-03 12:30:00;NORTE;30;0;30;1
2019-01-03 13:00:00;NORTE;31;0;31;1
2019-01-03 13:30:00;NORTE;35;0;35;1
2019-01-03 14:00:00;NORTE;31;0;31;1
2019-01-03 14:30:00;NORTE;33;0;33;1
2019-01-03 15:00:00;NORTE;44;0;44;1
2019-01-03 15:30:00;NORTE;34;0;34;1
2019-01-03 16:00:00;NORTE;21;0;21;1
2019-01-03 16:30:00;NORTE;20;0;20;1
2019-01-03 17:00:00;NORTE;28;0;28;1
2019-01-03 17:30:00;NORTE;30;0;30;1
2019-01-03 18:00:00;NORTE;23;0;23;1
2019-01-03 18:30:00;NORTE;32;0;32;1
2019-01-03 19:00:00;NORTE;43;0;43;1
2019-01-03 19:30:00;NORTE;27;0;27;1
2019-01-03 20:00:00;NORTE;27;0;27;1
2019-01-03 20:30:00;NORTE;32;0;32;1
2019-01-03 21:00:00;NORTE;34;0;34;1
2019-01-03 21:30:00;NORTE;18;0;18;1
2019-01-03 22:00:00;NORTE;12;0;12;1
2019-01-03 22:30:00;NORTE;11;0;11;1
2019-01-03 23:00:00;NORTE;12;0;12;1
2019-01-03 23:30:00;NORTE;5;0;5;1
2019-01-04 00:00:00;NORTE;1;0;1;1
2019-01-04 00:30:00;NORTE;3;0;3;1
2019-01-04 01:00:00;NORTE;1;0;1;1
2019-01-04 01:30:00;NORTE;1;0;1;1
2019-01-04 02:00:00;NORTE;1;0;1;1
2019-01-04 02:30:00;NORTE;1;0;1;1
2019-01-04 03:00:00;NORTE;2;0;2;1
2019-01-04 03:30:00;NORTE;6;0;6;1
2019-01-04 04:00:00;NORTE;4;0;4;1
2019-01-04 04:30:00;NORTE;6;0;6;1
2019-01-04 05:00:00;NORTE;8;0;8;1
2019-01-04 05:30:00;NORTE;10;0;10;1
2019-01-04 06:00:00;NORTE;15;0;15;1
2019-01-04 06:30:00;NORTE;33;0;33;1
2019-01-04 07:00:00;NORTE;21;0;21;1
2019-01-04 07:30:00;NORTE;26;0;26;1
2019-01-04 08:00:00;NORTE;33;0;33;1
2019-01-04 08:30:00;NORTE;32;0;32;1
2019-01-04 09:00:00;NORTE;39;0;39;1
2019-01-04 09:30:00;NORTE;25;0;25;1
2019-01-04 10:00:00;NORTE;23;0;23;1
2019-01-04 10:30:00;NORTE;46;0;46;1
2019-01-04 11:00:00;NORTE;30;0;30;1
2019-01-04 11:30:00;NORTE;26;0;26;1
2019-01-04 12:00:00;NORTE;26;0;26;1
2019-01-04 12:30:00;NORTE;30;0;30;1
2019-01-04 13:00:00;NORTE;30;1;31;1
2019-01-04 13:30:00;NORTE;33;0;33;1
2019-01-04 14:00:00;NORTE;31;0;31;1
2019-01-04 14:30:00;NORTE;34;0;34;1
2019-01-04 15:00:00;NORTE;43;0;43;1
2019-01-04 15:30:00;NORTE;33;0;33;1
2019-01-04 16:00:00;NORTE;27;0;27;1
2019-01-04 16:30:00;NORTE;16;0;16;1
2019-01-04 17:00:00;NORTE;22;0;22;1
2019-01-04 17:30:00;NORTE;33;0;33;1
2019-01-04 18:00:00;NORTE;29;0;29;1
2019-01-04 18:30:00;NORTE;32;0;32;1
2019-01-04 19:00:00;NORTE;35;0;35;1
2019-01-04 19:30:00;NORTE;35;0;35;1
2019-01-04 20:00:00;NORTE;25;0;25;1
2019-01-04 20:30:00;NORTE;32;0;32;1
2019-01-04 21:00:00;NORTE;29;0;29;1
2019-01-04 21:30:00;NORTE;21;0;21;1
2019-01-04 22:00:00;NORTE;11;0;11;1
2019-01-04 22:30:00;NORTE;10;0;10;1
2019-01-04 23:00:00;NORTE;11;0;11;1
2019-01-04 23:30:00;NORTE;2;0;2;1
2019-01-05 00:00:00;NORTE;1;0;1;1
2019-01-05 00:30:00;NORTE;1;0;1;1
2019-01-05 01:30:00;NORTE;1;0;1;1
2019-01-05 02:30:00;NORTE;1;0;1;1
2019-01-05 03:00:00;NORTE;1;0;1;1
2019-01-05 03:30:00;NORTE;2;0;2;1
2019-01-05 04:00:00;NORTE;5;0;5;1
2019-01-05 04:30:00;NORTE;3;0;3;1
2019-01-05 05:00:00;NORTE;10;0;10;1
2019-01-05 05:30:00;NORTE;14;0;14;1
2019-01-05 06:00:00;NORTE;16;0;16;1
2019-01-05 06:30:00;NORTE;21;0;21;1
2019-01-05 07:00:00;NORTE;20;0;20;1
2019-01-05 07:30:00;NORTE;19;0;19;1
2019-01-05 08:00:00;NORTE;39;0;39;1
2019-01-05 08:30:00;NORTE;29;0;29;1
2019-01-05 09:00:00;NORTE;36;0;36;1
2019-01-05 09:30:00;NORTE;29;0;29;1
2019-01-05 10:00:00;NORTE;24;0;24;1
2019-01-05 10:30:00;NORTE;37;0;37;1
2019-01-05 11:00:00;NORTE;34;0;34;1
2019-01-05 11:30:00;NORTE;27;0;27;1
2019-01-05 12:00:00;NORTE;32;0;32;1
2019-01-05 12:30:00;NORTE;29;0;29;1
2019-01-05 13:00:00;NORTE;33;0;33;1
2019-01-05 13:30:00;NORTE;25;0;25;1
2019-01-05 14:00:00;NORTE;32;0;32;1
2019-01-05 14:30:00;NORTE;27;0;27;1
2019-01-05 15:00:00;NORTE;38;0;38;1
2019-01-05 15:30:00;NORTE;29;0;29;1
2019-01-05 16:00:00;NORTE;20;0;20;1
2019-01-05 16:30:00;NORTE;15;0;15;1
2019-01-05 17:00:00;NORTE;22;0;22;1
2019-01-05 17:30:00;NORTE;32;0;32;1
2019-01-05 18:00:00;NORTE;19;0;19;1
2019-01-05 18:30:00;NORTE;28;0;28;1
2019-01-05 19:00:00;NORTE;31;0;31;1
2019-01-05 19:30:00;NORTE;17;0;17;1
2019-01-05 20:00:00;NORTE;21;0;21;1
2019-01-05 20:30:00;NORTE;26;0;26;1
2019-01-05 21:00:00;NORTE;15;0;15;1
2019-01-05 21:30:00;NORTE;14;0;14;1
2019-01-05 22:00:00;NORTE;11;0;11;1
2019-01-05 22:30:00;NORTE;9;0;9;1
2019-01-05 23:00:00;NORTE;9;0;9;1
2019-01-05 23:30:00;NORTE;4;0;4;1
2019-01-06 00:00:00;NORTE;1;0;1;1
2019-01-06 00:30:00;NORTE;2;0;2;1
2019-01-06 01:00:00;NORTE;1;0;1;1
2019-01-06 01:30:00;NORTE;1;0;1;1
2019-01-06 02:00:00;NORTE;2;0;2;1
2019-01-06 02:30:00;NORTE;1;0;1;1
2019-01-06 03:30:00;NORTE;6;0;6;1
2019-01-06 04:00:00;NORTE;2;0;2;1
2019-01-06 04:30:00;NORTE;3;0;3;1
2019-01-06 05:00:00;NORTE;8;0;8;1
2019-01-06 05:30:00;NORTE;7;0;7;1
2019-01-06 06:00:00;NORTE;12;0;12;1
2019-01-06 06:30:00;NORTE;26;0;26;1
2019-01-06 07:00:00;NORTE;16;0;16;1
2019-01-06 07:30:00;NORTE;20;0;20;1
2019-01-06 08:00:00;NORTE;28;0;28;1
2019-01-06 08:30:00;NORTE;35;0;35;1
2019-01-06 09:00:00;NORTE;33;0;33;1
2019-01-06 09:30:00;NORTE;28;0;28;1
2019-01-06 10:00:00;NORTE;18;0;18;1
2019-01-06 10:30:00;NORTE;45;0;45;1
2019-01-06 11:00:00;NORTE;37;0;37;1
2019-01-06 11:30:00;NORTE;27;0;27;1
2019-01-06 12:00:00;NORTE;27;0;27;1
2019-01-06 12:30:00;NORTE;30;0;30;1
2019-01-06 13:00:00;NORTE;34;0;34;1
2019-01-06 13:30:00;NORTE;33;0;33;1
2019-01-06 14:00:00;NORTE;37;0;37;1
2019-01-06 14:30:00;NORTE;31;0;31;1
2019-01-06 15:00:44;NORTE;1;0;1;1
2019-01-06 15:00:50;NORTE;1;0;1;1
2019-01-06 15:02:19;NORTE;1;0;1;1
2019-01-06 15:02:57;NORTE;1;0;1;1
2019-01-06 15:03:25;NORTE;1;0;1;1
2019-01-06 15:03:48;NORTE;1;0;1;1
2019-01-06 15:05:13;NORTE;1;0;1;1
2019-01-06 15:05:20;NORTE;1;0;1;1
2019-01-06 15:05:54;NORTE;1;0;1;1
2019-01-06 15:07:14;NORTE;1;0;1;1
2019-01-06 15:08:05;NORTE;1;0;1;1
2019-01-06 15:09:28;NORTE;1;0;1;1
2019-01-06 15:10:56;NORTE;1;0;1;1
2019-01-06 15:11:24;NORTE;1;0;1;1
2019-01-06 15:12:32;NORTE;1;0;1;1
2019-01-06 15:13:57;NORTE;1;0;1;1
2019-01-06 15:14:13;NORTE;1;0;1;1
2019-01-06 15:15:20;NORTE;1;0;1;1
2019-01-06 15:16:44;NORTE;1;0;1;1
2019-01-06 15:17:38;NORTE;1;0;1;1
2019-01-06 15:17:42;NORTE;1;0;1;1
2019-01-06 15:18:40;NORTE;1;0;1;1
2019-01-06 15:19:34;NORTE;1;0;1;1
2019-01-06 15:19:56;NORTE;1;0;1;1
2019-01-06 15:20:04;NORTE;1;0;1;1
2019-01-06 15:21:17;NORTE;1;0;1;1
2019-01-06 15:22:00;NORTE;1;0;1;1
2019-01-06 15:22:05;NORTE;1;0;1;1
2019-01-06 15:23:04;NORTE;1;0;1;1
2019-01-06 15:23:31;NORTE;1;0;1;1
2019-01-06 15:24:23;NORTE;1;0;1;1
2019-01-06 15:24:37;NORTE;1;0;1;1
2019-01-06 15:24:39;NORTE;1;0;1;1
2019-01-06 15:25:50;NORTE;1;0;1;1
2019-01-06 15:26:02;NORTE;1;0;1;1
2019-01-06 15:26:13;NORTE;1;0;1;1
2019-01-06 15:27:28;NORTE;1;0;1;1
2019-01-06 15:28:32;NORTE;1;0;1;1
2019-01-06 15:29:14;NORTE;1;0;1;1
2019-01-06 15:30:16;NORTE;1;0;1;1
2019-01-06 15:30:31;NORTE;1;0;1;1
2019-01-06 15:32:04;NORTE;1;0;1;1
2019-01-06 15:32:08;NORTE;1;0;1;1
2019-01-06 15:33:36;NORTE;1;0;1;1
2019-01-06 15:33:41;NORTE;1;0;1;1
2019-01-06 15:33:59;NORTE;1;0;1;1
2019-01-06 15:35:10;NORTE;1;0;1;1
2019-01-06 15:36:37;NORTE;1;0;1;1
2019-01-06 15:38:03;NORTE;1;0;1;1
2019-01-06 15:38:15;NORTE;1;0;1;1
2019-01-06 15:39:49;NORTE;1;0;1;1
2019-01-06 15:40:11;NORTE;1;0;1;1
2019-01-06 15:40:44;NORTE;1;0;1;1
2019-01-06 15:41:33;NORTE;1;0;1;1
2019-01-06 15:41:51;NORTE;1;0;1;1
2019-01-06 15:43:21;NORTE;1;0;1;1
2019-01-06 15:43:25;NORTE;1;0;1;1
2019-01-06 15:44:31;NORTE;1;0;1;1
2019-01-06 15:45:44;NORTE;1;0;1;1
2019-01-06 15:46:13;NORTE;1;0;1;1
2019-01-06 15:48:16;NORTE;1;0;1;1
2019-01-06 15:50:41;NORTE;1;0;1;1
2019-01-06 15:51:48;NORTE;1;0;1;1
2019-01-06 15:56:30;NORTE;1;0;1;1
2019-01-06 15:59:07;NORTE;1;0;1;1
2019-01-06 16:00:20;NORTE;1;0;1;1
2019-01-06 16:00:42;NORTE;1;0;1;1
2019-01-06 16:01:34;NORTE;1;0;1;1
2019-01-06 16:05:24;NORTE;1;0;1;1
2019-01-06 16:05:40;NORTE;1;0;1;1
2019-01-06 16:06:28;NORTE;1;0;1;1
2019-01-06 16:07:23;NORTE;1;0;1;1
2019-01-06 16:09:14;NORTE;1;0;1;1
2019-01-06 16:11:24;NORTE;1;0;1;1
2019-01-06 16:11:57;NORTE;1;0;1;1
2019-01-06 16:13:25;NORTE;1;0;1;1
2019-01-06 16:13:26;NORTE;1;0;1;1
2019-01-06 16:13:29;NORTE;1;0;1;1
2019-01-06 16:15:13;NORTE;1;0;1;1
2019-01-06 16:16:12;NORTE;1;0;1;1
2019-01-06 16:18:05;NORTE;1;0;1;1
2019-01-06 16:20:00;NORTE;1;0;1;1
2019-01-06 16:20:43;NORTE;1;0;1;1
2019-01-06 16:23:05;NORTE;1;0;1;1
2019-01-06 16:23:48;NORTE;1;0;1;1
2019-01-06 16:25:19;NORTE;1;0;1;1
2019-01-06 16:26:11;NORTE;1;0;1;1
2019-01-06 16:26:40;NORTE;1;0;1;1
2019-01-06 16:27:54;NORTE;1;0;1;1
2019-01-06 16:29:40;NORTE;1;0;1;1
2019-01-06 16:29:52;NORTE;1;0;1;1
2019-01-06 16:31:24;NORTE;1;0;1;1
2019-01-06 16:31:59;NORTE;2;0;2;1
2019-01-06 16:33:31;NORTE;1;0;1;1
2019-01-06 16:34:43;NORTE;1;0;1;1
2019-01-06 16:34:44;NORTE;1;0;1;1
2019-01-06 16:37:39;NORTE;1;0;1;1
2019-01-06 16:40:25;NORTE;1;0;1;1
2019-01-06 16:40:46;NORTE;1;0;1;1
2019-01-06 16:42:29;NORTE;1;0;1;1
2019-01-06 16:43:48;NORTE;1;0;1;1
2019-01-06 16:46:14;NORTE;1;0;1;1
2019-01-06 16:47:57;NORTE;1;0;1;1
2019-01-06 16:49:05;NORTE;1;0;1;1
2019-01-06 16:50:13;NORTE;1;0;1;1
2019-01-06 16:50:41;NORTE;1;0;1;1
2019-01-06 16:52:36;NORTE;1;0;1;1
2019-01-06 16:53:35;NORTE;1;0;1;1
2019-01-06 16:56:08;NORTE;1;0;1;1
2019-01-06 16:59:27;NORTE;1;0;1;1
2019-01-06 17:00:00;NORTE;23;0;23;1
2019-01-06 17:30:00;NORTE;33;0;33;1
2019-01-06 18:00:00;NORTE;33;0;33;1
2019-01-06 18:30:00;NORTE;31;0;31;1
2019-01-06 19:00:00;NORTE;37;0;37;1
2019-01-06 19:30:00;NORTE;42;0;42;1
2019-01-06 20:00:00;NORTE;31;0;31;1
2019-01-06 20:30:00;NORTE;31;0;31;1
2019-01-06 21:00:00;NORTE;29;0;29;1
2019-01-06 21:30:00;NORTE;22;0;22;1
2019-01-06 22:00:00;NORTE;10;0;10;1
2019-01-06 22:30:00;NORTE;11;0;11;1
2019-01-06 23:00:00;NORTE;13;0;13;1
2019-01-06 23:30:00;NORTE;7;0;7;1
2019-01-07 00:00:00;NORTE;2;0;2;1
2019-01-07 00:30:00;NORTE;1;0;1;1
2019-01-07 01:00:00;NORTE;1;0;1;1
2019-01-07 01:30:00;NORTE;1;0;1;1
2019-01-07 02:30:00;NORTE;1;0;1;1
2019-01-07 03:00:00;NORTE;4;0;4;1
2019-01-07 03:30:00;NORTE;1;0;1;1
2019-01-07 04:00:00;NORTE;2;0;2;1
2019-01-07 04:30:00;NORTE;7;0;7;1
2019-01-07 05:00:00;NORTE;8;0;8;1
2019-01-07 05:30:00;NORTE;11;0;11;1
2019-01-07 06:00:00;NORTE;18;0;18;1
2019-01-07 06:30:00;NORTE;37;0;37;1
2019-01-07 07:00:00;NORTE;26;0;26;1
2019-01-07 07:30:00;NORTE;37;0;37;1
2019-01-07 08:00:00;NORTE;36;0;36;1
2019-01-07 08:30:00;NORTE;29;0;29;1
2019-01-07 09:00:00;NORTE;29;0;29;1
2019-01-07 09:30:00;NORTE;35;0;35;1
2019-01-07 10:00:00;NORTE;29;0;29;1
2019-01-07 10:30:00;NORTE;36;0;36;1
2019-01-07 11:00:00;NORTE;38;0;38;1
2019-01-07 11:30:00;NORTE;28;0;28;1
2019-01-07 12:00:00;NORTE;21;0;21;1
2019-01-07 12:30:00;NORTE;31;0;31;1
2019-01-07 13:00:00;NORTE;17;0;17;1
2019-01-07 13:30:00;NORTE;29;0;29;1
2019-01-07 14:00:00;NORTE;41;0;41;1
2019-01-07 14:30:00;NORTE;34;0;34;1
2019-01-07 15:00:00;NORTE;34;0;34;1
2019-01-07 15:30:00;NORTE;26;0;26;1
2019-01-07 16:00:00;NORTE;25;0;25;1
2019-01-07 16:30:00;NORTE;22;0;22;1
2019-01-07 17:00:00;NORTE;27;0;27;1
2019-01-07 17:30:00;NORTE;33;0;33;1
2019-01-07 18:00:00;NORTE;31;0;31;1
2019-01-07 18:30:00;NORTE;38;0;38;1
2019-01-07 19:00:00;NORTE;40;0;40;1
2019-01-07 19:30:00;NORTE;29;0;29;1
2019-01-07 20:00:00;NORTE;23;0;23;1
2019-01-07 20:30:00;NORTE;37;0;37;1
2019-01-07 21:00:00;NORTE;35;0;35;1
2019-01-07 21:30:00;NORTE;20;0;20;1
2019-01-07 22:00:00;NORTE;16;0;16;1
2019-01-07 22:30:00;NORTE;3;0;3;1
2019-01-07 23:00:00;NORTE;11;0;11;1
2019-01-07 23:30:00;NORTE;3;0;3;1
2019-01-08 01:00:00;NORTE;1;0;1;1
2019-01-08 01:30:00;NORTE;1;0;1;1
2019-01-08 02:30:00;NORTE;1;0;1;1
2019-01-08 03:00:00;NORTE;2;0;2;1
2019-01-08 03:30:00;NORTE;5;0;5;1
2019-01-08 04:00:00;NORTE;2;0;2;1
2019-01-08 04:30:00;NORTE;4;0;4;1
2019-01-08 05:00:00;NORTE;10;0;10;1
2019-01-08 05:30:00;NORTE;16;0;16;1
2019-01-08 06:00:00;NORTE;21;0;21;1
2019-01-08 06:30:00;NORTE;38;0;38;1
2019-01-08 07:00:00;NORTE;24;0;24;1
2019-01-08 07:30:00;NORTE;24;0;24;1
2019-01-08 08:00:00;NORTE;29;0;29;1
2019-01-08 08:30:00;NORTE;32;0;32;1
2019-01-08 09:00:00;NORTE;39;0;39;1
2019-01-08 09:30:00;NORTE;30;0;30;1
2019-01-08 10:00:00;NORTE;24;0;24;1
2019-01-08 10:30:00;NORTE;37;0;37;1
2019-01-08 11:00:00;NORTE;37;0;37;1
2019-01-08 11:30:00;NORTE;28;0;28;1
2019-01-08 12:00:00;NORTE;27;0;27;1
2019-01-08 12:30:00;NORTE;28;0;28;1
2019-01-08 13:00:00;NORTE;27;0;27;1
2019-01-08 13:30:00;NORTE;26;0;26;1
2019-01-08 14:00:00;NORTE;29;0;29;1
2019-01-08 14:30:00;NORTE;33;0;33;1
2019-01-08 15:00:00;NORTE;41;0;41;1
2019-01-08 15:30:00;NORTE;29;0;29;1
2019-01-08 16:00:00;NORTE;27;0;27;1
2019-01-08 16:30:00;NORTE;16;0;16;1
2019-01-08 17:00:00;NORTE;22;0;22;1
2019-01-08 17:30:00;NORTE;33;0;33;1
2019-01-08 18:00:00;NORTE;21;0;21;1
2019-01-08 18:30:00;NORTE;24;0;24;1
2019-01-08 19:00:00;NORTE;42;0;42;1
2019-01-08 19:30:00;NORTE;24;0;24;1
2019-01-08 20:00:00;NORTE;24;0;24;1
2019-01-08 20:30:00;NORTE;24;0;24;1
2019-01-08 21:00:00;NORTE;27;0;27;1
2019-01-08 21:30:00;NORTE;21;0;21;1
2019-01-08 22:00:00;NORTE;11;0;11;1
2019-01-08 22:30:00;NORTE;8;0;8;1
2019-01-08 23:00:00;NORTE;11;0;11;1
2019-01-08 23:30:00;NORTE;3;0;3;1
2019-01-09 00:00:00;NORTE;1;0;1;1
2019-01-09 00:30:00;NORTE;1;0;1;1
2019-01-09 01:30:00;NORTE;1;0;1;1
2019-01-09 02:30:00;NORTE;1;0;1;1
2019-01-09 03:00:00;NORTE;2;0;2;1
2019-01-09 03:30:00;NORTE;3;0;3;1
2019-01-09 04:00:00;NORTE;4;0;4;1
2019-01-09 04:30:00;NORTE;7;0;7;1
2019-01-09 05:00:00;NORTE;9;0;9;1
2019-01-09 05:30:00;NORTE;12;0;12;1
2019-01-09 06:00:00;NORTE;19;0;19;1
2019-01-09 06:30:00;NORTE;38;0;38;1
2019-01-09 07:00:00;NORTE;25;0;25;1
2019-01-09 07:30:00;NORTE;28;0;28;1
2019-01-09 08:00:00;NORTE;31;0;31;1
2019-01-09 08:30:00;NORTE;29;0;29;1
2019-01-09 09:00:00;NORTE;32;0;32;1
2019-01-09 09:30:00;NORTE;40;0;40;1
2019-01-09 10:00:00;NORTE;23;0;23;1
2019-01-09 10:30:00;NORTE;43;0;43;1
2019-01-09 11:00:00;NORTE;33;0;33;1
2019-01-09 11:30:00;NORTE;33;0;33;1
2019-01-09 12:00:00;NORTE;24;0;24;1
2019-01-09 12:30:00;NORTE;27;0;27;1
2019-01-09 13:00:00;NORTE;31;0;31;1
2019-01-09 13:30:00;NORTE;29;0;29;1
2019-01-09 14:00:00;NORTE;38;0;38;1
2019-01-09 14:30:00;NORTE;23;0;23;1
2019-01-09 15:00:00;NORTE;35;0;35;1
2019-01-09 15:30:00;NORTE;28;0;28;1
2019-01-09 16:00:00;NORTE;27;0;27;1
2019-01-09 16:30:00;NORTE;15;0;15;1
2019-01-09 17:00:00;NORTE;17;0;17;1
2019-01-09 17:30:00;NORTE;37;0;37;1
2019-01-09 18:00:00;NORTE;23;0;23;1
2019-01-09 18:30:00;NORTE;32;0;32;1
2019-01-09 19:00:00;NORTE;38;0;38;1
2019-01-09 19:30:00;NORTE;27;0;27;1
2019-01-09 20:00:00;NORTE;26;0;26;1
2019-01-09 20:30:00;NORTE;23;0;23;1
2019-01-09 21:00:00;NORTE;35;0;35;1
2019-01-09 21:30:00;NORTE;27;0;27;1
2019-01-09 22:00:00;NORTE;7;0;7;1
2019-01-09 22:30:00;NORTE;7;0;7;1
2019-01-09 23:00:00;NORTE;13;0;13;1
2019-01-09 23:30:00;NORTE;4;0;4;1
2019-01-10 00:00:00;NORTE;2;0;2;1
2019-01-10 00:30:00;NORTE;2;0;2;1
2019-01-10 01:00:00;NORTE;2;0;2;1
2019-01-10 01:30:00;NORTE;1;0;1;1
2019-01-10 02:00:00;NORTE;1;0;1;1
2019-01-10 02:30:00;NORTE;1;0;1;1
2019-01-10 03:00:00;NORTE;3;0;3;1
2019-01-10 03:30:00;NORTE;5;0;5;1
2019-01-10 04:00:00;NORTE;2;0;2;1
2019-01-10 04:30:00;NORTE;9;0;9;1
2019-01-10 05:00:00;NORTE;8;0;8;1
2019-01-10 05:30:00;NORTE;11;0;11;1
2019-01-10 06:00:00;NORTE;20;0;20;1
2019-01-10 06:30:00;NORTE;38;0;38;1
2019-01-10 07:00:00;NORTE;8;0;8;1
2019-01-10 07:30:00;NORTE;11;0;11;1
2019-01-10 08:00:00;NORTE;26;0;26;1
2019-01-10 08:30:00;NORTE;24;0;24;1
2019-01-10 09:00:00;NORTE;35;0;35;1
2019-01-10 09:30:00;NORTE;27;0;27;1
2019-01-10 10:00:00;NORTE;22;0;22;1
2019-01-10 10:30:00;NORTE;40;0;40;1
2019-01-10 11:00:00;NORTE;28;0;28;1
2019-01-10 11:30:00;NORTE;31;0;31;1
2019-01-10 12:00:00;NORTE;32;0;32;1
2019-01-10 12:30:00;NORTE;26;0;26;1
2019-01-10 13:00:00;NORTE;32;0;32;1
2019-01-10 13:30:00;NORTE;32;0;32;1
2019-01-10 14:00:00;NORTE;37;0;37;1
2019-01-10 14:30:00;NORTE;33;0;33;1
2019-01-10 15:00:00;NORTE;35;0;35;1
2019-01-10 15:30:00;NORTE;26;0;26;1
2019-01-10 16:00:00;NORTE;24;0;24;1
2019-01-10 16:30:00;NORTE;18;0;18;1
2019-01-10 17:00:00;NORTE;27;0;27;1
2019-01-10 17:30:00;NORTE;31;0;31;1
2019-01-10 18:00:00;NORTE;30;0;30;1
2019-01-10 18:30:00;NORTE;40;0;40;1
2019-01-10 19:00:00;NORTE;40;0;40;1
2019-01-10 19:30:00;NORTE;33;0;33;1
2019-01-10 20:00:00;NORTE;18;0;18;1
2019-01-10 20:30:00;NORTE;32;0;32;1
2019-01-10 21:00:00;NORTE;25;0;25;1
2019-01-10 21:30:00;NORTE;18;0;18;1
2019-01-10 22:00:00;NORTE;16;0;16;1
2019-01-10 22:30:00;NORTE;5;0;5;1
2019-01-11 01:00:00;NORTE;1;0;1;1
2019-01-11 01:30:00;NORTE;1;0;1;1
2019-01-11 02:00:00;NORTE;1;0;1;1
2019-01-11 02:30:00;NORTE;1;0;1;1
2019-01-11 03:00:00;NORTE;2;0;2;1
2019-01-11 03:30:00;NORTE;5;0;5;1
2019-01-11 04:00:00;NORTE;3;0;3;1
2019-01-11 04:30:00;NORTE;5;0;5;1
2019-01-11 05:00:00;NORTE;11;0;11;1
2019-01-11 05:30:00;NORTE;13;0;13;1
2019-01-11 06:00:00;NORTE;20;0;20;1
2019-01-11 06:30:00;NORTE;32;0;32;1
2019-01-11 07:00:00;NORTE;23;0;23;1
2019-01-11 07:30:00;NORTE;24;0;24;1
2019-01-11 08:00:00;NORTE;36;0;36;1
2019-01-11 08:30:00;NORTE;28;0;28;1
2019-01-11 09:00:00;NORTE;38;0;38;1
2019-01-11 09:30:00;NORTE;25;0;25;1
2019-01-11 10:00:00;NORTE;31;0;31;1
2019-01-11 10:30:00;NORTE;37;0;37;1
2019-01-11 11:00:00;NORTE;34;0;34;1
2019-01-11 11:30:00;NORTE;31;0;31;1
2019-01-11 12:00:00;NORTE;27;0;27;1
2019-01-11 12:30:00;NORTE;29;0;29;1
2019-01-11 13:00:00;CONFLICTIVA;4;20;24;2
2019-01-11 13:30:00;SUR;0;35;35;1
2019-01-11 14:00:00;SUR;0;37;37;1
2019-01-11 14:30:00;SUR;0;33;33;1
2019-01-11 15:00:00;SUR;0;37;37;1
2019-01-11 15:30:00;SUR;0;28;28;1
2019-01-11 16:00:00;CONFLICTIVA;5;14;19;2
2019-01-11 16:30:00;NORTE;22;0;22;1
2019-01-11 17:00:00;NORTE;27;0;27;1
2019-01-11 17:30:00;NORTE;28;0;28;1
2019-01-11 18:00:00;NORTE;26;0;26;1
2019-01-11 18:30:00;NORTE;34;0;34;1
2019-01-11 19:00:00;NORTE;34;0;34;1
2019-01-11 19:30:00;NORTE;41;0;41;1
2019-01-11 20:00:00;NORTE;20;0;20;1
2019-01-11 20:30:00;NORTE;31;0;31;1
2019-01-11 21:00:00;NORTE;26;0;26;1
2019-01-11 21:30:00;NORTE;19;0;19;1
2019-01-11 22:00:00;NORTE;8;0;8;1
2019-01-11 22:30:00;NORTE;9;0;9;1
2019-01-11 23:00:00;NORTE;13;0;13;1
2019-01-11 23:30:00;NORTE;3;0;3;1
2019-01-12 00:30:00;NORTE;1;0;1;1
2019-01-12 01:30:00;NORTE;2;0;2;1
2019-01-12 02:30:00;NORTE;3;0;3;1
2019-01-12 03:00:00;NORTE;1;0;1;1
2019-01-12 03:30:00;NORTE;2;0;2;1
2019-01-12 04:00:00;NORTE;2;0;2;1
2019-01-12 04:30:00;NORTE;6;0;6;1
2019-01-12 05:00:00;NORTE;11;0;11;1
2019-01-12 05:30:00;NORTE;9;0;9;1
2019-01-12 06:00:00;NORTE;20;0;20;1
2019-01-12 06:30:00;NORTE;18;0;18;1
2019-01-12 07:00:00;NORTE;24;0;24;1
2019-01-12 07:30:00;NORTE;26;0;26;1
2019-01-12 08:00:00;NORTE;27;0;27;1
2019-01-12 08:30:00;NORTE;29;0;29;1
2019-01-12 09:00:00;NORTE;34;0;34;1
2019-01-12 09:30:00;NORTE;26;0;26;1
2019-01-12 10:00:00;NORTE;21;0;21;1
2019-01-12 10:30:00;NORTE;37;0;37;1
2019-01-12 11:00:00;NORTE;23;0;23;1
2019-01-12 11:30:00;NORTE;34;0;34;1
2019-01-12 12:00:00;NORTE;26;0;26;1
2019-01-12 12:30:00;NORTE;30;0;30;1
2019-01-12 13:00:00;NORTE;27;0;27;1
2019-01-12 13:30:00;NORTE;27;0;27;1
2019-01-12 14:00:00;NORTE;31;0;31;1
2019-01-12 14:30:00;NORTE;27;0;27;1
2019-01-12 15:00:00;NORTE;33;0;33;1
2019-01-12 15:30:00;NORTE;21;0;21;1
2019-01-12 16:00:00;NORTE;20;0;20;1
2019-01-12 16:30:00;NORTE;18;0;18;1
2019-01-12 17:00:00;NORTE;22;0;22;1
2019-01-12 17:30:00;NORTE;28;0;28;1
2019-01-12 18:00:00;NORTE;12;0;12;1
2019-01-12 18:30:00;NORTE;24;0;24;1
2019-01-12 19:00:00;NORTE;28;0;28;1
2019-01-12 19:30:00;NORTE;18;0;18;1
2019-01-12 20:00:00;NORTE;18;0;18;1
2019-01-12 20:30:00;NORTE;19;0;19;1
2019-01-12 21:00:00;NORTE;17;0;17;1
2019-01-12 21:30:00;NORTE;12;0;12;1
2019-01-12 22:00:00;NORTE;9;0;9;1
2019-01-12 22:30:00;NORTE;6;0;6;1
2019-01-12 23:00:00;NORTE;15;0;15;1
2019-01-12 23:30:00;NORTE;5;0;5;1
2019-01-13 00:30:00;NORTE;1;0;1;1
2019-01-13 01:30:00;NORTE;2;0;2;1
2019-01-13 02:00:00;NORTE;2;0;2;1
2019-01-13 03:00:00;NORTE;3;0;3;1
2019-01-13 03:30:00;NORTE;4;0;4;1
2019-01-13 04:00:00;NORTE;1;0;1;1
2019-01-13 04:30:00;NORTE;3;0;3;1
2019-01-13 05:00:00;NORTE;6;0;6;1
2019-01-13 05:30:00;NORTE;7;0;7;1
2019-01-13 06:00:00;NORTE;21;0;21;1
2019-01-13 06:30:00;NORTE;25;0;25;1
2019-01-13 07:00:00;NORTE;14;0;14;1
2019-01-13 07:30:00;NORTE;22;0;22;1
2019-01-13 08:00:00;NORTE;21;0;21;1
2019-01-13 08:30:00;NORTE;32;0;32;1
2019-01-13 09:00:00;NORTE;33;0;33;1
2019-01-13 09:30:00;NORTE;27;0;27;1
2019-01-13 10:00:00;NORTE;20;0;20;1
2019-01-13 10:30:00;NORTE;40;1;41;1
2019-01-13 11:00:00;NORTE;34;0;34;1
2019-01-13 11:30:00;NORTE;26;0;26;1
2019-01-13 12:00:00;NORTE;25;0;25;1
2019-01-13 12:30:00;NORTE;28;0;28;1
2019-01-13 13:00:00;NORTE;31;0;31;1
2019-01-13 13:30:00;NORTE;30;0;30;1
2019-01-13 14:00:00;NORTE;30;0;30;1
2019-01-13 14:30:00;NORTE;34;0;34;1
2019-01-13 15:00:00;NORTE;38;0;38;1
2019-01-13 15:30:00;NORTE;23;0;23;1
2019-01-13 16:00:00;NORTE;22;0;22;1
2019-01-13 16:30:00;NORTE;19;0;19;1
2019-01-13 17:00:00;NORTE;23;0;23;1
2019-01-13 17:30:00;NORTE;36;0;36;1
2019-01-13 18:00:00;NORTE;31;0;31;1
2019-01-13 18:30:00;NORTE;33;0;33;1
2019-01-13 19:00:00;NORTE;36;0;36;1
2019-01-13 19:30:00;NORTE;35;0;35;1
2019-01-13 20:00:00;NORTE;26;0;26;1
2019-01-13 20:30:00;NORTE;32;0;32;1
2019-01-13 21:00:00;NORTE;21;0;21;1
2019-01-13 21:30:00;NORTE;22;0;22;1
2019-01-13 22:00:00;NORTE;14;0;14;1
2019-01-13 22:30:00;NORTE;10;0;10;1
2019-01-13 23:00:00;NORTE;10;0;10;1
2019-01-13 23:30:00;NORTE;6;0;6;1
2019-01-14 00:00:00;NORTE;3;0;3;1
2019-01-14 00:30:00;NORTE;1;0;1;1
2019-01-14 01:30:00;NORTE;2;0;2;1
2019-01-14 02:30:00;NORTE;2;0;2;1
2019-01-14 03:00:00;NORTE;4;0;4;1
2019-01-14 03:30:00;NORTE;2;0;2;1
2019-01-14 04:00:00;NORTE;1;0;1;1
2019-01-14 04:30:00;NORTE;5;0;5;1
2019-01-14 05:00:00;NORTE;12;0;12;1
2019-01-14 05:30:00;NORTE;11;0;11;1
2019-01-14 06:00:00;NORTE;18;0;18;1
2019-01-14 06:30:00;NORTE;37;0;37;1
2019-01-14 07:00:00;NORTE;25;0;25;1
2019-01-14 07:30:00;NORTE;24;0;24;1
2019-01-14 08:00:00;NORTE;35;0;35;1
2019-01-14 08:30:00;NORTE;32;0;32;1
2019-01-14 09:00:00;NORTE;37;0;37;1
2019-01-14 09:30:00;NORTE;38;0;38;1
2019-01-14 10:00:00;NORTE;21;0;21;1
2019-01-14 10:30:00;NORTE;41;0;41;1
2019-01-14 11:00:00;NORTE;33;0;33;1
2019-01-14 11:30:00;NORTE;25;0;25;1
2019-01-14 12:00:00;NORTE;27;0;27;1
2019-01-14 12:30:00;NORTE;24;0;24;1
2019-01-14 13:00:00;NORTE;33;0;33;1
2019-01-14 13:30:00;NORTE;32;0;32;1
2019-01-14 14:00:00;NORTE;35;0;35;1
2019-01-14 14:30:00;NORTE;22;0;22;1
2019-01-14 15:00:00;NORTE;35;0;35;1
2019-01-14 15:30:00;NORTE;32;0;32;1
2019-01-14 16:00:00;NORTE;20;0;20;1
2019-01-14 16:30:00;NORTE;21;0;21;1
2019-01-14 17:00:00;NORTE;19;0;19;1
2019-01-14 17:30:00;NORTE;31;0;31;1
2019-01-14 18:00:00;NORTE;30;0;30;1
2019-01-14 18:30:00;NORTE;32;0;32;1
2019-01-14 19:00:00;NORTE;37;0;37;1
2019-01-14 19:30:00;NORTE;34;0;34;1
2019-01-14 20:00:00;NORTE;18;0;18;1
2019-01-14 20:30:00;NORTE;33;0;33;1
2019-01-14 21:00:00;NORTE;29;0;29;1
2019-01-14 21:30:00;NORTE;16;0;16;1
2019-01-14 22:00:00;NORTE;14;0;14;1
2019-01-14 22:30:00;NORTE;8;0;8;1
2019-01-14 23:00:00;NORTE;13;0;13;1
2019-01-14 23:30:00;NORTE;2;0;2;1
2019-01-15 00:00:00;NORTE;1;0;1;1
2019-01-15 01:00:00;NORTE;1;0;1;1
2019-01-15 02:00:00;NORTE;1;0;1;1
2019-01-15 03:00:00;NORTE;5;0;5;1
2019-01-15 03:30:00;NORTE;3;0;3;1
2019-01-15 04:00:00;NORTE;4;0;4;1
2019-01-15 04:30:00;NORTE;5;0;5;1
2019-01-15 05:00:00;NORTE;9;0;9;1
2019-01-15 05:30:00;NORTE;15;0;15;1
2019-01-15 06:00:00;NORTE;20;0;20;1
2019-01-15 06:30:00;NORTE;45;0;45;1
2019-01-15 07:00:00;NORTE;18;0;18;1
2019-01-15 07:30:00;NORTE;26;0;26;1
2019-01-15 08:00:00;NORTE;26;0;26;1
2019-01-15 08:30:00;NORTE;30;0;30;1
2019-01-15 09:00:00;NORTE;34;0;34;1
2019-01-15 09:30:00;NORTE;30;0;30;1
2019-01-15 10:00:00;NORTE;18;0;18;1
2019-01-15 10:30:00;NORTE;39;0;39;1
2019-01-15 11:00:00;NORTE;29;0;29;1
2019-01-15 11:30:00;NORTE;28;0;28;1
2019-01-15 12:00:00;NORTE;26;0;26;1
2019-01-15 12:30:00;NORTE;27;0;27;1
2019-01-15 13:00:00;NORTE;27;0;27;1
2019-01-15 13:30:00;NORTE;26;0;26;1
2019-01-15 14:00:00;NORTE;28;0;28;1
2019-01-15 14:30:00;NORTE;28;0;28;1
2019-01-15 15:00:00;NORTE;30;0;30;1
2019-01-15 15:30:00;NORTE;32;0;32;1
2019-01-15 16:00:00;NORTE;22;0;22;1
2019-01-15 16:30:00;NORTE;16;0;16;1
2019-01-15 17:00:00;NORTE;27;0;27;1
2019-01-15 17:30:00;NORTE;33;0;33;1
2019-01-15 18:00:00;NORTE;21;1;22;1
2019-01-15 18:30:00;NORTE;30;0;30;1
2019-01-15 19:00:00;NORTE;37;0;37;1
2019-01-15 19:30:00;NORTE;23;0;23;1
2019-01-15 20:00:00;NORTE;22;0;22;1
2019-01-15 20:30:00;NORTE;24;0;24;1
2019-01-15 21:00:00;NORTE;33;0;33;1
2019-01-15 21:30:00;NORTE;18;0;18;1
2019-01-15 22:00:00;NORTE;18;0;18;1
2019-01-15 22:30:00;NORTE;8;0;8;1
2019-01-15 23:00:00;NORTE;8;0;8;1
2019-01-15 23:30:00;NORTE;2;0;2;1
2019-01-16 00:00:00;NORTE;1;0;1;1
2019-01-16 00:30:00;NORTE;1;0;1;1
2019-01-16 01:00:00;NORTE;3;0;3;1
2019-01-16 02:30:00;NORTE;1;0;1;1
2019-01-16 03:00:00;NORTE;5;0;5;1
2019-01-16 03:30:00;NORTE;3;0;3;1
2019-01-16 04:00:00;NORTE;4;0;4;1
2019-01-16 04:30:00;NORTE;7;0;7;1
2019-01-16 05:00:00;NORTE;9;0;9;1
2019-01-16 05:30:00;NORTE;8;0;8;1
2019-01-16 06:00:00;NORTE;12;0;12;1
2019-01-16 06:30:00;NORTE;23;0;23;1
2019-01-16 07:00:00;NORTE;13;0;13;1
2019-01-16 07:30:00;NORTE;10;0;10;1
2019-01-16 08:00:00;NORTE;6;0;6;1
2019-01-16 08:30:00;NORTE;3;0;3;1
2019-01-16 09:00:00;NORTE;2;0;2;1
2019-01-16 09:30:00;NORTE;5;0;5;1
2019-01-16 10:00:00;NORTE;6;0;6;1
2019-01-16 10:30:00;NORTE;14;0;14;1
2019-01-16 11:00:00;NORTE;5;0;5;1
2019-01-16 11:30:00;NORTE;8;0;8;1
2019-01-16 12:00:00;NORTE;5;0;5;1
2019-01-16 12:30:00;NORTE;24;0;24;1
2019-01-16 13:00:00;NORTE;25;0;25;1
2019-01-16 13:30:00;NORTE;29;0;29;1
2019-01-16 14:00:00;NORTE;36;0;36;1
2019-01-16 14:30:00;NORTE;27;0;27;1
2019-01-16 15:00:00;NORTE;38;0;38;1
2019-01-16 15:30:00;NORTE;26;0;26;1
2019-01-16 16:00:00;NORTE;23;0;23;1
2019-01-16 16:30:00;NORTE;11;0;11;1
2019-01-16 17:00:00;NORTE;23;0;23;1
2019-01-16 17:30:00;NORTE;28;0;28;1
2019-01-16 18:00:00;NORTE;25;0;25;1
2019-01-16 18:30:00;NORTE;32;0;32;1
2019-01-16 19:00:00;NORTE;42;0;42;1
2019-01-16 19:30:00;NORTE;32;0;32;1
2019-01-16 20:00:00;NORTE;20;0;20;1
2019-01-16 20:30:00;NORTE;39;0;39;1
2019-01-16 21:00:00;NORTE;26;0;26;1
2019-01-16 21:30:00;NORTE;20;0;20;1
2019-01-16 22:00:00;NORTE;15;0;15;1
2019-01-16 22:30:00;NORTE;7;0;7;1
2019-01-16 23:00:00;NORTE;12;0;12;1
2019-01-16 23:30:00;NORTE;6;0;6;1
2019-01-17 00:00:00;NORTE;1;0;1;1
2019-01-17 01:00:00;NORTE;1;0;1;1
2019-01-17 02:30:00;NORTE;1;0;1;1
2019-01-17 03:00:00;NORTE;4;0;4;1
2019-01-17 03:30:00;NORTE;2;0;2;1
2019-01-17 04:00:00;NORTE;2;0;2;1
2019-01-17 04:30:00;NORTE;7;0;7;1
2019-01-17 05:00:00;NORTE;10;0;10;1
2019-01-17 05:30:00;NORTE;14;0;14;1
2019-01-17 06:00:00;NORTE;24;0;24;1
2019-01-17 06:30:00;NORTE;40;0;40;1
2019-01-17 07:00:00;NORTE;18;0;18;1
2019-01-17 07:30:00;NORTE;26;0;26;1
2019-01-17 08:00:00;NORTE;29;0;29;1
2019-01-17 08:30:00;NORTE;32;0;32;1
2019-01-17 09:00:00;NORTE;36;0;36;1
2019-01-17 09:30:00;NORTE;33;0;33;1
2019-01-17 10:00:00;NORTE;25;0;25;1
2019-01-17 10:30:00;NORTE;34;0;34;1
2019-01-17 11:00:00;NORTE;37;0;37;1
2019-01-17 11:30:00;NORTE;29;0;29;1
2019-01-17 12:00:00;NORTE;31;0;31;1
2019-01-17 12:30:00;NORTE;22;0;22;1
2019-01-17 13:00:00;NORTE;25;0;25;1
2019-01-17 13:30:00;NORTE;33;0;33;1
2019-01-17 14:00:00;NORTE;39;0;39;1
2019-01-17 14:30:00;NORTE;21;0;21;1
2019-01-17 15:00:00;NORTE;43;0;43;1
2019-01-17 15:30:00;NORTE;23;0;23;1
2019-01-17 16:00:00;NORTE;17;0;17;1
2019-01-17 16:30:00;NORTE;17;0;17;1
2019-01-17 17:00:00;NORTE;29;0;29;1
2019-01-17 17:30:00;NORTE;36;0;36;1
2019-01-17 18:00:00;NORTE;35;0;35;1
2019-01-17 18:30:00;NORTE;31;0;31;1
2019-01-17 19:00:00;NORTE;46;0;46;1
2019-01-17 19:30:00;NORTE;32;0;32;1
2019-01-17 20:00:00;NORTE;20;0;20;1
2019-01-17 20:30:00;NORTE;34;0;34;1
2019-01-17 21:00:00;NORTE;25;0;25;1
2019-01-17 21:30:00;NORTE;23;0;23;1
2019-01-17 22:00:00;NORTE;13;0;13;1
2019-01-17 22:30:00;NORTE;7;0;7;1
2019-01-17 23:00:00;NORTE;13;0;13;1
2019-01-17 23:30:00;NORTE;3;0;3;1
2019-01-18 00:30:00;NORTE;1;0;1;1
2019-01-18 01:00:00;NORTE;1;0;1;1
2019-01-18 01:30:00;NORTE;2;0;2;1
2019-01-18 02:00:00;NORTE;2;0;2;1
2019-01-18 02:30:00;NORTE;1;0;1;1
2019-01-18 03:00:00;NORTE;5;0;5;1
2019-01-18 03:30:00;NORTE;1;0;1;1
2019-01-18 04:00:00;NORTE;4;0;4;1
2019-01-18 04:30:00;NORTE;9;0;9;1
2019-01-18 05:00:00;NORTE;12;0;12;1
2019-01-18 05:30:00;NORTE;9;0;9;1
2019-01-18 06:00:00;NORTE;19;0;19;1
2019-01-18 06:30:00;NORTE;31;0;31;1
2019-01-18 07:00:00;NORTE;27;0;27;1
2019-01-18 07:30:00;NORTE;24;0;24;1
2019-01-18 08:00:00;NORTE;32;0;32;1
2019-01-18 08:30:00;NORTE;26;0;26;1
2019-01-18 09:00:00;NORTE;35;0;35;1
2019-01-18 09:30:00;NORTE;30;0;30;1
2019-01-18 10:00:00;NORTE;34;0;34;1
2019-01-18 10:30:00;NORTE;39;0;39;1
2019-01-18 11:00:00;NORTE;40;0;40;1
2019-01-18 11:30:00;NORTE;31;0;31;1
2019-01-18 12:00:00;NORTE;21;0;21;1
2019-01-18 12:30:00;NORTE;32;0;32;1
2019-01-18 13:00:00;NORTE;29;0;29;1
2019-01-18 13:30:00;NORTE;32;0;32;1
2019-01-18 14:00:00;NORTE;45;0;45;1
2019-01-18 14:30:00;NORTE;20;0;20;1
2019-01-18 15:00:00;NORTE;35;0;35;1
2019-01-18 15:30:00;NORTE;32;0;32;1
2019-01-18 16:00:00;NORTE;23;0;23;1
2019-01-18 16:30:00;NORTE;23;1;24;1
2019-01-18 17:00:00;NORTE;28;0;28;1
2019-01-18 17:30:00;NORTE;34;0;34;1
2019-01-18 18:00:00;NORTE;29;0;29;1
2019-01-18 18:30:00;NORTE;32;0;32;1
2019-01-18 19:00:00;NORTE;41;0;41;1
2019-01-18 19:30:00;NORTE;33;0;33;1
2019-01-18 20:00:00;NORTE;27;0;27;1
2019-01-18 20:30:00;NORTE;30;0;30;1
2019-01-18 21:00:00;NORTE;26;0;26;1
2019-01-18 21:30:00;NORTE;23;0;23;1
2019-01-18 22:00:00;NORTE;13;0;13;1
2019-01-18 22:30:00;NORTE;6;0;6;1
2019-01-18 23:00:00;NORTE;14;0;14;1
2019-01-18 23:30:00;NORTE;3;0;3;1
2019-01-19 00:30:00;NORTE;1;0;1;1
2019-01-19 01:00:00;NORTE;1;0;1;1
2019-01-19 01:30:00;NORTE;1;0;1;1
2019-01-19 02:30:00;NORTE;2;0;2;1
2019-01-19 03:00:00;NORTE;1;0;1;1
2019-01-19 03:30:00;NORTE;5;0;5;1
2019-01-19 04:00:00;NORTE;2;0;2;1
2019-01-19 04:30:00;NORTE;5;0;5;1
2019-01-19 05:00:00;NORTE;9;0;9;1
2019-01-19 05:30:00;NORTE;7;0;7;1
2019-01-19 06:00:00;NORTE;22;0;22;1
2019-01-19 06:30:00;NORTE;29;0;29;1
2019-01-19 07:00:00;NORTE;20;0;20;1
2019-01-19 07:30:00;NORTE;19;0;19;1
2019-01-19 08:00:00;NORTE;38;0;38;1
2019-01-19 08:30:00;NORTE;25;0;25;1
2019-01-19 09:00:00;NORTE;37;0;37;1
2019-01-19 09:30:00;NORTE;23;0;23;1
2019-01-19 10:00:00;NORTE;21;0;21;1
2019-01-19 10:30:00;NORTE;39;0;39;1
2019-01-19 11:00:00;NORTE;13;0;13;1
2019-01-19 11:11:00;NORTE;20;0;20;1
2019-01-19 11:30:00;NORTE;23;0;23;1
2019-01-19 12:00:00;NORTE;25;0;25;1
2019-01-19 12:30:00;NORTE;30;0;30;1
2019-01-19 13:00:00;NORTE;25;0;25;1
2019-01-19 13:30:00;NORTE;27;0;27;1
2019-01-19 14:00:00;NORTE;33;0;33;1
2019-01-19 14:30:00;NORTE;24;0;24;1
2019-01-19 15:00:00;NORTE;29;0;29;1
2019-01-19 15:30:00;NORTE;21;0;21;1
2019-01-19 16:00:00;NORTE;21;0;21;1
2019-01-19 16:30:00;NORTE;16;0;16;1
2019-01-19 17:00:00;NORTE;21;0;21;1
2019-01-19 17:30:00;NORTE;36;0;36;1
2019-01-19 18:00:00;NORTE;9;0;9;1
2019-01-19 18:30:00;NORTE;12;0;12;1
2019-01-19 18:50:00;NORTE;11;0;11;1
2019-01-19 19:00:00;NORTE;29;0;29;1
2019-01-19 19:30:00;NORTE;17;0;17;1
2019-01-19 20:00:00;NORTE;20;0;20;1
2019-01-19 20:30:00;NORTE;19;0;19;1
2019-01-19 21:00:00;NORTE;19;0;19;1
2019-01-19 21:30:00;NORTE;11;0;11;1
2019-01-19 22:00:00;NORTE;9;0;9;1
2019-01-19 22:30:00;NORTE;5;0;5;1
2019-01-19 23:00:00;NORTE;12;0;12;1
2019-01-19 23:30:00;NORTE;4;0;4;1
2019-01-20 00:30:00;NORTE;1;0;1;1
2019-01-20 01:00:00;NORTE;2;0;2;1
2019-01-20 02:00:00;NORTE;1;0;1;1
2019-01-20 02:30:00;NORTE;1;0;1;1
2019-01-20 03:00:00;NORTE;1;0;1;1
2019-01-20 03:30:00;NORTE;4;0;4;1
2019-01-20 04:00:00;NORTE;3;0;3;1
2019-01-20 04:30:00;NORTE;3;0;3;1
2019-01-20 05:00:00;NORTE;10;0;10;1
2019-01-20 05:30:00;NORTE;8;0;8;1
2019-01-20 06:00:00;NORTE;24;0;24;1
2019-01-20 06:30:00;NORTE;24;0;24;1
2019-01-20 07:00:00;NORTE;10;0;10;1
2019-01-20 07:30:00;NORTE;18;0;18;1
2019-01-20 08:00:00;NORTE;26;0;26;1
2019-01-20 08:30:00;NORTE;27;0;27;1
2019-01-20 09:00:00;NORTE;33;0;33;1
2019-01-20 09:30:00;NORTE;28;0;28;1
2019-01-20 10:00:00;NORTE;24;0;24;1
2019-01-20 10:30:00;NORTE;37;0;37;1
2019-01-20 11:00:00;NORTE;38;0;38;1
2019-01-20 11:30:00;NORTE;33;0;33;1
2019-01-20 12:00:00;NORTE;26;0;26;1
2019-01-20 12:30:00;NORTE;29;0;29;1
2019-01-20 13:00:00;NORTE;29;0;29;1
2019-01-20 13:30:00;NORTE;33;0;33;1
2019-01-20 14:00:00;NORTE;31;0;31;1
2019-01-20 14:30:00;NORTE;34;0;34;1
2019-01-20 15:00:00;NORTE;33;0;33;1
2019-01-20 15:30:00;NORTE;23;0;23;1
2019-01-20 16:00:00;NORTE;22;0;22;1
2019-01-20 16:30:00;NORTE;22;0;22;1
2019-01-20 17:00:00;NORTE;26;0;26;1
2019-01-20 17:30:00;NORTE;34;0;34;1
2019-01-20 18:00:00;NORTE;37;0;37;1
2019-01-20 18:30:00;NORTE;36;0;36;1
2019-01-20 19:00:00;NORTE;37;0;37;1
2019-01-20 19:30:00;NORTE;34;0;34;1
2019-01-20 20:00:00;NORTE;30;0;30;1
2019-01-20 20:30:00;NORTE;29;0;29;1
2019-01-20 21:00:00;NORTE;23;0;23;1
2019-01-20 21:30:00;NORTE;23;0;23;1
2019-01-20 22:00:00;NORTE;15;0;15;1
2019-01-20 22:30:00;NORTE;9;0;9;1
2019-01-20 23:00:00;NORTE;12;0;12;1
2019-01-20 23:30:00;NORTE;3;0;3;1
2019-01-21 00:00:00;NORTE;1;0;1;1
2019-01-21 00:30:00;NORTE;2;0;2;1
2019-01-21 01:00:00;NORTE;3;0;3;1
2019-01-21 01:30:00;NORTE;1;0;1;1
2019-01-21 02:30:00;NORTE;2;0;2;1
2019-01-21 03:00:00;NORTE;4;0;4;1
2019-01-21 03:30:00;NORTE;2;0;2;1
2019-01-21 04:00:00;NORTE;2;0;2;1
2019-01-21 04:30:00;NORTE;5;0;5;1
2019-01-21 05:00:00;NORTE;8;0;8;1
2019-01-21 05:30:00;NORTE;13;0;13;1
2019-01-21 06:00:00;NORTE;22;0;22;1
2019-01-21 06:30:00;NORTE;38;0;38;1
2019-01-21 07:00:00;NORTE;26;0;26;1
2019-01-21 07:30:00;NORTE;30;0;30;1
2019-01-21 08:00:00;NORTE;27;0;27;1
2019-01-21 08:30:00;NORTE;30;0;30;1
2019-01-21 09:00:00;NORTE;36;0;36;1
2019-01-21 09:30:00;NORTE;34;0;34;1
2019-01-21 10:00:00;NORTE;21;0;21;1
2019-01-21 10:30:00;NORTE;44;0;44;1
2019-01-21 11:00:00;NORTE;33;0;33;1
2019-01-21 11:30:00;NORTE;27;0;27;1
2019-01-21 12:00:00;NORTE;33;0;33;1
2019-01-21 12:30:00;NORTE;27;0;27;1
2019-01-21 13:00:00;NORTE;29;0;29;1
2019-01-21 13:30:00;NORTE;32;0;32;1
2019-01-21 14:00:00;NORTE;38;0;38;1
2019-01-21 14:30:00;NORTE;23;0;23;1
2019-01-21 15:00:00;NORTE;34;0;34;1
2019-01-21 15:30:00;NORTE;30;0;30;1
2019-01-21 16:00:00;NORTE;18;0;18;1
2019-01-21 16:30:00;NORTE;22;0;22;1
2019-01-21 17:00:00;NORTE;19;0;19;1
2019-01-21 17:30:00;NORTE;33;0;33;1
2019-01-21 18:00:00;NORTE;31;0;31;1
2019-01-21 18:30:00;NORTE;33;0;33;1
2019-01-21 19:00:00;NORTE;41;0;41;1
2019-01-21 19:30:00;NORTE;34;0;34;1
2019-01-21 20:00:00;NORTE;20;0;20;1
2019-01-21 20:30:00;NORTE;29;0;29;1
2019-01-21 21:00:00;NORTE;29;0;29;1
2019-01-21 21:30:00;NORTE;17;0;17;1
2019-01-21 22:00:00;NORTE;19;0;19;1
2019-01-21 22:30:00;NORTE;8;0;8;1
2019-01-21 23:00:00;NORTE;9;0;9;1
2019-01-21 23:30:00;NORTE;1;0;1;1
2019-01-22 00:00:00;NORTE;1;0;1;1
2019-01-22 01:00:00;NORTE;3;0;3;1
2019-01-22 02:30:00;NORTE;1;0;1;1
2019-01-22 03:00:00;NORTE;7;0;7;1
2019-01-22 04:00:00;NORTE;3;0;3;1
2019-01-22 04:30:00;NORTE;7;0;7;1
2019-01-22 05:00:00;NORTE;9;0;9;1
2019-01-22 05:30:00;NORTE;14;0;14;1
2019-01-22 06:00:00;NORTE;21;0;21;1
2019-01-22 06:30:00;NORTE;35;0;35;1
2019-01-22 07:00:00;NORTE;29;0;29;1
2019-01-22 07:30:00;NORTE;22;0;22;1
2019-01-22 08:00:00;NORTE;30;0;30;1
2019-01-22 08:30:00;NORTE;31;0;31;1
2019-01-22 09:00:00;NORTE;36;0;36;1
2019-01-22 09:30:00;NORTE;29;0;29;1
2019-01-22 10:00:00;NORTE;24;0;24;1
2019-01-22 10:30:00;NORTE;33;0;33;1
2019-01-22 11:00:00;NORTE;30;0;30;1
2019-01-22 11:30:00;NORTE;26;0;26;1
2019-01-22 12:00:00;NORTE;31;0;31;1
2019-01-22 12:30:00;NORTE;27;0;27;1
2019-01-22 13:00:00;NORTE;30;0;30;1
2019-01-22 13:30:00;NORTE;32;0;32;1
2019-01-22 14:00:00;NORTE;29;0;29;1
2019-01-22 14:30:00;NORTE;29;0;29;1
2019-01-22 15:00:00;NORTE;30;0;30;1
2019-01-22 15:30:00;NORTE;27;0;27;1
2019-01-22 16:00:00;NORTE;24;0;24;1
2019-01-22 16:30:00;NORTE;18;0;18;1
2019-01-22 17:00:00;NORTE;22;0;22;1
2019-01-22 17:30:00;NORTE;31;0;31;1
2019-01-22 18:00:00;NORTE;28;0;28;1
2019-01-22 18:30:00;NORTE;31;0;31;1
2019-01-22 19:00:00;NORTE;31;0;31;1
2019-01-22 19:30:00;NORTE;29;0;29;1
2019-01-22 20:00:00;NORTE;18;0;18;1
2019-01-22 20:30:00;NORTE;23;0;23;1
2019-01-22 21:00:00;NORTE;29;0;29;1
2019-01-22 21:30:00;NORTE;21;0;21;1
2019-01-22 22:00:00;NORTE;17;0;17;1
2019-01-22 22:30:00;NORTE;7;0;7;1
2019-01-22 23:00:00;NORTE;13;0;13;1
2019-01-22 23:30:00;NORTE;3;0;3;1
2019-01-23 01:00:00;NORTE;1;0;1;1
2019-01-23 01:30:00;NORTE;1;0;1;1
2019-01-23 03:00:00;NORTE;4;0;4;1
2019-01-23 03:30:00;NORTE;2;0;2;1
2019-01-23 04:00:00;NORTE;5;0;5;1
2019-01-23 04:30:00;NORTE;6;0;6;1
2019-01-23 05:00:00;NORTE;11;0;11;1
2019-01-23 05:30:00;NORTE;14;0;14;1
2019-01-23 06:00:00;NORTE;22;0;22;1
2019-01-23 06:30:00;NORTE;36;0;36;1
2019-01-23 07:00:00;NORTE;24;0;24;1
2019-01-23 07:30:00;NORTE;25;0;25;1
2019-01-23 08:00:00;NORTE;28;0;28;1
2019-01-23 08:30:00;NORTE;27;0;27;1
2019-01-23 09:00:00;NORTE;34;0;34;1
2019-01-23 09:30:00;NORTE;32;0;32;1
2019-01-23 10:00:00;NORTE;24;0;24;1
2019-01-23 10:30:00;NORTE;38;0;38;1
2019-01-23 11:00:00;NORTE;36;0;36;1
2019-01-23 11:30:00;NORTE;28;0;28;1
2019-01-23 12:00:00;NORTE;28;0;28;1
2019-01-23 12:30:00;NORTE;29;0;29;1
2019-01-23 13:00:00;NORTE;29;0;29;1
2019-01-23 13:30:00;NORTE;28;0;28;1
2019-01-23 14:00:00;NORTE;37;0;37;1
2019-01-23 14:30:00;NORTE;24;0;24;1
2019-01-23 15:00:00;NORTE;34;0;34;1
2019-01-23 15:30:00;NORTE;23;0;23;1
2019-01-23 16:00:00;NORTE;22;0;22;1
2019-01-23 16:30:00;NORTE;17;0;17;1
2019-01-23 17:00:00;NORTE;29;0;29;1
2019-01-23 17:30:00;NORTE;29;0;29;1
2019-01-23 18:00:00;NORTE;29;0;29;1
2019-01-23 18:30:00;NORTE;29;0;29;1
2019-01-23 19:00:00;NORTE;40;0;40;1
2019-01-23 19:30:00;NORTE;24;0;24;1
2019-01-23 20:00:00;NORTE;25;0;25;1
2019-01-23 20:30:00;NORTE;20;0;20;1
2019-01-23 21:00:00;NORTE;34;0;34;1
2019-01-23 21:30:00;NORTE;11;0;11;1
2019-01-23 22:00:00;NORTE;17;0;17;1
2019-01-23 22:30:00;NORTE;8;0;8;1
2019-01-23 23:00:00;NORTE;12;0;12;1
2019-01-23 23:30:00;NORTE;1;0;1;1
2019-01-24 01:00:00;NORTE;2;0;2;1
2019-01-24 01:30:00;NORTE;1;0;1;1
2019-01-24 02:30:00;NORTE;1;0;1;1
2019-01-24 03:00:00;NORTE;6;0;6;1
2019-01-24 03:30:00;NORTE;2;0;2;1
2019-01-24 04:00:00;NORTE;3;0;3;1
2019-01-24 04:30:00;NORTE;6;0;6;1
2019-01-24 05:00:00;NORTE;11;0;11;1
2019-01-24 05:30:00;NORTE;12;0;12;1
2019-01-24 06:00:00;NORTE;21;1;22;1
2019-01-24 06:30:00;NORTE;38;0;38;1
2019-01-24 07:00:00;NORTE;23;0;23;1
2019-01-24 07:30:00;NORTE;29;0;29;1
2019-01-24 08:00:00;NORTE;28;0;28;1
2019-01-24 08:30:00;NORTE;31;0;31;1
2019-01-24 09:00:00;NORTE;30;0;30;1
2019-01-24 09:30:00;NORTE;28;0;28;1
2019-01-24 10:00:00;NORTE;27;0;27;1
2019-01-24 10:30:00;NORTE;32;0;32;1
2019-01-24 11:00:00;NORTE;36;0;36;1
2019-01-24 11:30:00;NORTE;30;0;30;1
2019-01-24 12:00:00;NORTE;35;0;35;1
2019-01-24 12:30:00;NORTE;26;0;26;1
2019-01-24 13:00:00;NORTE;32;0;32;1
2019-01-24 13:30:00;NORTE;27;0;27;1
2019-01-24 14:00:00;NORTE;37;0;37;1
2019-01-24 14:30:00;NORTE;35;0;35;1
2019-01-24 15:00:00;NORTE;30;0;30;1
2019-01-24 15:30:00;NORTE;25;0;25;1
2019-01-24 16:00:00;NORTE;23;0;23;1
2019-01-24 16:30:00;NORTE;18;0;18;1
2019-01-24 17:00:00;NORTE;27;0;27;1
2019-01-24 17:30:00;NORTE;29;0;29;1
2019-01-24 18:00:00;NORTE;32;0;32;1
2019-01-24 18:30:00;NORTE;42;0;42;1
2019-01-24 19:00:00;NORTE;38;0;38;1
2019-01-24 19:30:00;NORTE;35;0;35;1
2019-01-24 20:00:00;NORTE;17;0;17;1
2019-01-24 20:30:00;NORTE;32;1;33;1
2019-01-24 21:00:00;NORTE;32;0;32;1
2019-01-24 21:30:00;NORTE;20;0;20;1
2019-01-24 22:00:00;NORTE;10;0;10;1
2019-01-24 22:30:00;NORTE;9;0;9;1
2019-01-24 23:00:00;NORTE;12;0;12;1
2019-01-24 23:30:00;NORTE;5;0;5;1
2019-01-25 00:30:00;NORTE;2;0;2;1
2019-01-25 01:00:00;NORTE;1;0;1;1
2019-01-25 01:30:00;NORTE;2;0;2;1
2019-01-25 02:00:00;NORTE;1;0;1;1
2019-01-25 02:30:00;NORTE;1;0;1;1
2019-01-25 03:00:00;NORTE;4;0;4;1
2019-01-25 03:30:00;NORTE;6;0;6;1
2019-01-25 04:00:00;NORTE;1;0;1;1
2019-01-25 04:30:00;NORTE;7;0;7;1
2019-01-25 05:00:00;NORTE;11;0;11;1
2019-01-25 05:30:00;NORTE;13;0;13;1
2019-01-25 06:00:00;NORTE;20;0;20;1
2019-01-25 06:30:00;NORTE;31;0;31;1
2019-01-25 07:00:00;NORTE;23;0;23;1
2019-01-25 07:30:00;NORTE;25;0;25;1
2019-01-25 08:00:00;NORTE;39;0;39;1
2019-01-25 08:30:00;NORTE;29;0;29;1
2019-01-25 09:00:00;NORTE;30;0;30;1
2019-01-25 09:30:00;NORTE;30;0;30;1
2019-01-25 10:00:00;NORTE;33;0;33;1
2019-01-25 10:30:00;NORTE;40;0;40;1
2019-01-25 11:00:00;NORTE;27;0;27;1
2019-01-25 11:30:00;NORTE;33;1;34;1
2019-01-25 12:00:00;NORTE;26;0;26;1
2019-01-25 12:30:00;NORTE;34;0;34;1
2019-01-25 13:00:00;NORTE;22;1;23;1
2019-01-25 13:30:00;NORTE;32;0;32;1
2019-01-25 14:00:00;NORTE;38;0;38;1
2019-01-25 14:30:00;NORTE;28;0;28;1
2019-01-25 15:00:00;NORTE;40;0;40;1
2019-01-25 15:30:00;NORTE;32;0;32;1
2019-01-25 16:00:00;NORTE;21;0;21;1
2019-01-25 16:30:00;NORTE;25;0;25;1
2019-01-25 17:00:00;NORTE;24;0;24;1
2019-01-25 17:30:00;NORTE;35;0;35;1
2019-01-25 18:00:00;NORTE;29;0;29;1
2019-01-25 18:30:00;NORTE;33;0;33;1
2019-01-25 19:00:00;NORTE;46;0;46;1
2019-01-25 19:30:00;NORTE;28;0;28;1
2019-01-25 20:00:00;NORTE;32;0;32;1
2019-01-25 20:30:00;NORTE;27;0;27;1
2019-01-25 21:00:00;NORTE;25;0;25;1
2019-01-25 21:30:00;NORTE;19;0;19;1
2019-01-25 22:00:00;NORTE;14;0;14;1
2019-01-25 22:30:00;NORTE;9;0;9;1
2019-01-25 23:00:00;NORTE;16;0;16;1
2019-01-25 23:30:00;NORTE;1;0;1;1
2019-01-26 00:30:00;NORTE;1;0;1;1
2019-01-26 01:00:00;NORTE;1;0;1;1
2019-01-26 02:30:00;NORTE;2;0;2;1
2019-01-26 03:00:00;NORTE;4;0;4;1
2019-01-26 03:30:00;NORTE;2;0;2;1
2019-01-26 04:00:00;NORTE;2;0;2;1
2019-01-26 04:30:00;NORTE;7;0;7;1
2019-01-26 05:00:00;NORTE;8;0;8;1
2019-01-26 05:30:00;NORTE;8;0;8;1
2019-01-26 06:00:00;NORTE;24;0;24;1
2019-01-26 06:30:00;NORTE;26;0;26;1
2019-01-26 07:00:00;NORTE;21;0;21;1
2019-01-26 07:30:00;NORTE;23;0;23;1
2019-01-26 08:00:00;NORTE;25;0;25;1
2019-01-26 08:30:00;NORTE;29;0;29;1
2019-01-26 09:00:00;NORTE;37;0;37;1
2019-01-26 09:30:00;NORTE;17;0;17;1
2019-01-26 10:00:00;NORTE;20;0;20;1
2019-01-26 10:30:00;NORTE;43;0;43;1
2019-01-26 11:00:00;NORTE;29;0;29;1
2019-01-26 11:30:00;NORTE;23;0;23;1
2019-01-26 12:00:00;NORTE;27;0;27;1
2019-01-26 12:30:00;NORTE;26;0;26;1
2019-01-26 13:00:00;NORTE;25;0;25;1
2019-01-26 13:30:00;NORTE;28;0;28;1
2019-01-26 14:00:00;NORTE;33;0;33;1
2019-01-26 14:30:00;NORTE;27;0;27;1
2019-01-26 15:00:00;NORTE;27;0;27;1
2019-01-26 15:30:00;NORTE;24;0;24;1
2019-01-26 16:00:00;NORTE;19;0;19;1
2019-01-26 16:30:00;NORTE;17;0;17;1
2019-01-26 17:00:00;NORTE;22;1;23;1
2019-01-26 17:30:00;NORTE;26;0;26;1
2019-01-26 18:00:00;NORTE;11;0;11;1
2019-01-26 18:30:00;NORTE;22;0;22;1
2019-01-26 19:00:00;NORTE;29;0;29;1
2019-01-26 19:30:00;NORTE;16;0;16;1
2019-01-26 20:00:00;NORTE;16;0;16;1
2019-01-26 20:30:00;NORTE;18;0;18;1
2019-01-26 21:00:00;NORTE;18;0;18;1
2019-01-26 21:30:00;NORTE;12;0;12;1
2019-01-26 22:00:00;NORTE;11;0;11;1
2019-01-26 22:30:00;NORTE;6;0;6;1
2019-01-26 23:00:00;NORTE;10;0;10;1
2019-01-26 23:30:00;NORTE;1;0;1;1
2019-01-27 00:00:00;NORTE;2;0;2;1
2019-01-27 01:30:00;NORTE;2;0;2;1
2019-01-27 02:00:00;NORTE;2;0;2;1
2019-01-27 03:00:00;NORTE;4;0;4;1
2019-01-27 03:30:00;NORTE;2;0;2;1
2019-01-27 04:00:00;NORTE;2;0;2;1
2019-01-27 04:30:00;NORTE;5;0;5;1
2019-01-27 05:00:00;NORTE;7;0;7;1
2019-01-27 05:30:00;NORTE;8;0;8;1
2019-01-27 06:00:00;NORTE;18;0;18;1
2019-01-27 06:30:00;NORTE;25;0;25;1
2019-01-27 07:00:00;NORTE;14;0;14;1
2019-01-27 07:30:00;NORTE;17;0;17;1
2019-01-27 08:00:00;NORTE;21;0;21;1
2019-01-27 08:30:00;NORTE;28;0;28;1
2019-01-27 09:00:00;NORTE;33;0;33;1
2019-01-27 09:30:00;NORTE;29;0;29;1
2019-01-27 10:00:00;NORTE;24;0;24;1
2019-01-27 10:30:00;NORTE;31;0;31;1
2019-01-27 11:00:00;NORTE;38;0;38;1
2019-01-27 11:30:00;NORTE;27;0;27;1
2019-01-27 12:00:00;NORTE;26;0;26;1
2019-01-27 12:30:00;NORTE;30;0;30;1
2019-01-27 13:00:00;NORTE;25;0;25;1
2019-01-27 13:30:00;NORTE;33;0;33;1
2019-01-27 14:00:00;NORTE;33;0;33;1
2019-01-27 14:30:00;NORTE;34;0;34;1
2019-01-27 15:00:00;NORTE;37;0;37;1
2019-01-27 15:30:00;NORTE;28;0;28;1
2019-01-27 16:00:00;NORTE;19;1;20;1
2019-01-27 16:30:00;NORTE;17;0;17;1
2019-01-27 17:00:00;NORTE;28;0;28;1
2019-01-27 17:30:00;NORTE;29;0;29;1
2019-01-27 18:00:00;NORTE;29;0;29;1
2019-01-27 18:30:00;NORTE;28;0;28;1
2019-01-27 19:00:00;NORTE;42;0;42;1
2019-01-27 19:30:00;NORTE;37;0;37;1
2019-01-27 20:00:00;NORTE;29;0;29;1
2019-01-27 20:30:00;NORTE;37;0;37;1
2019-01-27 21:00:00;NORTE;20;0;20;1
2019-01-27 21:30:00;NORTE;24;0;24;1
2019-01-27 22:00:00;NORTE;15;0;15;1
2019-01-27 22:30:00;NORTE;12;0;12;1
2019-01-27 23:00:00;NORTE;12;0;12;1
2019-01-27 23:30:00;NORTE;2;0;2;1
2019-01-28 00:00:00;NORTE;2;0;2;1
2019-01-28 00:30:00;NORTE;1;0;1;1
2019-01-28 01:00:00;NORTE;2;0;2;1
2019-01-28 01:30:00;NORTE;1;0;1;1
2019-01-28 02:00:00;NORTE;1;0;1;1
2019-01-28 03:00:00;NORTE;5;0;5;1
2019-01-28 03:30:00;NORTE;3;0;3;1
2019-01-28 04:00:00;NORTE;3;0;3;1
2019-01-28 04:30:00;NORTE;4;0;4;1
2019-01-28 05:00:00;NORTE;7;0;7;1
2019-01-28 05:30:00;NORTE;11;0;11;1
2019-01-28 06:00:00;NORTE;23;0;23;1
2019-01-28 06:30:00;NORTE;38;0;38;1
2019-01-28 07:00:00;NORTE;25;0;25;1
2019-01-28 07:30:00;NORTE;27;0;27;1
2019-01-28 08:00:00;NORTE;30;0;30;1
2019-01-28 08:30:00;NORTE;26;0;26;1
2019-01-28 09:00:00;NORTE;34;0;34;1
2019-01-28 09:30:00;NORTE;6;0;6;1
2019-01-28 10:00:00;NORTE;24;0;24;1
2019-01-28 10:30:00;NORTE;37;0;37;1
2019-01-28 11:00:00;NORTE;20;0;20;1
2019-01-28 11:30:00;NORTE;28;0;28;1
2019-01-28 12:00:00;NORTE;25;0;25;1
2019-01-28 12:30:00;NORTE;24;0;24;1
2019-01-28 13:00:00;NORTE;24;0;24;1
2019-01-28 13:30:00;NORTE;33;0;33;1
2019-01-28 14:00:00;NORTE;40;0;40;1
2019-01-28 14:30:00;NORTE;27;0;27;1
2019-01-28 15:00:00;NORTE;33;0;33;1
2019-01-28 15:30:00;NORTE;21;0;21;1
2019-01-28 16:00:00;NORTE;24;0;24;1
2019-01-28 16:30:00;NORTE;19;0;19;1
2019-01-28 17:00:00;NORTE;23;0;23;1
2019-01-28 17:30:00;NORTE;38;0;38;1
2019-01-28 18:00:00;NORTE;24;0;24;1
2019-01-28 18:30:00;NORTE;33;0;33;1
2019-01-28 19:00:00;NORTE;33;0;33;1
2019-01-28 19:30:00;NORTE;27;0;27;1
2019-01-28 20:00:00;NORTE;24;0;24;1
2019-01-28 20:30:00;NORTE;26;0;26;1
2019-01-28 21:00:00;NORTE;34;0;34;1
2019-01-28 21:30:00;NORTE;17;0;17;1
2019-01-28 22:00:00;NORTE;11;0;11;1
2019-01-28 22:30:00;NORTE;9;0;9;1
2019-01-28 23:00:00;NORTE;9;0;9;1
2019-01-28 23:30:00;NORTE;3;0;3;1
2019-01-29 01:00:00;NORTE;1;0;1;1
2019-01-29 01:30:00;NORTE;2;0;2;1
2019-01-29 02:00:00;NORTE;1;0;1;1
2019-01-29 02:30:00;NORTE;2;0;2;1
2019-01-29 03:00:00;NORTE;5;0;5;1
2019-01-29 04:00:00;NORTE;5;0;5;1
2019-01-29 04:30:00;NORTE;7;0;7;1
2019-01-29 05:00:00;NORTE;9;0;9;1
2019-01-29 05:30:00;NORTE;16;0;16;1
2019-01-29 06:00:00;NORTE;23;0;23;1
2019-01-29 06:30:00;NORTE;36;0;36;1
2019-01-29 07:00:00;NORTE;19;0;19;1
2019-01-29 07:30:00;NORTE;20;0;20;1
2019-01-29 08:00:00;NORTE;30;0;30;1
2019-01-29 08:30:00;NORTE;25;0;25;1
2019-01-29 09:00:00;NORTE;29;0;29;1
2019-01-29 09:30:00;CONFLICTIVA;16;8;24;2
2019-01-29 10:00:00;SUR;0;27;27;1
2019-01-29 10:30:00;SUR;0;31;31;1
2019-01-29 11:00:00;SUR;0;36;36;1
2019-01-29 11:30:00;SUR;0;25;25;1
2019-01-29 12:00:00;SUR;0;30;30;1
2019-01-29 12:30:00;SUR;0;24;24;1
2019-01-29 13:00:00;SUR;0;23;23;1
2019-01-29 13:30:00;SUR;0;27;27;1
2019-01-29 14:00:00;SUR;0;29;29;1
2019-01-29 14:30:00;SUR;0;28;28;1
2019-01-29 15:00:00;SUR;0;35;35;1
2019-01-29 15:30:00;SUR;0;29;29;1
2019-01-29 16:00:00;SUR;0;23;23;1
2019-01-29 16:30:00;SUR;0;17;17;1
2019-01-29 17:00:00;CONFLICTIVA;7;9;16;2
2019-01-29 17:30:00;NORTE;33;0;33;1
2019-01-29 18:00:00;NORTE;25;0;25;1
2019-01-29 18:30:00;NORTE;27;0;27;1
2019-01-29 19:00:00;NORTE;37;0;37;1
2019-01-29 19:30:00;NORTE;21;0;21;1
2019-01-29 20:00:00;NORTE;21;0;21;1
2019-01-29 20:30:00;NORTE;27;0;27;1
2019-01-29 21:00:00;NORTE;25;0;25;1
2019-01-29 21:30:00;NORTE;20;0;20;1
2019-01-29 22:00:00;NORTE;11;0;11;1
2019-01-29 22:30:00;NORTE;7;0;7;1
2019-01-29 23:00:00;NORTE;10;0;10;1
2019-01-29 23:30:00;NORTE;2;0;2;1
2019-01-30 01:00:00;NORTE;1;0;1;1
2019-01-30 02:30:00;NORTE;1;0;1;1
2019-01-30 03:00:00;NORTE;2;0;2;1
2019-01-30 03:30:00;NORTE;4;0;4;1
2019-01-30 04:00:00;NORTE;2;0;2;1
2019-01-30 04:30:00;NORTE;6;0;6;1
2019-01-30 05:00:00;NORTE;10;0;10;1
2019-01-30 05:30:00;NORTE;12;0;12;1
2019-01-30 06:00:00;NORTE;23;0;23;1
2019-01-30 06:30:00;NORTE;33;0;33;1
2019-01-30 07:00:00;NORTE;17;0;17;1
2019-01-30 07:30:00;NORTE;24;0;24;1
2019-01-30 08:00:00;NORTE;33;0;33;1
2019-01-30 08:30:00;NORTE;27;0;27;1
2019-01-30 09:00:00;NORTE;35;0;35;1
2019-01-30 09:30:00;NORTE;32;0;32;1
2019-01-30 10:00:00;NORTE;25;0;25;1
2019-01-30 10:30:00;NORTE;31;0;31;1
2019-01-30 11:00:00;NORTE;34;0;34;1
2019-01-30 11:30:00;NORTE;26;0;26;1
2019-01-30 12:00:00;NORTE;24;0;24;1
2019-01-30 12:30:00;NORTE;27;0;27;1
2019-01-30 13:00:00;NORTE;23;0;23;1
2019-01-30 13:30:00;NORTE;30;0;30;1
2019-01-30 14:00:00;NORTE;33;0;33;1
2019-01-30 14:30:00;CONFLICTIVA;13;11;24;2
2019-01-30 15:00:00;SUR;0;36;36;1
2019-01-30 15:30:00;SUR;0;25;25;1
2019-01-30 16:00:00;SUR;0;27;27;1
2019-01-30 16:30:00;SUR;0;14;14;1
2019-01-30 17:00:00;SUR;0;25;25;1
2019-01-30 17:30:00;SUR;0;29;29;1
2019-01-30 18:00:00;SUR;0;18;18;1
2019-01-30 18:30:00;SUR;0;29;29;1
2019-01-30 19:00:00;SUR;0;36;36;1
2019-01-30 19:30:00;SUR;0;22;22;1
2019-01-30 20:00:00;SUR;0;23;23;1
2019-01-30 20:30:00;SUR;0;24;24;1
2019-01-30 21:00:00;SUR;0;25;25;1
2019-01-30 21:30:00;SUR;0;19;19;1
2019-01-30 22:00:00;SUR;0;15;15;1
2019-01-30 22:30:00;SUR;0;11;11;1
2019-01-30 23:00:00;SUR;0;11;11;1
2019-01-30 23:30:00;SUR;0;7;7;1
2019-01-31 00:00:00;SUR;0;2;2;1
2019-01-31 01:00:00;SUR;0;2;2;1
2019-01-31 01:30:00;SUR;0;1;1;1
2019-01-31 02:30:00;SUR;0;1;1;1
2019-01-31 03:00:00;SUR;0;2;2;1
2019-01-31 03:30:00;SUR;0;2;2;1
2019-01-31 04:00:00;SUR;0;3;3;1
2019-01-31 04:30:00;SUR;0;7;7;1
2019-01-31 05:00:00;SUR;0;8;8;1
2019-01-31 05:30:00;SUR;0;13;13;1
2019-01-31 06:00:00;SUR;0;19;19;1
2019-01-31 06:30:00;SUR;0;38;38;1
2019-01-31 07:00:00;SUR;0;22;22;1
2019-01-31 07:30:00;SUR;0;22;22;1
2019-01-31 08:00:00;SUR;0;33;33;1
2019-01-31 08:30:00;SUR;0;25;25;1
2019-01-31 09:00:00;SUR;0;33;33;1
2019-01-31 09:30:00;SUR;0;30;30;1
2019-01-31 10:00:00;SUR;0;27;27;1
2019-01-31 10:30:00;SUR;0;38;38;1
2019-01-31 11:00:00;SUR;0;32;32;1
2019-01-31 11:30:00;SUR;0;30;30;1
2019-01-31 12:00:00;SUR;0;28;28;1
2019-01-31 12:30:00;SUR;0;30;30;1
2019-01-31 13:00:00;SUR;0;23;23;1
2019-01-31 13:30:00;SUR;0;29;29;1
2019-01-31 14:00:00;SUR;0;36;36;1
2019-01-31 14:30:00;SUR;0;32;32;1
2019-01-31 15:00:00;SUR;0;33;33;1
2019-01-31 15:30:00;SUR;0;29;29;1
2019-01-31 16:00:00;SUR;0;19;19;1
2019-01-31 16:30:00;SUR;0;20;20;1
2019-01-31 17:00:00;SUR;0;27;27;1
2019-01-31 17:30:00;SUR;0;29;29;1
2019-01-31 18:00:00;SUR;0;27;27;1
2019-01-31 18:30:00;SUR;0;30;30;1
2019-01-31 19:00:00;SUR;0;39;39;1
2019-01-31 19:30:00;SUR;0;24;24;1
2019-01-31 20:00:00;SUR;0;25;25;1
2019-01-31 20:30:00;SUR;0;22;22;1
2019-01-31 21:00:00;SUR;0;31;31;1
2019-01-31 21:30:00;SUR;0;21;21;1
2019-01-31 22:00:00;SUR;0;10;10;1
2019-01-31 22:30:00;SUR;0;14;14;1
2019-01-31 23:00:00;SUR;0;10;10;1
2019-01-31 23:30:00;SUR;0;8;8;1
2019-02-01 00:00:00;SUR;0;1;1;1
2019-02-01 00:30:00;SUR;0;2;2;1
2019-02-01 01:00:00;SUR;0;1;1;1
2019-02-01 01:30:00;SUR;0;1;1;1
2019-02-01 02:00:00;SUR;0;3;3;1
2019-02-01 02:30:00;SUR;0;2;2;1
2019-02-01 03:00:00;SUR;0;2;2;1
2019-02-01 03:30:00;SUR;0;3;3;1
2019-02-01 04:00:00;SUR;0;3;3;1
2019-02-01 04:30:00;SUR;0;8;8;1
2019-02-01 05:00:00;SUR;0;9;9;1
2019-02-01 05:30:00;SUR;0;11;11;1
2019-02-01 06:00:00;SUR;0;23;23;1
2019-02-01 06:30:00;SUR;0;27;27;1
2019-02-01 07:00:00;SUR;0;19;19;1
2019-02-01 07:30:00;SUR;0;14;14;1
2019-02-01 08:00:00;SUR;0;34;34;1
2019-02-01 08:30:00;SUR;0;23;23;1
2019-02-01 09:00:00;SUR;0;31;31;1
2019-02-01 09:30:00;SUR;0;31;31;1
2019-02-01 10:00:00;SUR;0;24;24;1
2019-02-01 10:30:00;SUR;0;27;27;1
2019-02-01 11:00:00;SUR;0;31;31;1
2019-02-01 11:30:00;SUR;0;17;17;1
2019-02-01 12:00:00;SUR;0;28;28;1
2019-02-01 12:30:00;SUR;0;24;24;1
2019-02-01 13:00:00;SUR;0;24;24;1
2019-02-01 13:30:00;SUR;0;29;29;1
2019-02-01 14:00:00;SUR;0;31;31;1
2019-02-01 14:30:00;SUR;0;31;31;1
2019-02-01 15:00:00;SUR;0;8;8;1
2019-02-01 15:06:00;SUR;0;20;20;1
2019-02-01 15:30:00;SUR;0;31;31;1
2019-02-01 16:00:00;SUR;0;26;26;1
2019-02-01 16:30:00;SUR;0;25;25;1
2019-02-01 17:00:00;SUR;0;18;18;1
2019-02-01 17:30:00;SUR;0;26;26;1
2019-02-01 18:00:00;SUR;0;23;23;1
2019-02-01 18:30:00;SUR;0;25;25;1
2019-02-01 19:00:00;SUR;0;35;35;1
2019-02-01 19:30:00;SUR;0;28;28;1
2019-02-01 20:00:00;CONFLICTIVA;15;12;27;2
2019-02-01 20:30:00;NORTE;25;0;25;1
2019-02-01 21:00:00;NORTE;28;0;28;1
2019-02-01 21:30:00;NORTE;23;0;23;1
2019-02-01 22:00:00;NORTE;21;0;21;1
2019-02-01 22:30:00;NORTE;11;0;11;1
2019-02-01 23:00:00;NORTE;17;0;17;1
2019-02-01 23:30:00;NORTE;9;0;9;1
2019-02-02 00:00:00;NORTE;1;0;1;1
2019-02-02 00:30:00;NORTE;2;0;2;1
2019-02-02 01:00:00;NORTE;2;0;2;1
2019-02-02 03:00:00;NORTE;1;0;1;1
2019-02-02 03:30:00;NORTE;2;0;2;1
2019-02-02 04:00:00;NORTE;4;0;4;1
2019-02-02 04:30:00;NORTE;2;0;2;1
2019-02-02 05:00:00;CONFLICTIVA;3;3;6;2
2019-02-02 05:30:00;NORTE;14;0;14;1
2019-02-02 06:00:00;NORTE;25;0;25;1
2019-02-02 06:30:00;NORTE;25;0;25;1
2019-02-02 07:00:00;NORTE;17;0;17;1
2019-02-02 07:30:00;NORTE;17;0;17;1
2019-02-02 08:00:00;NORTE;32;0;32;1
2019-02-02 08:30:00;NORTE;27;0;27;1
2019-02-02 09:00:00;NORTE;37;0;37;1
2019-02-02 09:30:00;NORTE;24;0;24;1
2019-02-02 10:00:00;NORTE;22;0;22;1
2019-02-02 10:30:00;NORTE;40;0;40;1
2019-02-02 11:00:00;NORTE;34;0;34;1
2019-02-02 11:30:00;NORTE;23;0;23;1
2019-02-02 12:00:00;NORTE;28;0;28;1
2019-02-02 12:30:00;NORTE;28;0;28;1
2019-02-02 13:00:00;NORTE;25;0;25;1
2019-02-02 13:30:00;NORTE;26;0;26;1
2019-02-02 14:00:00;NORTE;32;0;32;1
2019-02-02 14:30:00;NORTE;27;0;27;1
2019-02-02 15:00:00;NORTE;33;0;33;1
2019-02-02 15:30:00;NORTE;28;0;28;1
2019-02-02 16:00:00;NORTE;17;0;17;1
2019-02-02 16:30:00;NORTE;19;0;19;1
2019-02-02 17:00:00;NORTE;22;0;22;1
2019-02-02 17:30:00;NORTE;24;0;24;1
2019-02-02 18:00:00;NORTE;14;0;14;1
2019-02-02 18:30:00;NORTE;16;0;16;1
2019-02-02 19:00:00;NORTE;30;0;30;1
2019-02-02 19:30:00;NORTE;15;0;15;1
2019-02-02 20:00:00;NORTE;15;0;15;1
2019-02-02 20:30:00;NORTE;25;0;25;1
2019-02-02 21:00:00;NORTE;13;0;13;1
2019-02-02 21:30:00;NORTE;16;0;16;1
2019-02-02 22:00:00;NORTE;7;0;7;1
2019-02-02 22:30:00;NORTE;4;0;4;1
2019-02-02 23:00:00;NORTE;11;0;11;1
2019-02-02 23:30:00;NORTE;4;0;4;1
2019-02-03 01:00:00;NORTE;1;0;1;1
2019-02-03 01:30:00;NORTE;1;0;1;1
2019-02-03 02:00:00;NORTE;1;0;1;1
2019-02-03 02:30:00;NORTE;1;0;1;1
2019-02-03 03:00:00;NORTE;2;0;2;1
2019-02-03 03:30:00;NORTE;2;0;2;1
2019-02-03 04:00:00;NORTE;3;0;3;1
2019-02-03 04:30:00;NORTE;4;0;4;1
2019-02-03 05:00:00;NORTE;10;0;10;1
2019-02-03 05:30:00;NORTE;11;0;11;1
2019-02-03 06:00:00;NORTE;17;0;17;1
2019-02-03 06:30:00;NORTE;18;0;18;1
2019-02-03 07:00:00;NORTE;12;0;12;1
2019-02-03 07:30:00;NORTE;16;0;16;1
2019-02-03 08:00:00;NORTE;23;0;23;1
2019-02-03 08:30:00;NORTE;27;0;27;1
2019-02-03 09:00:00;NORTE;29;0;29;1
2019-02-03 09:30:00;NORTE;24;0;24;1
2019-02-03 10:00:00;NORTE;23;0;23;1
2019-02-03 10:30:00;NORTE;37;0;37;1
2019-02-03 11:00:00;NORTE;35;0;35;1
2019-02-03 11:30:00;NORTE;23;0;23;1
2019-02-03 12:00:00;NORTE;30;0;30;1
2019-02-03 12:30:00;NORTE;29;0;29;1
2019-02-03 13:00:00;NORTE;25;0;25;1
2019-02-03 13:30:00;NORTE;23;0;23;1
2019-02-03 14:00:00;NORTE;29;0;29;1
2019-02-03 14:30:00;NORTE;30;0;30;1
2019-02-03 15:00:00;NORTE;31;0;31;1
2019-02-03 15:30:00;NORTE;29;0;29;1
2019-02-03 16:00:00;NORTE;17;0;17;1
2019-02-03 16:30:00;NORTE;16;0;16;1
2019-02-03 17:00:00;NORTE;19;0;19;1
2019-02-03 17:30:00;NORTE;30;0;30;1
2019-02-03 18:00:00;NORTE;27;0;27;1
2019-02-03 18:30:00;NORTE;40;0;40;1
2019-02-03 19:00:00;NORTE;38;0;38;1
2019-02-03 19:30:00;NORTE;31;0;31;1
2019-02-03 20:00:00;NORTE;25;0;25;1
2019-02-03 20:30:00;NORTE;31;0;31;1
2019-02-03 21:00:00;NORTE;26;0;26;1
2019-02-03 21:30:00;NORTE;21;0;21;1
2019-02-03 22:00:00;NORTE;12;0;12;1
2019-02-03 22:30:00;NORTE;12;0;12;1
2019-02-03 23:00:00;NORTE;13;0;13;1
2019-02-03 23:30:00;NORTE;4;0;4;1
2019-02-04 00:00:00;NORTE;2;0;2;1
2019-02-04 00:30:00;NORTE;3;0;3;1
2019-02-04 01:30:00;NORTE;2;0;2;1
2019-02-04 03:00:00;NORTE;2;0;2;1
2019-02-04 03:30:00;NORTE;6;0;6;1
2019-02-04 04:00:00;NORTE;2;0;2;1
2019-02-04 04:30:00;NORTE;6;0;6;1
2019-02-04 05:00:00;NORTE;6;0;6;1
2019-02-04 05:30:00;NORTE;11;0;11;1
2019-02-04 06:00:00;NORTE;15;0;15;1
2019-02-04 06:30:00;NORTE;41;0;41;1
2019-02-04 07:00:00;NORTE;26;0;26;1
2019-02-04 07:30:00;NORTE;22;0;22;1
2019-02-04 08:00:00;NORTE;31;0;31;1
2019-02-04 08:30:00;NORTE;28;0;28;1
2019-02-04 09:00:00;NORTE;38;0;38;1
2019-02-04 09:30:00;NORTE;35;0;35;1
2019-02-04 10:00:00;NORTE;21;0;21;1
2019-02-04 10:30:00;NORTE;36;0;36;1
2019-02-04 11:00:00;NORTE;28;0;28;1
2019-02-04 11:30:00;NORTE;26;0;26;1
2019-02-04 12:00:00;NORTE;27;0;27;1
2019-02-04 12:30:00;NORTE;30;0;30;1
2019-02-04 13:00:00;NORTE;29;0;29;1
2019-02-04 13:30:00;NORTE;35;0;35;1
2019-02-04 14:00:00;NORTE;37;0;37;1
2019-02-04 14:30:00;NORTE;25;0;25;1
2019-02-04 15:00:00;NORTE;33;0;33;1
2019-02-04 15:30:00;NORTE;29;0;29;1
2019-02-04 16:00:00;NORTE;20;0;20;1
2019-02-04 16:30:00;NORTE;22;0;22;1
2019-02-04 17:00:00;NORTE;25;0;25;1
2019-02-04 17:30:00;NORTE;35;0;35;1
2019-02-04 18:00:00;NORTE;23;0;23;1
2019-02-04 18:30:00;NORTE;35;0;35;1
2019-02-04 19:00:00;NORTE;36;0;36;1
2019-02-04 19:30:00;NORTE;33;0;33;1
2019-02-04 20:00:00;NORTE;23;0;23;1
2019-02-04 20:30:00;NORTE;26;0;26;1
2019-02-04 21:00:00;NORTE;32;0;32;1
2019-02-04 21:30:00;NORTE;17;0;17;1
2019-02-04 22:00:00;NORTE;15;0;15;1
2019-02-04 22:30:00;NORTE;7;0;7;1
2019-02-04 23:00:00;NORTE;12;0;12;1
2019-02-04 23:30:00;NORTE;2;0;2;1
2019-02-05 00:30:00;NORTE;2;0;2;1
2019-02-05 01:30:00;NORTE;1;0;1;1
2019-02-05 02:30:00;NORTE;2;0;2;1
2019-02-05 03:00:00;NORTE;7;0;7;1
2019-02-05 04:00:00;NORTE;2;0;2;1
2019-02-05 04:30:00;NORTE;11;0;11;1
2019-02-05 05:00:00;NORTE;10;0;10;1
2019-02-05 05:30:00;NORTE;12;0;12;1
2019-02-05 06:00:00;NORTE;20;0;20;1
2019-02-05 06:30:00;NORTE;40;0;40;1
2019-02-05 07:00:00;NORTE;25;0;25;1
2019-02-05 07:30:00;NORTE;26;0;26;1
2019-02-05 08:00:00;NORTE;32;0;32;1
2019-02-05 08:30:00;NORTE;29;0;29;1
2019-02-05 09:00:00;NORTE;37;0;37;1
2019-02-05 09:30:00;NORTE;23;0;23;1
2019-02-05 10:00:00;NORTE;17;0;17;1
2019-02-05 10:30:00;NORTE;39;0;39;1
2019-02-05 11:00:00;NORTE;27;0;27;1
2019-02-05 11:30:00;NORTE;29;0;29;1
2019-02-05 12:00:00;NORTE;27;0;27;1
2019-02-05 12:30:00;NORTE;26;0;26;1
2019-02-05 13:00:00;NORTE;23;0;23;1
2019-02-05 13:30:00;NORTE;31;0;31;1
2019-02-05 14:00:00;NORTE;32;0;32;1
2019-02-05 14:30:00;NORTE;24;0;24;1
2019-02-05 15:00:00;NORTE;28;0;28;1
2019-02-05 15:30:00;NORTE;28;0;28;1
2019-02-05 16:00:00;NORTE;22;0;22;1
2019-02-05 16:30:00;NORTE;18;0;18;1
2019-02-05 17:00:00;NORTE;21;0;21;1
2019-02-05 17:30:00;NORTE;28;0;28;1
2019-02-05 18:00:00;NORTE;23;0;23;1
2019-02-05 18:30:00;NORTE;24;0;24;1
2019-02-05 19:00:00;NORTE;36;0;36;1
2019-02-05 19:30:00;NORTE;21;0;21;1
2019-02-05 20:00:00;NORTE;18;0;18;1
2019-02-05 20:30:00;NORTE;29;0;29;1
2019-02-05 21:00:00;NORTE;25;0;25;1
2019-02-05 21:30:00;NORTE;15;0;15;1
2019-02-05 22:00:00;NORTE;8;0;8;1
2019-02-05 22:30:00;NORTE;3;0;3;1
2019-02-05 23:00:00;NORTE;12;0;12;1
2019-02-05 23:30:00;NORTE;2;0;2;1
2019-02-06 01:30:00;NORTE;1;0;1;1
2019-02-06 02:30:00;NORTE;1;0;1;1
2019-02-06 03:00:00;NORTE;4;0;4;1
2019-02-06 03:30:00;NORTE;1;0;1;1
2019-02-06 04:00:00;NORTE;2;0;2;1
2019-02-06 04:30:00;NORTE;9;0;9;1
2019-02-06 05:00:00;NORTE;7;0;7;1
2019-02-06 05:30:00;NORTE;14;0;14;1
2019-02-06 06:00:00;NORTE;18;0;18;1
2019-02-06 06:30:00;NORTE;30;0;30;1
2019-02-06 07:00:00;NORTE;20;0;20;1
2019-02-06 07:30:00;NORTE;31;0;31;1
2019-02-06 08:00:00;NORTE;25;0;25;1
2019-02-06 08:30:00;NORTE;26;0;26;1
2019-02-06 09:00:00;NORTE;37;0;37;1
2019-02-06 09:30:00;NORTE;25;0;25;1
2019-02-06 10:00:00;NORTE;24;0;24;1
2019-02-06 10:30:00;NORTE;40;0;40;1
2019-02-06 11:00:00;NORTE;29;0;29;1
2019-02-06 11:30:00;NORTE;29;0;29;1
2019-02-06 12:00:00;NORTE;33;0;33;1
2019-02-06 12:30:00;NORTE;25;0;25;1
2019-02-06 13:00:00;NORTE;23;0;23;1
2019-02-06 13:30:00;NORTE;26;0;26;1
2019-02-06 14:00:00;NORTE;35;0;35;1
2019-02-06 14:30:00;NORTE;25;0;25;1
2019-02-06 15:00:00;NORTE;30;0;30;1
2019-02-06 15:30:00;NORTE;28;1;29;1
2019-02-06 16:00:00;NORTE;18;0;18;1
2019-02-06 16:30:00;NORTE;16;0;16;1
2019-02-06 17:00:00;NORTE;21;0;21;1
2019-02-06 17:30:00;NORTE;32;0;32;1
2019-02-06 18:00:00;NORTE;26;0;26;1
2019-02-06 18:30:00;NORTE;26;0;26;1
2019-02-06 19:00:00;NORTE;31;0;31;1
2019-02-06 19:30:00;NORTE;32;0;32;1
2019-02-06 20:00:00;NORTE;20;0;20;1
2019-02-06 20:30:00;NORTE;27;0;27;1
2019-02-06 21:00:00;NORTE;33;0;33;1
2019-02-06 21:30:00;NORTE;18;0;18;1
2019-02-06 22:00:00;NORTE;10;0;10;1
2019-02-06 22:30:00;NORTE;9;0;9;1
2019-02-06 23:00:00;NORTE;11;0;11;1
2019-02-06 23:30:00;NORTE;2;0;2;1
2019-02-07 00:00:00;NORTE;1;0;1;1
2019-02-07 00:30:00;NORTE;1;0;1;1
2019-02-07 01:00:00;NORTE;2;0;2;1
2019-02-07 01:30:00;NORTE;1;0;1;1
2019-02-07 02:30:00;NORTE;2;0;2;1
2019-02-07 03:00:00;NORTE;3;0;3;1
2019-02-07 03:30:00;NORTE;1;0;1;1
2019-02-07 04:30:00;NORTE;7;0;7;1
2019-02-07 05:00:00;NORTE;11;0;11;1
2019-02-07 05:30:00;NORTE;13;0;13;1
2019-02-07 06:00:00;NORTE;20;0;20;1
2019-02-07 06:30:00;NORTE;32;0;32;1
2019-02-07 07:00:00;NORTE;24;0;24;1
2019-02-07 07:30:00;NORTE;26;0;26;1
2019-02-07 08:00:00;NORTE;26;0;26;1
2019-02-07 08:30:00;NORTE;31;0;31;1
2019-02-07 09:00:00;NORTE;34;0;34;1
2019-02-07 09:30:00;NORTE;32;0;32;1
2019-02-07 10:00:00;NORTE;20;0;20;1
2019-02-07 10:30:00;NORTE;32;0;32;1
2019-02-07 11:00:00;NORTE;33;0;33;1
2019-02-07 11:30:00;NORTE;33;0;33;1
2019-02-07 12:00:00;NORTE;26;0;26;1
2019-02-07 12:30:00;NORTE;21;0;21;1
2019-02-07 13:00:00;NORTE;32;0;32;1
2019-02-07 13:30:00;NORTE;28;0;28;1
2019-02-07 14:00:00;NORTE;35;0;35;1
2019-02-07 14:30:00;NORTE;25;0;25;1
2019-02-07 15:00:00;NORTE;32;0;32;1
2019-02-07 15:30:00;NORTE;32;0;32;1
2019-02-07 16:00:00;NORTE;25;0;25;1
2019-02-07 16:30:00;NORTE;13;0;13;1
2019-02-07 17:00:00;NORTE;24;0;24;1
2019-02-07 17:30:00;NORTE;30;0;30;1
2019-02-07 18:00:00;NORTE;29;0;29;1
2019-02-07 18:30:00;NORTE;29;0;29;1
2019-02-07 19:00:00;NORTE;38;0;38;1
2019-02-07 19:30:00;NORTE;37;0;37;1
2019-02-07 20:00:00;NORTE;18;0;18;1
2019-02-07 20:30:00;NORTE;32;0;32;1
2019-02-07 21:00:00;NORTE;28;0;28;1
2019-02-07 21:30:00;NORTE;18;0;18;1
2019-02-07 22:00:00;NORTE;14;0;14;1
2019-02-07 22:30:00;NORTE;10;0;10;1
2019-02-07 23:00:00;NORTE;9;0;9;1
2019-02-07 23:30:00;NORTE;5;0;5;1
2019-02-08 00:30:00;NORTE;2;0;2;1
2019-02-08 01:30:00;NORTE;1;0;1;1
2019-02-08 02:00:00;NORTE;1;0;1;1
2019-02-08 02:30:00;NORTE;1;0;1;1
2019-02-08 03:00:00;NORTE;3;0;3;1
2019-02-08 03:30:00;NORTE;5;0;5;1
2019-02-08 04:00:00;NORTE;4;0;4;1
2019-02-08 04:30:00;NORTE;6;0;6;1
2019-02-08 05:00:00;NORTE;9;0;9;1
2019-02-08 05:30:00;NORTE;12;0;12;1
2019-02-08 06:00:00;NORTE;19;0;19;1
2019-02-08 06:30:00;NORTE;35;0;35;1
2019-02-08 07:00:00;NORTE;17;0;17;1
2019-02-08 07:30:00;NORTE;25;0;25;1
2019-02-08 08:00:00;NORTE;27;0;27;1
2019-02-08 08:30:00;NORTE;30;0;30;1
2019-02-08 09:00:00;NORTE;40;0;40;1
2019-02-08 09:30:00;NORTE;30;0;30;1
2019-02-08 10:00:00;NORTE;21;0;21;1
2019-02-08 10:30:00;NORTE;36;0;36;1
2019-02-08 11:00:00;NORTE;31;0;31;1
2019-02-08 11:30:00;NORTE;32;0;32;1
2019-02-08 12:00:00;NORTE;25;0;25;1
2019-02-08 12:30:00;NORTE;27;0;27;1
2019-02-08 13:00:00;NORTE;26;0;26;1
2019-02-08 13:30:00;NORTE;29;0;29;1
2019-02-08 14:00:00;NORTE;20;2;22;1
2019-02-08 14:30:00;SUR;0;35;35;1
2019-02-08 15:00:00;SUR;0;35;35;1
2019-02-08 15:30:00;SUR;0;26;26;1
2019-02-08 16:00:00;SUR;0;22;22;1
2019-02-08 16:30:00;SUR;0;23;23;1
2019-02-08 17:00:00;SUR;0;17;17;1
2019-02-08 17:30:00;SUR;0;29;29;1
2019-02-08 18:00:00;SUR;0;34;34;1
2019-02-08 18:30:00;SUR;0;28;28;1
2019-02-08 19:00:00;SUR;0;32;32;1
2019-02-08 19:30:00;SUR;0;29;29;1
2019-02-08 20:00:00;SUR;0;30;30;1
2019-02-08 20:30:00;SUR;0;25;25;1
2019-02-08 21:00:00;NORTE;30;0;30;1
2019-02-08 21:30:00;NORTE;18;0;18;1
2019-02-08 22:00:00;NORTE;15;0;15;1
2019-02-08 22:30:00;NORTE;10;0;10;1
2019-02-08 23:00:00;NORTE;12;0;12;1
2019-02-08 23:30:00;NORTE;5;0;5;1
2019-02-09 00:00:00;NORTE;1;0;1;1
2019-02-09 00:30:00;NORTE;2;0;2;1
2019-02-09 02:30:00;NORTE;2;0;2;1
2019-02-09 03:00:00;NORTE;3;0;3;1
2019-02-09 03:30:00;NORTE;3;0;3;1
2019-02-09 04:00:00;NORTE;1;0;1;1
2019-02-09 04:30:00;NORTE;5;0;5;1
2019-02-09 05:00:00;NORTE;10;0;10;1
2019-02-09 05:30:00;NORTE;12;0;12;1
2019-02-09 06:00:00;NORTE;20;0;20;1
2019-02-09 06:30:00;NORTE;28;0;28;1
2019-02-09 07:00:00;NORTE;13;0;13;1
2019-02-09 07:30:00;NORTE;23;0;23;1
2019-02-09 08:00:00;NORTE;29;0;29;1
2019-02-09 08:30:00;NORTE;20;0;20;1
2019-02-09 09:00:00;NORTE;35;0;35;1
2019-02-09 09:30:00;NORTE;27;0;27;1
2019-02-09 10:00:00;NORTE;17;0;17;1
2019-02-09 10:22:00;NORTE;4;0;4;1
2019-02-09 10:30:00;NORTE;38;0;38;1
2019-02-09 11:00:00;NORTE;30;0;30;1
2019-02-09 11:30:00;NORTE;31;0;31;1
2019-02-09 12:00:00;NORTE;21;0;21;1
2019-02-09 12:30:00;NORTE;28;0;28;1
2019-02-09 13:00:00;NORTE;30;0;30;1
2019-02-09 13:30:00;NORTE;30;0;30;1
2019-02-09 14:00:00;NORTE;27;0;27;1
2019-02-09 14:30:00;NORTE;25;0;25;1
2019-02-09 15:00:00;NORTE;34;0;34;1
2019-02-09 15:30:00;NORTE;17;0;17;1
2019-02-09 16:00:00;NORTE;20;0;20;1
2019-02-09 16:30:00;NORTE;16;0;16;1
2019-02-09 17:00:00;NORTE;19;0;19;1
2019-02-09 17:30:00;NORTE;26;0;26;1
2019-02-09 18:00:00;NORTE;12;0;12;1
2019-02-09 18:30:00;NORTE;27;0;27;1
2019-02-09 19:00:00;NORTE;28;0;28;1
2019-02-09 19:30:00;NORTE;14;0;14;1
2019-02-09 20:00:00;NORTE;17;0;17;1
2019-02-09 20:30:00;NORTE;19;0;19;1
2019-02-09 21:00:00;NORTE;17;0;17;1
2019-02-09 21:30:00;NORTE;14;0;14;1
2019-02-09 22:00:00;NORTE;9;0;9;1
2019-02-09 22:30:00;NORTE;4;0;4;1
2019-02-09 23:00:00;NORTE;13;0;13;1
2019-02-09 23:30:00;NORTE;2;0;2;1
2019-02-10 00:00:00;NORTE;2;0;2;1
2019-02-10 00:30:00;NORTE;1;0;1;1
2019-02-10 01:00:00;NORTE;2;0;2;1
2019-02-10 01:30:00;NORTE;1;0;1;1
2019-02-10 02:00:00;NORTE;1;0;1;1
2019-02-10 02:30:00;NORTE;2;0;2;1
2019-02-10 03:00:00;NORTE;4;0;4;1
2019-02-10 03:30:00;NORTE;3;0;3;1
2019-02-10 04:00:00;NORTE;1;0;1;1
2019-02-10 04:30:00;NORTE;3;0;3;1
2019-02-10 05:00:00;NORTE;7;0;7;1
2019-02-10 05:30:00;NORTE;11;0;11;1
2019-02-10 06:00:00;NORTE;20;0;20;1
2019-02-10 06:30:00;NORTE;22;0;22;1
2019-02-10 07:00:00;NORTE;11;0;11;1
2019-02-10 07:30:00;NORTE;16;0;16;1
2019-02-10 08:00:00;NORTE;21;0;21;1
2019-02-10 08:15:00;NORTE;6;0;6;1
2019-02-10 08:30:00;NORTE;27;0;27;1
2019-02-10 09:00:00;NORTE;35;0;35;1
2019-02-10 09:30:00;NORTE;22;0;22;1
2019-02-10 10:00:00;SUR;1;22;23;1
2019-02-10 10:30:00;SUR;0;36;36;1
2019-02-10 11:00:00;SUR;0;31;31;1
2019-02-10 11:30:00;SUR;0;26;26;1
2019-02-10 12:00:00;SUR;0;28;28;1
2019-02-10 12:30:00;SUR;0;30;30;1
2019-02-10 13:00:00;SUR;0;28;28;1
2019-02-10 13:30:00;SUR;0;30;30;1
2019-02-10 14:00:00;SUR;0;35;35;1
2019-02-10 14:30:00;SUR;0;30;30;1
2019-02-10 15:00:00;SUR;0;34;34;1
2019-02-10 15:30:00;SUR;0;29;29;1
2019-02-10 16:00:00;SUR;0;14;14;1
2019-02-10 16:30:00;SUR;0;14;14;1
2019-02-10 17:00:00;SUR;0;19;19;1
2019-02-10 17:30:00;SUR;0;34;34;1
2019-02-10 18:00:00;SUR;0;21;21;1
2019-02-10 18:30:00;SUR;0;37;37;1
2019-02-10 19:00:00;SUR;0;32;32;1
2019-02-10 19:30:00;SUR;0;30;30;1
2019-02-10 20:00:00;SUR;0;34;34;1
2019-02-10 20:30:00;SUR;0;27;27;1
2019-02-10 21:00:00;SUR;0;29;29;1
2019-02-10 21:30:00;SUR;0;19;19;1
2019-02-10 22:00:00;SUR;0;17;17;1
2019-02-10 22:30:00;CONFLICTIVA;3;9;12;2
2019-02-10 23:00:00;NORTE;12;0;12;1
2019-02-10 23:30:00;NORTE;5;0;5;1
2019-02-11 00:00:00;NORTE;2;0;2;1
2019-02-11 00:30:00;NORTE;1;0;1;1
2019-02-11 01:00:00;NORTE;2;0;2;1
2019-02-11 01:30:00;NORTE;1;0;1;1
2019-02-11 02:30:00;NORTE;1;0;1;1
2019-02-11 03:00:00;NORTE;5;0;5;1
2019-02-11 03:30:00;NORTE;2;0;2;1
2019-02-11 04:30:00;NORTE;7;0;7;1
2019-02-11 05:00:00;NORTE;8;0;8;1
2019-02-11 05:30:00;NORTE;13;0;13;1
2019-02-11 06:00:00;NORTE;25;0;25;1
2019-02-11 06:30:00;NORTE;38;0;38;1
2019-02-11 07:00:00;NORTE;18;0;18;1
2019-02-11 07:30:00;NORTE;30;0;30;1
2019-02-11 08:00:00;NORTE;31;0;31;1
2019-02-11 08:30:00;NORTE;32;0;32;1
2019-02-11 09:00:00;NORTE;37;0;37;1
2019-02-11 09:30:00;NORTE;34;0;34;1
2019-02-11 10:00:00;NORTE;28;0;28;1
2019-02-11 10:30:00;NORTE;35;0;35;1
2019-02-11 11:00:00;NORTE;32;0;32;1
2019-02-11 11:30:00;NORTE;30;0;30;1
2019-02-11 12:00:00;NORTE;30;0;30;1
2019-02-11 12:30:00;NORTE;24;0;24;1
2019-02-11 13:00:00;NORTE;25;0;25;1
2019-02-11 13:30:00;NORTE;29;0;29;1
2019-02-11 14:00:00;NORTE;42;0;42;1
2019-02-11 14:30:00;NORTE;24;0;24;1
2019-02-11 15:00:00;NORTE;36;0;36;1
2019-02-11 15:30:00;NORTE;28;0;28;1
2019-02-11 16:00:00;NORTE;20;0;20;1
2019-02-11 16:30:00;NORTE;22;0;22;1
2019-02-11 17:00:00;NORTE;22;0;22;1
2019-02-11 17:30:00;NORTE;31;0;31;1
2019-02-11 18:00:00;NORTE;27;0;27;1
2019-02-11 18:30:00;NORTE;32;0;32;1
2019-02-11 19:00:00;NORTE;36;0;36;1
2019-02-11 19:30:00;NORTE;27;0;27;1
2019-02-11 20:00:00;NORTE;25;0;25;1
2019-02-11 20:30:00;NORTE;34;0;34;1
2019-02-11 21:00:00;NORTE;25;0;25;1
2019-02-11 21:30:00;NORTE;23;0;23;1
2019-02-11 22:00:00;NORTE;12;0;12;1
2019-02-11 22:30:00;NORTE;4;0;4;1
2019-02-11 23:00:00;NORTE;9;0;9;1
2019-02-11 23:30:00;NORTE;2;0;2;1
2019-02-12 00:00:00;NORTE;1;0;1;1
2019-02-12 01:30:00;NORTE;1;0;1;1
2019-02-12 03:00:00;NORTE;7;0;7;1
2019-02-12 03:30:00;NORTE;1;0;1;1
2019-02-12 04:00:00;NORTE;5;0;5;1
2019-02-12 04:30:00;NORTE;7;0;7;1
2019-02-12 05:00:00;NORTE;10;0;10;1
2019-02-12 05:30:00;NORTE;9;0;9;1
2019-02-12 06:00:00;NORTE;26;0;26;1
2019-02-12 06:30:00;NORTE;37;0;37;1
2019-02-12 07:00:00;NORTE;26;0;26;1
2019-02-12 07:30:00;NORTE;19;0;19;1
2019-02-12 08:00:00;NORTE;36;0;36;1
2019-02-12 08:30:00;NORTE;28;0;28;1
2019-02-12 09:00:00;NORTE;37;0;37;1
2019-02-12 09:30:00;NORTE;29;0;29;1
2019-02-12 10:00:00;NORTE;21;0;21;1
2019-02-12 10:30:00;NORTE;35;0;35;1
2019-02-12 11:00:00;NORTE;32;0;32;1
2019-02-12 11:30:00;NORTE;24;0;24;1
2019-02-12 12:00:00;NORTE;29;0;29;1
2019-02-12 12:30:00;NORTE;26;0;26;1
2019-02-12 13:00:00;NORTE;26;0;26;1
2019-02-12 13:30:00;NORTE;29;0;29;1
2019-02-12 14:00:00;NORTE;32;0;32;1
2019-02-12 14:30:00;NORTE;28;0;28;1
2019-02-12 15:00:00;NORTE;34;0;34;1
2019-02-12 15:30:00;NORTE;23;0;23;1
2019-02-12 16:00:00;NORTE;25;0;25;1
2019-02-12 16:30:00;NORTE;18;0;18;1
2019-02-12 17:00:00;NORTE;21;0;21;1
2019-02-12 17:30:00;NORTE;33;0;33;1
2019-02-12 18:00:00;NORTE;25;0;25;1
2019-02-12 18:30:00;NORTE;24;0;24;1
2019-02-12 19:00:00;NORTE;37;1;38;1
2019-02-12 19:30:00;NORTE;19;0;19;1
2019-02-12 20:00:00;NORTE;21;0;21;1
2019-02-12 20:30:00;NORTE;30;0;30;1
2019-02-12 21:00:00;NORTE;29;0;29;1
2019-02-12 21:30:00;NORTE;18;0;18;1
2019-02-12 22:00:00;NORTE;11;0;11;1
2019-02-12 22:30:00;NORTE;3;0;3;1
2019-02-12 23:00:00;NORTE;11;0;11;1
2019-02-12 23:30:00;NORTE;2;0;2;1
2019-02-13 00:00:00;NORTE;2;0;2;1
2019-02-13 00:30:00;NORTE;1;0;1;1
2019-02-13 01:00:00;NORTE;2;0;2;1
2019-02-13 02:00:00;NORTE;1;0;1;1
2019-02-13 02:30:00;NORTE;2;0;2;1
2019-02-13 03:00:00;NORTE;3;0;3;1
2019-02-13 03:30:00;NORTE;3;0;3;1
2019-02-13 04:30:00;NORTE;8;0;8;1
2019-02-13 05:00:00;NORTE;6;0;6;1
2019-02-13 05:30:00;NORTE;16;0;16;1
2019-02-13 06:00:00;NORTE;21;0;21;1
2019-02-13 06:30:00;NORTE;34;0;34;1
2019-02-13 07:00:00;NORTE;15;0;15;1
2019-02-13 07:30:00;NORTE;27;0;27;1
2019-02-13 08:00:00;NORTE;29;0;29;1
2019-02-13 08:30:00;NORTE;24;0;24;1
2019-02-13 09:00:00;NORTE;33;0;33;1
2019-02-13 09:30:27;NORTE;1;0;1;1
2019-02-13 09:30:45;NORTE;1;0;1;1
2019-02-13 09:30:47;NORTE;1;0;1;1
2019-02-13 09:31:59;NORTE;1;0;1;1
2019-02-13 09:32:30;NORTE;1;0;1;1
2019-02-13 09:32:41;NORTE;1;0;1;1
2019-02-13 09:33:54;NORTE;1;0;1;1
2019-02-13 09:34:57;NORTE;1;0;1;1
2019-02-13 09:36:50;NORTE;1;0;1;1
2019-02-13 09:36:57;NORTE;1;0;1;1
2019-02-13 09:37:33;NORTE;1;0;1;1
2019-02-13 09:38:42;NORTE;1;0;1;1
2019-02-13 09:39:12;NORTE;1;0;1;1
2019-02-13 09:39:43;NORTE;1;0;1;1
2019-02-13 09:41:01;NORTE;1;0;1;1
2019-02-13 09:41:33;NORTE;1;0;1;1
2019-02-13 09:42:12;NORTE;1;0;1;1
2019-02-13 09:42:49;NORTE;1;0;1;1
2019-02-13 09:44:10;NORTE;1;0;1;1
2019-02-13 09:44:40;NORTE;1;0;1;1
2019-02-13 09:45:32;NORTE;1;0;1;1
2019-02-13 09:46:41;NORTE;1;0;1;1
2019-02-13 09:47:47;NORTE;1;0;1;1
2019-02-13 09:48:54;NORTE;1;0;1;1
2019-02-13 09:50:35;NORTE;1;0;1;1
2019-02-13 09:50:53;NORTE;1;0;1;1
2019-02-13 09:52:02;NORTE;1;0;1;1
2019-02-13 09:53:38;NORTE;1;0;1;1
2019-02-13 09:55:39;NORTE;1;0;1;1
2019-02-13 09:57:28;NORTE;1;0;1;1
2019-02-13 09:59:04;NORTE;1;0;1;1
2019-02-13 10:00:00;NORTE;23;0;23;1
2019-02-13 10:30:00;NORTE;35;0;35;1
2019-02-13 11:00:00;NORTE;31;0;31;1
2019-02-13 11:30:00;NORTE;33;0;33;1
2019-02-13 12:00:00;NORTE;26;0;26;1
2019-02-13 12:30:00;NORTE;23;0;23;1
2019-02-13 13:00:00;NORTE;28;0;28;1
2019-02-13 13:30:00;NORTE;31;0;31;1
2019-02-13 14:00:00;NORTE;39;0;39;1
2019-02-13 14:30:00;NORTE;24;0;24;1
2019-02-13 15:00:00;NORTE;28;0;28;1
2019-02-13 15:30:00;NORTE;30;0;30;1
2019-02-13 16:00:00;NORTE;23;0;23;1
2019-02-13 16:30:00;NORTE;12;0;12;1
2019-02-13 17:00:00;NORTE;22;0;22;1
2019-02-13 17:30:00;NORTE;32;0;32;1
2019-02-13 18:00:00;NORTE;23;0;23;1
2019-02-13 18:30:00;NORTE;31;0;31;1
2019-02-13 19:00:00;NORTE;42;0;42;1
2019-02-13 19:30:00;NORTE;28;0;28;1
2019-02-13 20:00:00;NORTE;22;0;22;1
2019-02-13 20:30:00;NORTE;34;0;34;1
2019-02-13 21:00:00;NORTE;34;0;34;1
2019-02-13 21:30:00;NORTE;19;0;19;1
2019-02-13 22:00:00;NORTE;7;0;7;1
2019-02-13 22:30:00;NORTE;8;0;8;1
2019-02-13 23:00:00;NORTE;13;0;13;1
2019-02-13 23:30:00;NORTE;5;0;5;1
2019-02-14 00:30:00;NORTE;2;0;2;1
2019-02-14 01:00:00;NORTE;1;0;1;1
2019-02-14 02:30:00;NORTE;2;0;2;1
2019-02-14 03:00:00;NORTE;4;0;4;1
2019-02-14 03:30:00;NORTE;1;0;1;1
2019-02-14 04:00:00;NORTE;2;0;2;1
2019-02-14 04:30:00;NORTE;7;0;7;1
2019-02-14 05:00:00;NORTE;8;0;8;1
2019-02-14 05:30:00;NORTE;15;0;15;1
2019-02-14 06:00:00;NORTE;22;0;22;1
2019-02-14 06:30:00;NORTE;35;0;35;1
2019-02-14 07:00:00;NORTE;22;0;22;1
2019-02-14 07:30:00;NORTE;20;0;20;1
2019-02-14 08:00:00;NORTE;36;0;36;1
2019-02-14 08:30:00;NORTE;32;0;32;1
2019-02-14 09:00:00;NORTE;34;0;34;1
2019-02-14 09:30:00;NORTE;31;1;32;1
2019-02-14 10:00:00;NORTE;21;0;21;1
2019-02-14 10:30:00;NORTE;37;0;37;1
2019-02-14 11:00:00;NORTE;37;0;37;1
2019-02-14 11:30:00;NORTE;33;0;33;1
2019-02-14 12:00:00;NORTE;29;0;29;1
2019-02-14 12:30:00;NORTE;24;0;24;1
2019-02-14 13:00:00;NORTE;27;0;27;1
2019-02-14 13:30:00;NORTE;35;0;35;1
2019-02-14 14:00:00;NORTE;39;0;39;1
2019-02-14 14:30:00;NORTE;27;0;27;1
2019-02-14 15:00:00;NORTE;36;0;36;1
2019-02-14 15:30:00;NORTE;30;0;30;1
2019-02-14 16:00:00;NORTE;24;0;24;1
2019-02-14 16:30:00;NORTE;19;0;19;1
2019-02-14 17:00:00;NORTE;26;0;26;1
2019-02-14 17:30:00;NORTE;35;0;35;1
2019-02-14 18:00:00;NORTE;29;0;29;1
2019-02-14 18:30:00;NORTE;35;0;35;1
2019-02-14 19:00:00;NORTE;44;0;44;1
2019-02-14 19:30:00;NORTE;30;0;30;1
2019-02-14 20:00:00;NORTE;22;0;22;1
2019-02-14 20:30:00;NORTE;31;0;31;1
2019-02-14 21:00:00;NORTE;30;0;30;1
2019-02-14 21:30:00;NORTE;25;0;25;1
2019-02-14 22:00:00;NORTE;11;0;11;1
2019-02-14 22:30:00;NORTE;14;0;14;1
2019-02-14 23:00:00;NORTE;11;0;11;1
2019-02-14 23:30:00;NORTE;3;0;3;1
2019-02-15 00:00:00;NORTE;1;0;1;1
2019-02-15 01:00:00;NORTE;2;0;2;1
2019-02-15 01:30:00;NORTE;2;0;2;1
2019-02-15 02:00:00;NORTE;1;0;1;1
2019-02-15 02:30:00;NORTE;1;0;1;1
2019-02-15 03:00:00;NORTE;7;0;7;1
2019-02-15 03:30:00;NORTE;4;0;4;1
2019-02-15 04:00:00;NORTE;3;0;3;1
2019-02-15 04:30:00;NORTE;9;0;9;1
2019-02-15 05:00:00;NORTE;8;0;8;1
2019-02-15 05:30:00;NORTE;12;0;12;1
2019-02-15 06:00:00;NORTE;21;0;21;1
2019-02-15 06:30:00;NORTE;33;0;33;1
2019-02-15 07:00:00;NORTE;20;0;20;1
2019-02-15 07:30:00;NORTE;23;0;23;1
2019-02-15 08:00:00;NORTE;36;0;36;1
2019-02-15 08:30:04;NORTE;1;0;1;1
2019-02-15 08:31:05;NORTE;1;0;1;1
2019-02-15 08:32:47;NORTE;1;0;1;1
2019-02-15 08:33:33;NORTE;1;0;1;1
2019-02-15 08:34:18;NORTE;1;0;1;1
2019-02-15 08:35:20;NORTE;1;0;1;1
2019-02-15 08:37:11;NORTE;1;0;1;1
2019-02-15 08:37:25;NORTE;1;0;1;1
2019-02-15 08:39:04;NORTE;1;0;1;1
2019-02-15 08:39:53;NORTE;1;0;1;1
2019-02-15 08:40:53;NORTE;1;0;1;1
2019-02-15 08:41:23;NORTE;1;0;1;1
2019-02-15 08:42:19;NORTE;1;0;1;1
2019-02-15 08:42:57;NORTE;1;0;1;1
2019-02-15 08:43:17;NORTE;1;0;1;1
2019-02-15 08:44:18;NORTE;1;0;1;1
2019-02-15 08:45:18;NORTE;1;0;1;1
2019-02-15 08:46:33;NORTE;1;0;1;1
2019-02-15 08:46:54;NORTE;1;0;1;1
2019-02-15 08:49:11;NORTE;1;0;1;1
2019-02-15 08:50:47;NORTE;1;0;1;1
2019-02-15 08:51:49;NORTE;1;0;1;1
2019-02-15 08:51:57;NORTE;1;0;1;1
2019-02-15 08:52:50;NORTE;1;0;1;1
2019-02-15 08:54:14;NORTE;1;0;1;1
2019-02-15 08:55:44;NORTE;1;0;1;1
2019-02-15 08:56:14;NORTE;1;0;1;1
2019-02-15 08:57:07;NORTE;1;0;1;1
2019-02-15 08:58:02;NORTE;1;0;1;1
2019-02-15 08:58:12;NORTE;1;0;1;1
2019-02-15 08:59:16;NORTE;1;0;1;1
2019-02-15 08:59:41;NORTE;1;0;1;1
2019-02-15 09:00:00;NORTE;36;0;36;1
2019-02-15 09:30:00;NORTE;32;0;32;1
2019-02-15 10:00:00;NORTE;28;0;28;1
2019-02-15 10:30:00;NORTE;39;0;39;1
2019-02-15 11:00:00;NORTE;30;0;30;1
2019-02-15 11:30:00;NORTE;39;0;39;1
2019-02-15 12:00:00;NORTE;25;0;25;1
2019-02-15 12:30:00;NORTE;28;0;28;1
2019-02-15 13:00:00;NORTE;32;0;32;1
2019-02-15 13:30:00;NORTE;30;0;30;1
2019-02-15 14:00:00;NORTE;37;0;37;1
2019-02-15 14:30:00;NORTE;28;1;29;1
2019-02-15 15:00:00;NORTE;41;0;41;1
2019-02-15 15:30:00;NORTE;38;0;38;1
2019-02-15 16:00:00;NORTE;16;0;16;1
2019-02-15 16:30:00;NORTE;20;0;20;1
2019-02-15 17:00:00;NORTE;22;0;22;1
2019-02-15 17:30:00;NORTE;28;0;28;1
2019-02-15 18:00:00;NORTE;33;0;33;1
2019-02-15 18:30:00;NORTE;33;0;33;1
2019-02-15 19:00:00;NORTE;40;0;40;1
2019-02-15 19:30:00;NORTE;33;0;33;1
2019-02-15 20:00:00;NORTE;25;0;25;1
2019-02-15 20:30:00;NORTE;26;0;26;1
2019-02-15 21:00:00;NORTE;29;0;29;1
2019-02-15 21:30:00;NORTE;24;0;24;1
2019-02-15 22:00:00;NORTE;14;0;14;1
2019-02-15 22:30:00;NORTE;10;0;10;1
2019-02-15 23:00:00;NORTE;11;0;11;1
2019-02-15 23:30:00;NORTE;4;0;4;1
2019-02-16 00:30:00;NORTE;1;0;1;1
2019-02-16 01:00:00;NORTE;1;0;1;1
2019-02-16 02:00:00;NORTE;1;0;1;1
2019-02-16 02:30:00;NORTE;1;0;1;1
2019-02-16 03:00:00;NORTE;3;0;3;1
2019-02-16 03:30:00;NORTE;3;0;3;1
2019-02-16 04:00:00;NORTE;3;0;3;1
2019-02-16 04:30:00;NORTE;3;0;3;1
2019-02-16 05:00:00;NORTE;11;0;11;1
2019-02-16 05:30:00;NORTE;14;0;14;1
2019-02-16 06:00:00;NORTE;22;0;22;1
2019-02-16 06:30:00;NORTE;28;0;28;1
2019-02-16 07:00:00;NORTE;17;0;17;1
2019-02-16 07:30:00;NORTE;16;0;16;1
2019-02-16 08:00:00;NORTE;28;0;28;1
2019-02-16 08:30:00;NORTE;23;0;23;1
2019-02-16 09:00:00;NORTE;29;0;29;1
2019-02-16 09:30:00;NORTE;31;0;31;1
2019-02-16 10:00:00;NORTE;23;0;23;1
2019-02-16 10:30:00;NORTE;36;0;36;1
2019-02-16 11:00:00;NORTE;37;0;37;1
2019-02-16 11:30:00;NORTE;29;0;29;1
2019-02-16 12:00:00;NORTE;27;0;27;1
2019-02-16 12:30:00;NORTE;25;0;25;1
2019-02-16 13:00:00;NORTE;23;0;23;1
2019-02-16 13:30:00;NORTE;28;0;28;1
2019-02-16 14:00:00;NORTE;21;2;23;1
2019-02-16 14:30:00;SUR;0;28;28;1
2019-02-16 15:00:00;SUR;0;19;19;1
2019-02-16 15:30:00;SUR;0;19;19;1
2019-02-16 16:00:00;SUR;0;27;27;1
2019-02-16 16:30:00;SUR;0;23;23;1
2019-02-16 17:00:00;SUR;0;27;27;1
2019-02-16 17:30:00;SUR;0;29;29;1
2019-02-16 18:00:00;SUR;0;28;28;1
2019-02-16 18:30:00;SUR;0;21;21;1
2019-02-16 19:00:00;CONFLICTIVA;19;7;26;2
2019-02-16 19:30:00;NORTE;20;0;20;1
2019-02-16 20:00:00;NORTE;18;0;18;1
2019-02-16 20:30:00;NORTE;21;0;21;1
2019-02-16 21:00:00;NORTE;19;0;19;1
2019-02-16 21:30:00;NORTE;17;0;17;1
2019-02-16 22:00:00;NORTE;15;0;15;1
2019-02-16 22:30:00;NORTE;12;0;12;1
2019-02-16 23:00:00;NORTE;9;0;9;1
2019-02-16 23:30:00;NORTE;3;0;3;1
2019-02-17 00:00:00;NORTE;1;0;1;1
2019-02-17 01:00:00;NORTE;1;0;1;1
2019-02-17 01:30:00;NORTE;1;0;1;1
2019-02-17 02:00:00;NORTE;1;0;1;1
2019-02-17 03:00:00;NORTE;2;0;2;1
2019-02-17 03:30:00;NORTE;6;0;6;1
2019-02-17 04:00:00;NORTE;2;0;2;1
2019-02-17 04:30:00;NORTE;4;0;4;1
2019-02-17 05:00:00;NORTE;8;0;8;1
2019-02-17 05:30:00;NORTE;11;0;11;1
2019-02-17 06:00:00;NORTE;15;0;15;1
2019-02-17 06:30:00;NORTE;21;0;21;1
2019-02-17 07:00:00;NORTE;16;0;16;1
2019-02-17 07:30:00;NORTE;19;0;19;1
2019-02-17 08:00:00;NORTE;28;0;28;1
2019-02-17 08:30:00;NORTE;21;0;21;1
2019-02-17 09:00:00;NORTE;30;0;30;1
2019-02-17 09:30:00;NORTE;25;0;25;1
2019-02-17 10:00:00;NORTE;27;0;27;1
2019-02-17 10:30:00;NORTE;38;0;38;1
2019-02-17 11:00:00;NORTE;31;0;31;1
2019-02-17 11:30:00;NORTE;36;0;36;1
2019-02-17 12:00:00;NORTE;24;0;24;1
2019-02-17 12:30:00;NORTE;22;0;22;1
2019-02-17 13:00:00;NORTE;27;1;28;1
2019-02-17 13:30:00;NORTE;22;0;22;1
2019-02-17 14:00:00;NORTE;34;0;34;1
2019-02-17 14:30:00;NORTE;46;0;46;1
2019-02-17 15:00:00;NORTE;34;0;34;1
2019-02-17 15:30:00;NORTE;28;0;28;1
2019-02-17 16:00:00;NORTE;30;0;30;1
2019-02-17 16:30:00;NORTE;17;0;17;1
2019-02-17 17:00:00;NORTE;23;0;23;1
2019-02-17 17:30:00;NORTE;25;0;25;1
2019-02-17 18:00:00;NORTE;28;0;28;1
2019-02-17 18:30:00;NORTE;27;0;27;1
2019-02-17 19:00:00;NORTE;35;0;35;1
2019-02-17 19:30:00;NORTE;29;0;29;1
2019-02-17 20:00:00;NORTE;31;0;31;1
2019-02-17 20:30:00;NORTE;28;0;28;1
2019-02-17 21:00:00;NORTE;31;0;31;1
2019-02-17 21:30:00;NORTE;23;0;23;1
2019-02-17 22:00:00;NORTE;12;0;12;1
2019-02-17 22:30:00;NORTE;17;0;17;1
2019-02-17 23:00:00;NORTE;16;0;16;1
2019-02-17 23:30:00;NORTE;6;0;6;1
2019-02-18 00:00:00;NORTE;3;0;3;1
2019-02-18 01:00:00;NORTE;2;0;2;1
2019-02-18 01:30:00;CONFLICTIVA;2;1;3;2
2019-02-18 02:00:00;NORTE;1;0;1;1
2019-02-18 02:30:00;NORTE;2;0;2;1
2019-02-18 03:00:00;NORTE;3;0;3;1
2019-02-18 03:30:00;NORTE;1;0;1;1
2019-02-18 04:00:00;NORTE;4;0;4;1
2019-02-18 04:30:00;NORTE;6;0;6;1
2019-02-18 05:00:00;NORTE;6;0;6;1
2019-02-18 05:30:00;NORTE;15;0;15;1
2019-02-18 06:00:00;NORTE;20;0;20;1
2019-02-18 06:30:00;NORTE;35;0;35;1
2019-02-18 07:00:00;NORTE;23;0;23;1
2019-02-18 07:30:00;NORTE;28;0;28;1
2019-02-18 08:00:00;NORTE;38;0;38;1
2019-02-18 08:30:00;NORTE;26;0;26;1
2019-02-18 09:00:00;NORTE;41;0;41;1
2019-02-18 09:30:00;NORTE;31;0;31;1
2019-02-18 10:00:00;NORTE;28;0;28;1
2019-02-18 10:30:00;NORTE;38;0;38;1
2019-02-18 11:00:00;NORTE;40;0;40;1
2019-02-18 11:30:00;NORTE;24;0;24;1
2019-02-18 12:00:00;NORTE;29;0;29;1
2019-02-18 12:30:00;NORTE;27;0;27;1
2019-02-18 13:00:00;NORTE;22;0;22;1
2019-02-18 13:30:00;NORTE;35;0;35;1
2019-02-18 14:00:00;NORTE;21;0;21;1
2019-02-18 14:30:00;NORTE;35;0;35;1
2019-02-18 15:00:00;NORTE;35;0;35;1
2019-02-18 15:30:00;NORTE;21;0;21;1
2019-02-18 16:00:00;NORTE;23;0;23;1
2019-02-18 16:30:00;NORTE;20;0;20;1
2019-02-18 17:00:00;NORTE;26;0;26;1
2019-02-18 17:30:00;NORTE;35;0;35;1
2019-02-18 18:00:00;NORTE;33;0;33;1
2019-02-18 18:30:00;NORTE;27;0;27;1
2019-02-18 19:00:00;NORTE;42;0;42;1
2019-02-18 19:30:00;NORTE;32;0;32;1
2019-02-18 20:00:00;NORTE;22;0;22;1
2019-02-18 20:30:00;NORTE;37;0;37;1
2019-02-18 21:00:00;NORTE;26;0;26;1
2019-02-18 21:30:00;NORTE;17;0;17;1
2019-02-18 22:00:00;NORTE;13;0;13;1
2019-02-18 22:30:00;NORTE;9;0;9;1
2019-02-18 23:00:00;NORTE;10;0;10;1
2019-02-18 23:30:00;NORTE;2;0;2;1
2019-02-19 00:00:00;NORTE;1;0;1;1
2019-02-19 00:30:00;NORTE;1;0;1;1
2019-02-19 01:00:00;NORTE;1;0;1;1
2019-02-19 03:00:00;NORTE;2;0;2;1
2019-02-19 03:30:00;NORTE;4;0;4;1
2019-02-19 04:00:00;NORTE;2;0;2;1
2019-02-19 04:30:00;NORTE;8;0;8;1
2019-02-19 05:00:00;NORTE;9;0;9;1
2019-02-19 05:30:00;NORTE;15;0;15;1
2019-02-19 06:00:00;NORTE;21;0;21;1
2019-02-19 06:30:00;NORTE;38;0;38;1
2019-02-19 07:00:00;NORTE;25;0;25;1
2019-02-19 07:30:00;NORTE;21;0;21;1
2019-02-19 08:00:00;NORTE;32;0;32;1
2019-02-19 08:30:00;NORTE;32;0;32;1
2019-02-19 09:00:00;NORTE;33;0;33;1
2019-02-19 09:30:00;NORTE;25;0;25;1
2019-02-19 10:00:00;NORTE;23;0;23;1
2019-02-19 10:30:00;NORTE;37;0;37;1
2019-02-19 11:00:00;NORTE;27;0;27;1
2019-02-19 11:30:00;NORTE;23;0;23;1
2019-02-19 12:00:00;NORTE;35;0;35;1
2019-02-19 12:30:00;NORTE;25;0;25;1
2019-02-19 13:00:00;NORTE;34;0;34;1
2019-02-19 13:30:00;NORTE;26;0;26;1
2019-02-19 14:00:00;NORTE;33;0;33;1
2019-02-19 14:30:00;NORTE;28;0;28;1
2019-02-19 15:00:00;NORTE;32;0;32;1
2019-02-19 15:30:00;NORTE;28;0;28;1
2019-02-19 16:00:00;NORTE;25;0;25;1
2019-02-19 16:30:00;NORTE;15;0;15;1
2019-02-19 17:00:00;NORTE;21;0;21;1
2019-02-19 17:30:00;NORTE;36;0;36;1
2019-02-19 18:00:00;NORTE;20;0;20;1
2019-02-19 18:30:00;NORTE;30;0;30;1
2019-02-19 19:00:00;NORTE;38;0;38;1
2019-02-19 19:30:00;NORTE;28;0;28;1
2019-02-19 20:00:00;NORTE;16;0;16;1
2019-02-19 20:30:00;NORTE;30;0;30;1
2019-02-19 21:00:00;NORTE;28;0;28;1
2019-02-19 21:30:00;NORTE;20;0;20;1
2019-02-19 22:00:00;NORTE;8;0;8;1
2019-02-19 22:30:00;NORTE;2;0;2;1
2019-02-19 23:00:00;NORTE;12;0;12;1
2019-02-19 23:30:00;NORTE;2;0;2;1
2019-02-20 01:00:00;NORTE;1;0;1;1
2019-02-20 02:30:00;NORTE;1;0;1;1
2019-02-20 03:00:00;NORTE;2;0;2;1
2019-02-20 03:30:00;NORTE;4;0;4;1
2019-02-20 04:00:00;NORTE;4;0;4;1
2019-02-20 04:30:00;NORTE;8;0;8;1
2019-02-20 05:00:00;NORTE;7;0;7;1
2019-02-20 05:30:00;NORTE;16;0;16;1
2019-02-20 06:00:00;NORTE;19;0;19;1
2019-02-20 06:30:00;NORTE;37;0;37;1
2019-02-20 07:00:00;NORTE;18;0;18;1
2019-02-20 07:30:00;NORTE;23;0;23;1
2019-02-20 08:00:00;NORTE;34;0;34;1
2019-02-20 08:30:00;NORTE;30;0;30;1
2019-02-20 09:00:00;NORTE;38;0;38;1
2019-02-20 09:30:00;NORTE;30;0;30;1
2019-02-20 10:00:00;NORTE;25;0;25;1
2019-02-20 10:30:00;NORTE;41;0;41;1
2019-02-20 11:00:00;NORTE;34;0;34;1
2019-02-20 11:30:00;NORTE;32;0;32;1
2019-02-20 12:00:00;NORTE;21;0;21;1
2019-02-20 12:30:00;NORTE;24;0;24;1
2019-02-20 13:00:00;NORTE;32;0;32;1
2019-02-20 13:30:00;NORTE;33;0;33;1
2019-02-20 14:00:00;NORTE;33;0;33;1
2019-02-20 14:30:00;NORTE;29;0;29;1
2019-02-20 15:00:00;NORTE;37;0;37;1
2019-02-20 15:30:00;NORTE;26;0;26;1
2019-02-20 16:00:00;NORTE;20;0;20;1
2019-02-20 16:30:00;NORTE;12;0;12;1
2019-02-20 17:00:00;NORTE;24;0;24;1
2019-02-20 17:30:00;NORTE;29;0;29;1
2019-02-20 18:00:00;NORTE;20;0;20;1
2019-02-20 18:30:00;NORTE;24;0;24;1
2019-02-20 19:00:00;NORTE;44;0;44;1
2019-02-20 19:30:00;NORTE;28;0;28;1
2019-02-20 20:00:00;NORTE;21;0;21;1
2019-02-20 20:30:00;NORTE;31;0;31;1
2019-02-20 21:00:00;NORTE;31;0;31;1
2019-02-20 21:30:00;NORTE;21;0;21;1
2019-02-20 23:00:00;NORTE;13;0;13;1
2019-02-20 23:30:00;NORTE;2;0;2;1
2019-02-21 01:00:00;NORTE;1;0;1;1
2019-02-21 01:30:00;NORTE;1;0;1;1
2019-02-21 02:30:00;NORTE;2;0;2;1
2019-02-21 03:00:00;NORTE;3;0;3;1
2019-02-21 03:30:00;NORTE;1;0;1;1
2019-02-21 04:00:00;NORTE;4;0;4;1
2019-02-21 04:30:00;NORTE;5;0;5;1
2019-02-21 05:00:00;NORTE;10;0;10;1
2019-02-21 05:30:00;NORTE;13;0;13;1
2019-02-21 06:00:00;NORTE;24;0;24;1
2019-02-21 06:30:00;NORTE;36;0;36;1
2019-02-21 07:00:00;NORTE;21;0;21;1
2019-02-21 07:30:00;NORTE;27;0;27;1
2019-02-21 08:00:00;NORTE;32;0;32;1
2019-02-21 08:30:00;NORTE;32;0;32;1
2019-02-21 09:00:00;NORTE;37;0;37;1
2019-02-21 09:30:00;NORTE;29;0;29;1
2019-02-21 10:00:00;NORTE;24;0;24;1
2019-02-21 10:30:00;NORTE;38;0;38;1
2019-02-21 11:00:00;NORTE;35;0;35;1
2019-02-21 11:30:00;NORTE;32;0;32;1
2019-02-21 12:00:00;NORTE;34;0;34;1
2019-02-21 12:30:00;NORTE;32;0;32;1
2019-02-21 13:00:00;NORTE;25;0;25;1
2019-02-21 13:30:00;NORTE;31;0;31;1
2019-02-21 14:00:00;NORTE;42;0;42;1
2019-02-21 14:30:00;NORTE;27;0;27;1
2019-02-21 15:00:00;NORTE;39;0;39;1
2019-02-21 15:30:00;NORTE;27;0;27;1
2019-02-21 16:00:00;NORTE;23;0;23;1
2019-02-21 16:30:00;NORTE;19;0;19;1
2019-02-21 17:00:00;NORTE;24;0;24;1
2019-02-21 17:30:00;NORTE;34;0;34;1
2019-02-21 18:00:00;NORTE;30;0;30;1
2019-02-21 18:30:00;NORTE;36;0;36;1
2019-02-21 19:00:00;NORTE;36;1;37;1
2019-02-21 19:30:00;NORTE;27;0;27;1
2019-02-21 20:00:00;NORTE;27;0;27;1
2019-02-21 20:30:00;NORTE;25;0;25;1
2019-02-21 21:00:00;NORTE;27;0;27;1
2019-02-21 21:30:00;NORTE;21;0;21;1
2019-02-21 22:00:00;NORTE;12;0;12;1
2019-02-21 22:30:00;NORTE;13;0;13;1
2019-02-21 23:00:00;NORTE;8;0;8;1
2019-02-21 23:30:00;NORTE;4;0;4;1
2019-02-22 00:00:00;NORTE;2;0;2;1
2019-02-22 00:30:00;NORTE;3;0;3;1
2019-02-22 01:00:00;NORTE;1;0;1;1
2019-02-22 01:30:00;NORTE;1;0;1;1
2019-02-22 02:00:00;NORTE;2;0;2;1
2019-02-22 02:30:00;NORTE;1;0;1;1
2019-02-22 03:00:00;NORTE;4;0;4;1
2019-02-22 03:30:00;NORTE;3;0;3;1
2019-02-22 04:00:00;NORTE;5;0;5;1
2019-02-22 04:30:00;NORTE;10;0;10;1
2019-02-22 05:00:00;NORTE;6;0;6;1
2019-02-22 05:30:00;NORTE;16;0;16;1
2019-02-22 06:00:00;NORTE;19;0;19;1
2019-02-22 06:30:00;NORTE;34;0;34;1
2019-02-22 07:00:00;NORTE;19;0;19;1
2019-02-22 07:30:00;NORTE;25;0;25;1
2019-02-22 08:00:00;NORTE;43;0;43;1
2019-02-22 08:30:00;NORTE;35;0;35;1
2019-02-22 09:00:00;NORTE;33;0;33;1
2019-02-22 09:30:00;NORTE;31;0;31;1
2019-02-22 10:00:00;NORTE;30;0;30;1
2019-02-22 10:30:00;NORTE;38;0;38;1
2019-02-22 11:00:00;NORTE;31;1;32;1
2019-02-22 11:30:00;NORTE;34;0;34;1
2019-02-22 12:00:00;NORTE;25;0;25;1
2019-02-22 12:30:00;NORTE;22;0;22;1
2019-02-22 13:00:00;NORTE;28;0;28;1
2019-02-22 13:30:00;NORTE;28;0;28;1
2019-02-22 14:00:00;NORTE;39;0;39;1
2019-02-22 14:30:00;NORTE;34;0;34;1
2019-02-22 15:00:00;NORTE;37;0;37;1
2019-02-22 15:30:00;NORTE;36;0;36;1
2019-02-22 16:00:00;NORTE;25;0;25;1
2019-02-22 16:30:00;NORTE;20;0;20;1
2019-02-22 17:00:00;NORTE;28;0;28;1
2019-02-22 17:30:00;NORTE;29;0;29;1
2019-02-22 18:00:00;NORTE;28;0;28;1
2019-02-22 18:30:00;NORTE;32;0;32;1
2019-02-22 19:00:00;NORTE;41;0;41;1
2019-02-22 19:30:00;NORTE;37;0;37;1
2019-02-22 20:00:00;NORTE;27;0;27;1
2019-02-22 20:30:00;NORTE;34;0;34;1
2019-02-22 21:00:00;NORTE;28;0;28;1
2019-02-22 21:30:00;NORTE;22;0;22;1
2019-02-22 22:00:00;NORTE;11;0;11;1
2019-02-22 22:30:00;NORTE;8;0;8;1
2019-02-22 23:00:00;NORTE;11;0;11;1
2019-02-22 23:30:00;NORTE;2;0;2;1
2019-02-23 01:00:00;NORTE;2;0;2;1
2019-02-23 02:00:00;NORTE;1;0;1;1
2019-02-23 03:00:00;NORTE;2;0;2;1
2019-02-23 03:30:00;NORTE;3;0;3;1
2019-02-23 04:00:00;NORTE;2;0;2;1
2019-02-23 04:30:00;NORTE;4;0;4;1
2019-02-23 05:00:00;NORTE;8;0;8;1
2019-02-23 05:30:00;NORTE;10;0;10;1
2019-02-23 06:00:00;NORTE;25;0;25;1
2019-02-23 06:30:00;NORTE;23;0;23;1
2019-02-23 07:00:00;NORTE;15;0;15;1
2019-02-23 07:30:00;NORTE;21;0;21;1
2019-02-23 08:00:00;NORTE;32;0;32;1
2019-02-23 08:30:00;NORTE;29;0;29;1
2019-02-23 09:00:00;NORTE;37;0;37;1
2019-02-23 09:30:00;NORTE;30;0;30;1
2019-02-23 10:00:00;NORTE;17;0;17;1
2019-02-23 10:30:00;NORTE;36;0;36;1
2019-02-23 11:00:00;NORTE;34;0;34;1
2019-02-23 11:30:00;NORTE;30;0;30;1
2019-02-23 12:00:00;NORTE;29;0;29;1
2019-02-23 12:30:00;NORTE;26;0;26;1
2019-02-23 13:00:00;NORTE;25;0;25;1
2019-02-23 13:30:00;NORTE;28;0;28;1
2019-02-23 14:00:00;NORTE;32;0;32;1
2019-02-23 14:30:00;NORTE;26;0;26;1
2019-02-23 15:00:00;NORTE;32;0;32;1
2019-02-23 15:30:00;NORTE;20;0;20;1
2019-02-23 16:00:00;NORTE;27;0;27;1
2019-02-23 16:30:00;NORTE;22;0;22;1
2019-02-23 17:00:00;NORTE;23;0;23;1
2019-02-23 17:30:00;NORTE;23;0;23;1
2019-02-23 18:00:00;NORTE;14;0;14;1
2019-02-23 18:30:00;NORTE;22;0;22;1
2019-02-23 19:00:00;NORTE;26;0;26;1
2019-02-23 19:30:00;NORTE;16;0;16;1
2019-02-23 20:00:00;NORTE;25;0;25;1
2019-02-23 20:30:00;NORTE;17;0;17;1
2019-02-23 21:00:00;NORTE;22;0;22;1
2019-02-23 21:30:00;NORTE;14;0;14;1
2019-02-23 22:00:00;NORTE;10;0;10;1
2019-02-23 22:30:00;NORTE;9;0;9;1
2019-02-23 23:00:00;NORTE;11;0;11;1
2019-02-23 23:30:00;NORTE;1;0;1;1
2019-02-24 01:00:00;NORTE;1;0;1;1
2019-02-24 01:30:00;NORTE;1;0;1;1
2019-02-24 02:00:00;NORTE;1;0;1;1
2019-02-24 02:30:00;NORTE;1;0;1;1
2019-02-24 03:00:00;NORTE;1;0;1;1
2019-02-24 03:30:00;NORTE;6;0;6;1
2019-02-24 04:00:00;NORTE;3;0;3;1
2019-02-24 04:30:00;NORTE;3;0;3;1
2019-02-24 05:00:00;NORTE;8;0;8;1
2019-02-24 05:30:00;NORTE;12;0;12;1
2019-02-24 06:00:00;NORTE;18;0;18;1
2019-02-24 06:30:00;NORTE;25;0;25;1
2019-02-24 07:00:00;NORTE;12;0;12;1
2019-02-24 07:30:00;NORTE;20;0;20;1
2019-02-24 08:00:00;NORTE;30;0;30;1
2019-02-24 08:30:00;NORTE;30;0;30;1
2019-02-24 09:00:00;NORTE;32;0;32;1
2019-02-24 09:30:00;NORTE;24;0;24;1
2019-02-24 10:00:00;NORTE;23;0;23;1
2019-02-24 10:30:00;NORTE;34;0;34;1
2019-02-24 11:00:00;NORTE;35;0;35;1
2019-02-24 11:30:00;NORTE;34;0;34;1
2019-02-24 12:00:00;NORTE;33;0;33;1
2019-02-24 12:30:00;NORTE;29;0;29;1
2019-02-24 13:00:00;NORTE;28;0;28;1
2019-02-24 13:30:00;NORTE;27;0;27;1
2019-02-24 14:00:00;NORTE;36;0;36;1
2019-02-24 14:30:00;NORTE;32;0;32;1
2019-02-24 15:00:00;NORTE;36;0;36;1
2019-02-24 15:30:00;NORTE;28;0;28;1
2019-02-24 16:00:00;NORTE;22;0;22;1
2019-02-24 16:30:00;NORTE;19;0;19;1
2019-02-24 17:00:00;NORTE;22;0;22;1
2019-02-24 17:30:00;NORTE;31;0;31;1
2019-02-24 18:00:00;NORTE;31;0;31;1
2019-02-24 18:30:00;NORTE;32;0;32;1
2019-02-24 19:00:00;NORTE;40;0;40;1
2019-02-24 19:30:00;NORTE;36;0;36;1
2019-02-24 20:00:00;NORTE;29;0;29;1
2019-02-24 20:30:00;NORTE;30;0;30;1
2019-02-24 21:00:00;NORTE;32;0;32;1
2019-02-24 21:30:00;NORTE;23;0;23;1
2019-02-24 22:00:00;NORTE;13;0;13;1
2019-02-24 22:30:00;NORTE;12;0;12;1
2019-02-24 23:00:00;NORTE;13;0;13;1
2019-02-24 23:30:00;NORTE;4;0;4;1
2019-02-25 00:00:00;NORTE;2;0;2;1
2019-02-25 00:30:00;NORTE;1;0;1;1
2019-02-25 01:00:00;NORTE;2;0;2;1
2019-02-25 01:30:00;NORTE;1;0;1;1
2019-02-25 02:30:00;NORTE;1;0;1;1
2019-02-25 03:00:00;NORTE;4;0;4;1
2019-02-25 03:30:00;NORTE;1;0;1;1
2019-02-25 04:00:00;NORTE;2;0;2;1
2019-02-25 04:30:00;NORTE;3;0;3;1
2019-02-25 05:00:00;NORTE;10;0;10;1
2019-02-25 05:30:00;NORTE;17;0;17;1
2019-02-25 06:00:00;NORTE;16;0;16;1
2019-02-25 06:30:00;NORTE;40;0;40;1
2019-02-25 07:00:00;NORTE;24;0;24;1
2019-02-25 07:30:00;NORTE;31;0;31;1
2019-02-25 08:00:00;NORTE;29;0;29;1
2019-02-25 08:30:00;NORTE;28;0;28;1
2019-02-25 09:00:00;NORTE;38;0;38;1
2019-02-25 09:30:00;NORTE;34;0;34;1
2019-02-25 10:00:00;NORTE;23;0;23;1
2019-02-25 10:30:00;NORTE;45;0;45;1
2019-02-25 11:00:00;NORTE;28;0;28;1
2019-02-25 11:30:00;NORTE;31;0;31;1
2019-02-25 12:00:00;NORTE;25;0;25;1
2019-02-25 12:30:00;NORTE;28;0;28;1
2019-02-25 13:00:00;NORTE;34;0;34;1
2019-02-25 13:30:00;NORTE;33;0;33;1
2019-02-25 14:00:00;NORTE;40;0;40;1
2019-02-25 14:30:00;NORTE;32;0;32;1
2019-02-25 15:00:00;NORTE;29;0;29;1
2019-02-25 15:30:00;NORTE;32;0;32;1
2019-02-25 16:00:00;NORTE;20;0;20;1
2019-02-25 16:30:00;NORTE;22;0;22;1
2019-02-25 17:00:00;NORTE;23;0;23;1
2019-02-25 17:30:00;NORTE;32;0;32;1
2019-02-25 18:00:00;NORTE;26;0;26;1
2019-02-25 18:30:00;NORTE;33;0;33;1
2019-02-25 19:00:00;NORTE;34;0;34;1
2019-02-25 19:30:00;NORTE;27;0;27;1
2019-02-25 20:00:00;NORTE;23;0;23;1
2019-02-25 20:30:00;NORTE;30;0;30;1
2019-02-25 21:00:00;NORTE;30;0;30;1
2019-02-25 21:30:00;NORTE;22;0;22;1
2019-02-25 22:00:00;NORTE;10;0;10;1
2019-02-25 22:30:00;NORTE;8;0;8;1
2019-02-25 23:00:00;NORTE;9;0;9;1
2019-02-25 23:30:00;NORTE;2;0;2;1
2019-02-26 01:30:00;NORTE;2;0;2;1
2019-02-26 02:30:00;NORTE;1;0;1;1
2019-02-26 03:00:00;NORTE;2;0;2;1
2019-02-26 03:30:00;NORTE;3;0;3;1
2019-02-26 04:00:00;NORTE;1;0;1;1
2019-02-26 04:30:00;NORTE;8;0;8;1
2019-02-26 05:00:00;NORTE;13;0;13;1
2019-02-26 05:30:00;NORTE;13;1;14;1
2019-02-26 06:00:00;NORTE;18;0;18;1
2019-02-26 06:30:00;NORTE;35;0;35;1
2019-02-26 07:00:00;NORTE;26;0;26;1
2019-02-26 07:30:00;NORTE;22;0;22;1
2019-02-26 08:00:00;NORTE;35;0;35;1
2019-02-26 08:30:00;NORTE;34;0;34;1
2019-02-26 09:00:00;NORTE;34;0;34;1
2019-02-26 09:30:00;NORTE;29;0;29;1
2019-02-26 10:00:00;NORTE;19;0;19;1
2019-02-26 10:30:00;NORTE;40;0;40;1
2019-02-26 11:00:00;NORTE;27;0;27;1
2019-02-26 11:30:00;NORTE;31;0;31;1
2019-02-26 12:00:00;NORTE;30;0;30;1
2019-02-26 12:30:00;NORTE;27;0;27;1
2019-02-26 13:00:00;NORTE;30;0;30;1
2019-02-26 13:30:00;NORTE;26;0;26;1
2019-02-26 14:00:00;NORTE;33;0;33;1
2019-02-26 14:30:00;NORTE;26;0;26;1
2019-02-26 15:00:00;NORTE;39;0;39;1
2019-02-26 15:30:00;NORTE;28;0;28;1
2019-02-26 16:00:00;CONFLICTIVA;6;18;24;2
2019-02-26 16:30:00;SUR;0;18;18;1
2019-02-26 17:00:00;SUR;0;21;21;1
2019-02-26 17:30:00;SUR;0;29;29;1
2019-02-26 18:00:00;SUR;0;32;32;1
2019-02-26 18:30:00;CONFLICTIVA;24;3;27;2
2019-02-26 19:00:00;NORTE;38;0;38;1
2019-02-26 19:30:00;NORTE;23;0;23;1
2019-02-26 20:00:00;NORTE;23;0;23;1
2019-02-26 20:30:00;NORTE;27;0;27;1
2019-02-26 21:00:00;NORTE;31;0;31;1
2019-02-26 21:30:00;NORTE;17;0;17;1
2019-02-26 22:00:00;NORTE;10;0;10;1
2019-02-26 22:30:00;NORTE;7;0;7;1
2019-02-26 23:00:00;NORTE;10;0;10;1
2019-02-26 23:30:00;NORTE;2;0;2;1
2019-02-27 00:00:00;NORTE;2;0;2;1
2019-02-27 01:30:00;NORTE;1;0;1;1
2019-02-27 02:00:00;NORTE;1;0;1;1
2019-02-27 02:30:00;NORTE;1;0;1;1
2019-02-27 03:00:00;NORTE;3;0;3;1
2019-02-27 03:30:00;NORTE;2;0;2;1
2019-02-27 04:00:00;NORTE;7;0;7;1
2019-02-27 04:30:00;NORTE;7;0;7;1
2019-02-27 05:00:00;NORTE;6;0;6;1
2019-02-27 05:30:00;NORTE;18;0;18;1
2019-02-27 06:00:00;NORTE;20;0;20;1
2019-02-27 06:30:00;NORTE;41;0;41;1
2019-02-27 07:00:00;NORTE;22;0;22;1
2019-02-27 07:30:00;NORTE;25;0;25;1
2019-02-27 08:00:00;NORTE;33;0;33;1
2019-02-27 08:30:00;NORTE;31;0;31;1
2019-02-27 09:00:00;NORTE;38;0;38;1
2019-02-27 09:30:00;NORTE;31;0;31;1
2019-02-27 10:00:00;NORTE;24;0;24;1
2019-02-27 10:30:00;NORTE;45;0;45;1
2019-02-27 11:00:00;NORTE;30;0;30;1
2019-02-27 11:30:00;NORTE;30;0;30;1
2019-02-27 12:00:00;NORTE;30;0;30;1
2019-02-27 12:30:00;NORTE;30;0;30;1
2019-02-27 13:00:00;NORTE;30;0;30;1
2019-02-27 13:30:00;NORTE;26;0;26;1
2019-02-27 14:00:00;NORTE;38;0;38;1
2019-02-27 14:30:00;NORTE;31;0;31;1
2019-02-27 15:00:00;NORTE;34;0;34;1
2019-02-27 15:30:00;NORTE;27;0;27;1
2019-02-27 16:00:00;NORTE;24;0;24;1
2019-02-27 16:30:00;NORTE;14;0;14;1
2019-02-27 17:00:00;NORTE;29;0;29;1
2019-02-27 17:30:00;NORTE;31;0;31;1
2019-02-27 18:01:44;NORTE;1;0;1;1
2019-02-27 18:01:51;NORTE;1;0;1;1
2019-02-27 18:03:14;NORTE;1;0;1;1
2019-02-27 18:04:44;NORTE;1;0;1;1
2019-02-27 18:05:19;NORTE;1;0;1;1
2019-02-27 18:08:18;NORTE;1;0;1;1
2019-02-27 18:09:30;NORTE;1;0;1;1
2019-02-27 18:10:38;NORTE;1;0;1;1
2019-02-27 18:12:14;NORTE;1;0;1;1
2019-02-27 18:12:59;NORTE;1;0;1;1
2019-02-27 18:13:44;NORTE;1;0;1;1
2019-02-27 18:15:05;NORTE;1;0;1;1
2019-02-27 18:16:22;NORTE;1;0;1;1
2019-02-27 18:17:10;NORTE;1;0;1;1
2019-02-27 18:18:33;NORTE;1;0;1;1
2019-02-27 18:19:33;NORTE;1;0;1;1
2019-02-27 18:19:54;NORTE;1;0;1;1
2019-02-27 18:22:43;NORTE;1;0;1;1
2019-02-27 18:22:55;NORTE;1;0;1;1
2019-02-27 18:23:07;NORTE;1;0;1;1
2019-02-27 18:25:28;NORTE;1;0;1;1
2019-02-27 18:27:31;NORTE;1;0;1;1
2019-02-27 18:29:27;NORTE;1;0;1;1
2019-02-27 18:30:00;NORTE;31;0;31;1
2019-02-27 19:00:00;NORTE;43;0;43;1
2019-02-27 19:30:00;NORTE;28;0;28;1
2019-02-27 20:00:00;NORTE;18;0;18;1
2019-02-27 20:30:00;NORTE;34;0;34;1
2019-02-27 21:00:00;NORTE;31;0;31;1
2019-02-27 21:30:00;NORTE;26;0;26;1
2019-02-27 22:00:00;NORTE;11;0;11;1
2019-02-27 22:30:00;NORTE;10;0;10;1
2019-02-27 23:00:00;NORTE;8;0;8;1
2019-02-27 23:30:00;NORTE;3;0;3;1
2019-02-28 00:00:00;NORTE;2;0;2;1
2019-02-28 00:30:00;NORTE;1;0;1;1
2019-02-28 01:00:00;NORTE;2;0;2;1
2019-02-28 01:30:00;NORTE;1;0;1;1
2019-02-28 02:30:00;NORTE;1;0;1;1
2019-02-28 03:30:00;NORTE;3;0;3;1
2019-02-28 04:00:00;NORTE;5;0;5;1
2019-02-28 04:30:00;CONFLICTIVA;5;1;6;2
2019-02-28 05:00:00;NORTE;10;0;10;1
2019-02-28 05:30:00;NORTE;13;0;13;1
2019-02-28 06:00:00;NORTE;23;0;23;1
2019-02-28 06:30:00;NORTE;36;0;36;1
2019-02-28 07:00:00;NORTE;21;0;21;1
2019-02-28 07:30:00;NORTE;20;0;20;1
2019-02-28 08:00:00;NORTE;35;0;35;1
2019-02-28 08:30:00;NORTE;22;0;22;1
2019-02-28 09:00:00;NORTE;37;0;37;1
2019-02-28 09:30:00;NORTE;35;0;35;1
2019-02-28 10:00:00;NORTE;27;0;27;1
2019-02-28 10:30:00;NORTE;38;0;38;1
2019-02-28 11:00:00;NORTE;34;0;34;1
2019-02-28 11:30:00;NORTE;31;0;31;1
2019-02-28 12:00:00;NORTE;37;0;37;1
2019-02-28 12:30:00;NORTE;24;0;24;1
2019-02-28 13:00:00;NORTE;31;0;31;1
2019-02-28 13:30:00;NORTE;34;0;34;1
2019-02-28 14:00:00;NORTE;38;0;38;1
2019-02-28 14:30:00;NORTE;29;0;29;1
2019-02-28 15:00:29;NORTE;1;0;1;1
2019-02-28 15:00:33;NORTE;1;0;1;1
2019-02-28 15:02:03;NORTE;1;0;1;1
2019-02-28 15:03:06;NORTE;1;0;1;1
2019-02-28 15:03:42;NORTE;1;0;1;1
2019-02-28 15:04:00;NORTE;1;0;1;1
2019-02-28 15:05:40;NORTE;1;0;1;1
2019-02-28 15:06:09;NORTE;1;0;1;1
2019-02-28 15:06:55;NORTE;1;0;1;1
2019-02-28 15:08:22;NORTE;1;0;1;1
2019-02-28 15:08:42;NORTE;1;0;1;1
2019-02-28 15:08:43;NORTE;1;0;1;1
2019-02-28 15:09:43;NORTE;1;0;1;1
2019-02-28 15:11:14;NORTE;1;0;1;1
2019-02-28 15:11:39;NORTE;1;0;1;1
2019-02-28 15:13:19;NORTE;1;0;1;1
2019-02-28 15:13:43;NORTE;1;0;1;1
2019-02-28 15:15:08;NORTE;1;0;1;1
2019-02-28 15:15:44;NORTE;1;0;1;1
2019-02-28 15:16:27;NORTE;1;0;1;1
2019-02-28 15:17:29;NORTE;1;0;1;1
2019-02-28 15:18:01;NORTE;1;0;1;1
2019-02-28 15:18:41;NORTE;1;0;1;1
2019-02-28 15:19:37;NORTE;1;0;1;1
2019-02-28 15:19:39;NORTE;1;0;1;1
2019-02-28 15:20:35;NORTE;1;0;1;1
2019-02-28 15:20:56;NORTE;1;0;1;1
2019-02-28 15:22:27;NORTE;1;0;1;1
2019-02-28 15:22:56;NORTE;1;0;1;1
2019-02-28 15:23:02;NORTE;1;0;1;1
2019-02-28 15:24:33;NORTE;1;0;1;1
2019-02-28 15:25:08;NORTE;1;0;1;1
2019-02-28 15:27:35;NORTE;1;0;1;1
2019-02-28 15:28:00;NORTE;1;0;1;1
2019-02-28 15:30:00;NORTE;38;0;38;1
2019-02-28 16:00:00;NORTE;24;0;24;1
2019-02-28 16:30:00;NORTE;18;0;18;1
2019-02-28 17:00:00;NORTE;23;0;23;1
2019-02-28 17:30:00;NORTE;31;0;31;1
2019-02-28 18:00:00;NORTE;33;0;33;1
2019-02-28 18:30:00;NORTE;36;0;36;1
2019-02-28 19:00:00;NORTE;41;0;41;1
2019-02-28 19:30:00;NORTE;32;0;32;1
2019-02-28 20:00:00;NORTE;27;0;27;1
2019-02-28 20:30:00;NORTE;31;0;31;1
2019-02-28 21:00:00;NORTE;30;0;30;1
2019-02-28 21:30:00;NORTE;23;0;23;1
2019-02-28 22:00:00;NORTE;8;0;8;1
2019-02-28 22:30:00;NORTE;10;0;10;1
2019-02-28 23:00:00;NORTE;11;0;11;1
2019-02-28 23:30:00;NORTE;9;0;9;1
2019-03-01 01:00:00;NORTE;2;0;2;1
2019-03-01 01:30:00;NORTE;2;0;2;1
2019-03-01 02:00:00;NORTE;1;0;1;1
2019-03-01 02:30:00;NORTE;2;0;2;1
2019-03-01 03:00:00;NORTE;3;0;3;1
2019-03-01 03:30:00;NORTE;4;0;4;1
2019-03-01 04:00:00;NORTE;4;0;4;1
2019-03-01 04:30:00;NORTE;8;0;8;1
2019-03-01 05:00:00;NORTE;6;0;6;1
2019-03-01 05:30:00;NORTE;14;0;14;1
2019-03-01 06:00:00;NORTE;15;0;15;1
2019-03-01 06:30:00;NORTE;32;0;32;1
2019-03-01 07:00:00;NORTE;23;0;23;1
2019-03-01 07:30:00;NORTE;26;0;26;1
2019-03-01 08:00:00;NORTE;34;0;34;1
2019-03-01 08:30:00;NORTE;23;0;23;1
2019-03-01 09:00:00;NORTE;25;0;25;1
2019-03-01 09:30:00;NORTE;27;0;27;1
2019-03-01 10:00:00;NORTE;34;0;34;1
2019-03-01 10:30:00;NORTE;34;0;34;1
2019-03-01 11:00:00;NORTE;35;0;35;1
2019-03-01 11:30:00;NORTE;37;0;37;1
2019-03-01 12:00:00;NORTE;27;0;27;1
2019-03-01 12:30:00;NORTE;28;0;28;1
2019-03-01 13:00:00;NORTE;25;0;25;1
2019-03-01 13:30:00;NORTE;20;0;20;1
2019-03-01 14:00:00;NORTE;39;0;39;1
2019-03-01 14:30:00;NORTE;33;0;33;1
2019-03-01 15:00:00;NORTE;44;0;44;1
2019-03-01 15:30:00;NORTE;41;0;41;1
2019-03-01 16:00:00;NORTE;30;0;30;1
2019-03-01 16:30:00;NORTE;25;0;25;1
2019-03-01 17:00:00;NORTE;24;0;24;1
2019-03-01 17:30:00;CONFLICTIVA;16;7;23;2
2019-03-01 18:00:00;SUR;0;31;31;1
2019-03-01 18:30:00;SUR;0;33;33;1
2019-03-01 19:00:00;SUR;0;28;28;1
2019-03-01 19:30:00;SUR;0;26;26;1
2019-03-01 20:00:00;SUR;0;34;34;1
2019-03-01 20:30:00;SUR;0;33;33;1
2019-03-01 21:00:00;SUR;0;27;27;1
2019-03-01 21:30:00;SUR;0;32;32;1
2019-03-01 22:00:00;CONFLICTIVA;4;7;11;2
2019-03-01 22:30:00;NORTE;12;0;12;1
2019-03-01 23:00:00;NORTE;15;0;15;1
2019-03-01 23:30:00;NORTE;6;0;6;1
2019-03-02 00:30:00;NORTE;3;0;3;1
2019-03-02 01:30:00;NORTE;1;0;1;1
2019-03-02 02:30:00;NORTE;1;0;1;1
2019-03-02 03:00:00;NORTE;2;0;2;1
2019-03-02 03:30:00;NORTE;3;0;3;1
2019-03-02 04:00:00;NORTE;3;0;3;1
2019-03-02 04:30:00;NORTE;3;0;3;1
2019-03-02 05:00:00;NORTE;10;0;10;1
2019-03-02 05:30:00;NORTE;15;0;15;1
2019-03-02 06:00:00;NORTE;18;0;18;1
2019-03-02 06:30:00;NORTE;29;0;29;1
2019-03-02 07:00:00;NORTE;14;0;14;1
2019-03-02 07:30:00;NORTE;18;0;18;1
2019-03-02 08:00:00;NORTE;38;0;38;1
2019-03-02 08:30:00;CONFLICTIVA;3;17;20;2
2019-03-02 09:00:00;SUR;0;37;37;1
2019-03-02 09:30:00;SUR;0;31;31;1
2019-03-02 10:00:00;SUR;0;24;24;1
2019-03-02 10:30:00;NORTE;36;1;37;1
2019-03-02 11:00:00;NORTE;39;0;39;1
2019-03-02 11:30:00;NORTE;28;0;28;1
2019-03-02 12:00:00;CONFLICTIVA;20;3;23;2
2019-03-02 12:30:00;SUR;0;31;31;1
2019-03-02 13:00:00;SUR;0;25;25;1
2019-03-02 13:30:00;SUR;0;32;32;1
2019-03-02 14:00:00;SUR;0;32;32;1
2019-03-02 14:30:00;NORTE;20;2;22;1
2019-03-02 15:00:00;NORTE;39;0;39;1
2019-03-02 15:30:00;NORTE;28;0;28;1
2019-03-02 16:00:00;NORTE;25;0;25;1
2019-03-02 16:30:00;NORTE;15;0;15;1
2019-03-02 17:00:00;NORTE;20;0;20;1
2019-03-02 17:30:00;NORTE;25;0;25;1
2019-03-02 18:00:00;NORTE;20;0;20;1
2019-03-02 18:30:00;NORTE;20;0;20;1
2019-03-02 19:00:00;NORTE;35;0;35;1
2019-03-02 19:30:00;NORTE;17;0;17;1
2019-03-02 20:00:00;NORTE;19;0;19;1
2019-03-02 20:30:00;NORTE;22;0;22;1
2019-03-02 21:00:00;NORTE;17;0;17;1
2019-03-02 21:30:00;CONFLICTIVA;10;5;15;2
2019-03-02 22:00:00;SUR;0;9;9;1
2019-03-02 22:30:00;NORTE;3;0;3;1
2019-03-02 23:00:00;NORTE;11;0;11;1
2019-03-02 23:30:00;NORTE;2;0;2;1
2019-03-03 00:00:00;NORTE;1;0;1;1
2019-03-03 01:30:00;NORTE;2;0;2;1
2019-03-03 02:00:00;NORTE;1;0;1;1
2019-03-03 03:00:00;NORTE;1;0;1;1
2019-03-03 03:30:00;NORTE;1;0;1;1
2019-03-03 05:00:00;NORTE;5;0;5;1
2019-03-03 05:30:00;NORTE;12;0;12;1
2019-03-03 06:00:00;NORTE;14;0;14;1
2019-03-03 06:30:00;NORTE;22;0;22;1
2019-03-03 07:00:00;NORTE;2;0;2;1
2019-03-03 07:30:00;NORTE;17;0;17;1
2019-03-03 08:00:00;NORTE;21;0;21;1
2019-03-03 08:30:00;SUR;0;18;18;1
2019-03-03 09:00:00;SUR;0;20;20;1
2019-03-03 09:30:00;SUR;0;12;12;1
2019-03-03 10:00:00;SUR;0;14;14;1
2019-03-03 10:30:00;SUR;0;21;21;1
2019-03-03 11:00:00;SUR;0;15;15;1
2019-03-03 11:30:00;SUR;0;14;14;1
2019-03-03 12:00:00;SUR;0;20;20;1
2019-03-03 12:30:00;SUR;0;18;18;1
2019-03-03 13:00:00;SUR;0;21;21;1
2019-03-03 13:30:00;SUR;0;18;18;1
2019-03-03 14:00:00;SUR;0;18;18;1
2019-03-03 14:30:00;SUR;0;17;17;1
2019-03-03 15:00:00;SUR;0;16;16;1
2019-03-03 15:30:00;SUR;0;17;17;1
2019-03-03 16:00:00;SUR;0;19;19;1
2019-03-03 16:30:00;SUR;0;22;22;1
2019-03-03 17:00:00;SUR;0;17;17;1
2019-03-03 17:30:00;CONFLICTIVA;11;7;18;2
2019-03-03 18:00:00;NORTE;33;0;33;1
2019-03-03 18:30:00;NORTE;23;0;23;1
2019-03-03 19:00:00;NORTE;26;0;26;1
2019-03-03 19:30:00;NORTE;16;0;16;1
2019-03-03 20:00:00;NORTE;22;0;22;1
2019-03-03 20:30:00;NORTE;15;0;15;1
2019-03-03 21:00:00;SUR;0;23;23;1
2019-03-03 21:30:00;SUR;0;20;20;1
2019-03-03 22:00:00;SUR;0;15;15;1
2019-03-03 22:30:00;SUR;0;4;4;1
2019-03-03 23:00:00;SUR;0;4;4;1
2019-03-03 23:30:00;SUR;0;5;5;1
2019-03-04 01:30:00;SUR;0;1;1;1
2019-03-04 05:00:00;SUR;0;1;1;1
2019-03-04 05:30:00;SUR;0;2;2;1
2019-03-04 06:00:00;SUR;0;4;4;1
2019-03-04 06:30:00;SUR;0;6;6;1
2019-03-04 07:00:00;SUR;0;7;7;1
2019-03-04 07:30:00;CONFLICTIVA;7;1;8;2
2019-03-04 08:00:00;CONFLICTIVA;4;6;10;2
2019-03-04 08:30:00;SUR;0;11;11;1
2019-03-04 09:00:00;SUR;0;25;25;1
2019-03-04 09:30:00;SUR;0;33;33;1
2019-03-04 10:00:00;SUR;0;29;29;1
2019-03-04 10:30:00;CONFLICTIVA;23;9;32;2
2019-03-04 11:00:00;NORTE;36;0;36;1
2019-03-04 11:30:00;NORTE;37;0;37;1
2019-03-04 12:00:00;CONFLICTIVA;5;15;20;2
2019-03-04 12:30:00;SUR;0;34;34;1
2019-03-04 13:00:00;SUR;0;31;31;1
2019-03-04 13:30:00;SUR;0;29;29;1
2019-03-04 14:00:00;SUR;0;29;29;1
2019-03-04 14:30:00;SUR;0;26;26;1
2019-03-04 15:00:00;SUR;0;24;24;1
2019-03-04 15:30:00;SUR;0;29;29;1
2019-03-04 16:00:00;SUR;0;31;31;1
2019-03-04 16:30:00;SUR;0;27;27;1
2019-03-04 17:00:00;SUR;0;25;25;1
2019-03-04 17:30:00;SUR;0;32;32;1
2019-03-04 18:00:00;SUR;0;31;31;1
2019-03-04 18:30:00;SUR;0;32;32;1
2019-03-04 19:00:00;SUR;0;33;33;1
2019-03-04 19:30:00;CONFLICTIVA;16;9;25;2
2019-03-04 20:00:00;NORTE;37;0;37;1
2019-03-04 20:30:00;NORTE;24;0;24;1
2019-03-04 21:00:00;NORTE;27;0;27;1
2019-03-04 21:30:00;NORTE;30;0;30;1
2019-03-04 22:00:00;NORTE;20;0;20;1
2019-03-04 22:30:00;NORTE;13;0;13;1
2019-03-04 23:00:00;NORTE;23;0;23;1
2019-03-04 23:30:00;NORTE;8;0;8;1
2019-03-05 00:00:00;NORTE;4;0;4;1
2019-03-05 00:30:00;NORTE;1;0;1;1
2019-03-05 01:30:00;NORTE;1;0;1;1
2019-03-05 02:30:00;NORTE;1;0;1;1
2019-03-05 03:00:00;NORTE;4;0;4;1
2019-03-05 03:30:00;CONFLICTIVA;1;3;4;2
2019-03-05 04:00:00;SUR;0;2;2;1
2019-03-05 04:30:00;CONFLICTIVA;3;3;6;2
2019-03-05 05:00:00;NORTE;12;0;12;1
2019-03-05 05:30:00;NORTE;14;0;14;1
2019-03-05 06:00:00;NORTE;25;0;25;1
2019-03-05 06:30:00;NORTE;40;0;40;1
2019-03-05 07:00:00;NORTE;20;0;20;1
2019-03-05 07:30:00;NORTE;20;0;20;1
2019-03-05 08:00:00;CONFLICTIVA;23;7;30;2
2019-03-05 08:30:00;SUR;0;35;35;1
2019-03-05 09:00:00;SUR;0;43;43;1
2019-03-05 09:30:00;SUR;0;31;31;1
2019-03-05 10:00:00;SUR;0;24;24;1
2019-03-05 10:30:00;SUR;0;27;27;1
2019-03-05 11:00:00;SUR;0;26;26;1
2019-03-05 11:30:00;SUR;0;29;29;1
2019-03-05 12:00:00;SUR;0;30;30;1
2019-03-05 12:30:00;SUR;0;32;32;1
2019-03-05 13:00:00;SUR;0;35;35;1
2019-03-05 13:30:00;SUR;0;35;35;1
2019-03-05 14:00:00;SUR;0;37;37;1
2019-03-05 14:30:00;SUR;0;21;21;1
2019-03-05 15:00:00;SUR;0;23;23;1
2019-03-05 15:30:00;SUR;0;26;26;1
2019-03-05 16:00:00;SUR;0;30;30;1
2019-03-05 16:30:00;SUR;0;27;27;1
2019-03-05 17:00:00;SUR;0;27;27;1
2019-03-05 17:30:00;SUR;0;28;28;1
2019-03-05 18:00:00;SUR;0;32;32;1
2019-03-05 18:30:00;SUR;0;24;24;1
2019-03-05 19:00:00;SUR;0;34;34;1
2019-03-05 19:30:00;SUR;0;31;31;1
2019-03-05 20:00:00;SUR;0;24;24;1
2019-03-05 20:30:00;SUR;0;27;27;1
2019-03-05 21:00:00;SUR;0;27;27;1
2019-03-05 21:30:00;SUR;0;17;17;1
2019-03-05 22:00:00;SUR;0;17;17;1
2019-03-05 22:30:00;SUR;0;13;13;1
2019-03-05 23:00:00;SUR;0;13;13;1
2019-03-05 23:30:00;SUR;0;9;9;1
2019-03-06 00:00:00;SUR;0;3;3;1
2019-03-06 01:30:00;SUR;0;2;2;1
2019-03-06 02:30:00;SUR;0;1;1;1
2019-03-06 03:00:00;SUR;0;5;5;1
2019-03-06 03:30:00;SUR;0;2;2;1
2019-03-06 04:00:00;SUR;0;2;2;1
2019-03-06 04:30:00;SUR;0;9;9;1
2019-03-06 05:00:00;SUR;0;11;11;1
2019-03-06 05:30:00;SUR;0;15;15;1
2019-03-06 06:00:00;SUR;0;17;17;1
2019-03-06 06:30:00;SUR;0;22;22;1
2019-03-06 07:00:00;SUR;0;27;27;1
2019-03-06 07:30:00;SUR;0;27;27;1
2019-03-06 08:00:00;SUR;0;37;37;1
2019-03-06 08:30:00;SUR;0;25;25;1
2019-03-06 09:00:00;SUR;0;15;15;1
2019-03-06 09:13:00;SUR;0;19;19;1
2019-03-06 09:30:00;SUR;0;32;32;1
2019-03-06 10:00:00;SUR;0;36;36;1
2019-03-06 10:30:00;SUR;0;31;31;1
2019-03-06 11:00:00;SUR;0;29;29;1
2019-03-06 11:30:00;SUR;0;27;27;1
2019-03-06 12:00:00;SUR;0;34;34;1
2019-03-06 12:30:00;SUR;0;34;34;1
2019-03-06 13:00:00;SUR;0;14;14;1
2019-03-06 13:14:00;SUR;0;2;2;1
2019-03-06 13:17:00;SUR;0;12;12;1
2019-03-06 13:30:00;SUR;0;28;28;1
2019-03-06 14:00:00;SUR;0;21;21;1
2019-03-06 14:17:00;SUR;0;11;11;1
2019-03-06 14:30:00;SUR;0;28;28;1
2019-03-06 15:00:00;SUR;0;23;23;1
2019-03-06 15:30:00;SUR;0;25;25;1
2019-03-06 16:00:00;SUR;0;24;24;1
2019-03-06 16:30:00;SUR;0;22;22;1
2019-03-06 17:00:00;SUR;0;25;25;1
2019-03-06 17:30:00;SUR;0;23;23;1
2019-03-06 18:00:00;SUR;0;37;37;1
2019-03-06 18:30:00;NORTE;32;1;33;1
2019-03-06 19:00:00;NORTE;34;0;34;1
2019-03-06 19:30:00;NORTE;25;2;27;1
2019-03-06 20:00:00;SUR;0;30;30;1
2019-03-06 20:30:00;SUR;0;28;28;1
2019-03-06 21:00:00;SUR;0;35;35;1
2019-03-06 21:30:00;SUR;0;27;27;1
2019-03-06 22:00:00;SUR;0;23;23;1
2019-03-06 22:30:00;SUR;0;19;19;1
2019-03-06 23:00:00;SUR;0;23;23;1
2019-03-06 23:30:00;SUR;0;7;7;1
2019-03-07 00:00:00;NORTE;3;0;3;1
2019-03-07 00:30:00;NORTE;2;0;2;1
2019-03-07 01:00:00;NORTE;1;0;1;1
2019-03-07 01:30:00;NORTE;2;0;2;1
2019-03-07 03:00:00;NORTE;1;0;1;1
2019-03-07 03:30:00;NORTE;2;0;2;1
2019-03-07 04:00:00;NORTE;3;0;3;1
2019-03-07 04:30:00;NORTE;6;0;6;1
2019-03-07 05:00:00;NORTE;10;0;10;1
2019-03-07 05:30:00;NORTE;15;0;15;1
2019-03-07 06:00:00;NORTE;24;0;24;1
2019-03-07 06:30:00;NORTE;36;0;36;1
2019-03-07 07:00:00;NORTE;15;0;15;1
2019-03-07 07:30:00;NORTE;30;0;30;1
2019-03-07 08:00:00;NORTE;29;0;29;1
2019-03-07 08:30:00;SUR;2;26;28;1
2019-03-07 09:00:00;SUR;0;37;37;1
2019-03-07 09:30:00;SUR;0;32;32;1
2019-03-07 10:00:00;SUR;1;26;27;1
2019-03-07 10:30:00;NORTE;36;0;36;1
2019-03-07 11:00:00;NORTE;37;0;37;1
2019-03-07 11:30:00;NORTE;28;0;28;1
2019-03-07 12:00:00;SUR;0;30;30;1
2019-03-07 12:30:00;SUR;0;28;28;1
2019-03-07 13:00:00;SUR;0;26;26;1
2019-03-07 13:30:00;SUR;0;34;34;1
2019-03-07 14:00:00;SUR;0;27;27;1
2019-03-07 14:30:00;SUR;0;27;27;1
2019-03-07 15:00:00;SUR;0;24;24;1
2019-03-07 15:30:00;SUR;0;26;26;1
2019-03-07 16:00:00;SUR;0;33;33;1
2019-03-07 16:30:00;SUR;0;29;29;1
2019-03-07 17:00:00;SUR;0;32;32;1
2019-03-07 17:30:00;SUR;0;22;22;1
2019-03-07 18:00:00;SUR;0;25;25;1
2019-03-07 18:30:00;SUR;0;32;32;1
2019-03-07 19:00:00;SUR;0;33;33;1
2019-03-07 19:30:00;SUR;0;33;33;1
2019-03-07 20:00:00;SUR;0;30;30;1
2019-03-07 20:30:00;SUR;0;33;33;1
2019-03-07 21:00:00;SUR;0;31;31;1
2019-03-07 21:30:00;SUR;0;28;28;1
2019-03-07 22:00:00;CONFLICTIVA;3;15;18;2
2019-03-07 22:30:00;NORTE;15;0;15;1
2019-03-07 23:00:00;NORTE;12;0;12;1
2019-03-07 23:30:00;NORTE;9;0;9;1
2019-03-08 00:00:00;NORTE;1;0;1;1
2019-03-08 01:00:00;NORTE;1;0;1;1
2019-03-08 01:30:00;NORTE;1;0;1;1
2019-03-08 02:00:00;NORTE;2;0;2;1
2019-03-08 03:00:00;NORTE;3;0;3;1
2019-03-08 03:30:00;NORTE;2;0;2;1
2019-03-08 04:00:00;NORTE;6;0;6;1
2019-03-08 04:30:00;NORTE;9;0;9;1
2019-03-08 05:00:00;NORTE;9;0;9;1
2019-03-08 05:30:00;NORTE;16;0;16;1
2019-03-08 06:00:00;NORTE;17;0;17;1
2019-03-08 06:30:00;NORTE;35;0;35;1
2019-03-08 07:00:00;NORTE;24;0;24;1
2019-03-08 07:30:00;CONFLICTIVA;7;10;17;2
2019-03-08 08:00:00;SUR;0;36;36;1
2019-03-08 08:30:00;SUR;0;32;32;1
2019-03-08 09:00:00;SUR;0;39;39;1
2019-03-08 09:30:00;CONFLICTIVA;20;7;27;2
2019-03-08 10:00:00;NORTE;26;0;26;1
2019-03-08 10:30:00;NORTE;38;0;38;1
2019-03-08 11:00:00;NORTE;33;0;33;1
2019-03-08 11:30:00;NORTE;35;0;35;1
2019-03-08 12:00:00;CONFLICTIVA;3;23;26;2
2019-03-08 12:30:00;SUR;0;25;25;1
2019-03-08 13:00:00;SUR;0;27;27;1
2019-03-08 13:30:00;SUR;0;28;28;1
2019-03-08 14:00:00;SUR;0;28;28;1
2019-03-08 14:30:00;NORTE;31;1;32;1
2019-03-08 15:00:00;NORTE;38;0;38;1
2019-03-08 15:30:00;NORTE;35;0;35;1
2019-03-08 16:00:00;NORTE;28;0;28;1
2019-03-08 16:30:00;NORTE;20;0;20;1
2019-03-08 17:00:00;SUR;0;29;29;1
2019-03-08 17:30:00;SUR;0;27;27;1
2019-03-08 18:00:00;SUR;0;33;33;1
2019-03-08 18:30:00;SUR;0;32;32;1
2019-03-08 19:00:00;SUR;0;33;33;1
2019-03-08 19:30:00;SUR;0;31;31;1
2019-03-08 20:00:00;SUR;0;33;33;1
2019-03-08 20:30:00;SUR;0;28;28;1
2019-03-08 21:00:00;NORTE;28;1;29;1
2019-03-08 21:30:00;NORTE;24;0;24;1
2019-03-08 22:00:00;NORTE;19;0;19;1
2019-03-08 22:30:00;NORTE;10;0;10;1
2019-03-08 23:00:00;NORTE;11;0;11;1
2019-03-08 23:30:00;NORTE;5;0;5;1
2019-03-09 00:00:00;NORTE;2;0;2;1
2019-03-09 00:30:00;NORTE;1;0;1;1
2019-03-09 01:00:00;NORTE;1;0;1;1
2019-03-09 02:30:00;NORTE;1;0;1;1
2019-03-09 03:00:00;NORTE;1;0;1;1
2019-03-09 03:30:00;NORTE;4;0;4;1
2019-03-09 04:00:00;NORTE;2;0;2;1
2019-03-09 04:30:00;NORTE;3;0;3;1
2019-03-09 05:00:00;NORTE;12;0;12;1
2019-03-09 05:30:00;NORTE;12;0;12;1
2019-03-09 06:00:00;NORTE;25;0;25;1
2019-03-09 06:30:00;NORTE;27;0;27;1
2019-03-09 07:00:00;NORTE;14;0;14;1
2019-03-09 07:30:00;CONFLICTIVA;3;15;18;2
2019-03-09 08:00:00;SUR;0;29;29;1
2019-03-09 08:30:00;SUR;0;34;34;1
2019-03-09 09:00:00;SUR;0;34;34;1
2019-03-09 09:30:00;SUR;0;38;38;1
2019-03-09 10:00:00;CONFLICTIVA;8;10;18;2
2019-03-09 10:30:00;NORTE;39;0;39;1
2019-03-09 11:00:00;NORTE;36;0;36;1
2019-03-09 11:30:00;NORTE;35;0;35;1
2019-03-09 12:00:00;CONFLICTIVA;14;5;19;2
2019-03-09 12:30:00;SUR;0;30;30;1
2019-03-09 13:00:00;SUR;0;24;24;1
2019-03-09 13:30:00;SUR;0;26;26;1
2019-03-09 14:00:00;SUR;0;33;33;1
2019-03-09 14:30:00;CONFLICTIVA;27;5;32;2
2019-03-09 15:00:00;NORTE;36;0;36;1
2019-03-09 15:30:00;NORTE;27;0;27;1
2019-03-09 16:00:00;NORTE;24;0;24;1
2019-03-09 16:30:00;NORTE;13;0;13;1
2019-03-09 17:00:00;NORTE;29;0;29;1
2019-03-09 17:30:00;NORTE;26;0;26;1
2019-03-09 18:00:00;NORTE;13;0;13;1
2019-03-09 18:30:00;NORTE;24;0;24;1
2019-03-09 19:00:00;NORTE;32;0;32;1
2019-03-09 19:30:00;NORTE;19;0;19;1
2019-03-09 20:00:00;NORTE;10;0;10;1
2019-03-09 20:30:00;NORTE;22;0;22;1
2019-03-09 21:00:00;NORTE;16;0;16;1
2019-03-09 21:30:00;NORTE;16;0;16;1
2019-03-09 22:00:00;NORTE;9;0;9;1
2019-03-09 22:30:00;NORTE;8;0;8;1
2019-03-09 23:00:00;NORTE;9;0;9;1
2019-03-09 23:30:00;NORTE;3;0;3;1
2019-03-10 00:00:00;NORTE;1;0;1;1
2019-03-10 00:30:00;NORTE;1;0;1;1
2019-03-10 01:30:00;NORTE;1;0;1;1
2019-03-10 02:00:00;NORTE;1;0;1;1
2019-03-10 02:30:00;NORTE;1;0;1;1
2019-03-10 03:00:00;NORTE;1;0;1;1
2019-03-10 03:30:00;NORTE;5;0;5;1
2019-03-10 04:00:00;NORTE;3;0;3;1
2019-03-10 04:30:00;NORTE;3;0;3;1
2019-03-10 05:00:00;NORTE;10;0;10;1
2019-03-10 05:30:00;NORTE;11;0;11;1
2019-03-10 06:00:00;NORTE;20;0;20;1
2019-03-10 06:30:00;NORTE;20;0;20;1
2019-03-10 07:00:00;NORTE;10;0;10;1
2019-03-10 07:30:00;NORTE;23;0;23;1
2019-03-10 08:00:00;CONFLICTIVA;17;9;26;2
2019-03-10 08:30:00;SUR;0;28;28;1
2019-03-10 09:00:00;SUR;0;34;34;1
2019-03-10 09:30:00;SUR;0;28;28;1
2019-03-10 10:00:00;NORTE;28;0;28;1
2019-03-10 10:30:00;NORTE;39;0;39;1
2019-03-10 11:00:00;NORTE;28;0;28;1
2019-03-10 11:30:00;NORTE;36;0;36;1
2019-03-10 12:00:00;SUR;0;24;24;1
2019-03-10 12:30:00;SUR;0;31;31;1
2019-03-10 13:00:00;CONFLICTIVA;12;6;18;2
2019-03-10 13:30:00;NORTE;25;0;25;1
2019-03-10 14:00:00;NORTE;31;0;31;1
2019-03-10 14:30:00;NORTE;41;0;41;1
2019-03-10 15:00:00;NORTE;39;0;39;1
2019-03-10 15:30:00;NORTE;19;0;19;1
2019-03-10 16:00:00;NORTE;20;0;20;1
2019-03-10 16:30:00;CONFLICTIVA;7;8;15;2
2019-03-10 17:00:00;SUR;0;27;27;1
2019-03-10 17:30:00;SUR;0;33;33;1
2019-03-10 18:00:00;CONFLICTIVA;13;8;21;2
2019-03-10 18:30:00;NORTE;36;0;36;1
2019-03-10 19:00:00;NORTE;32;0;32;1
2019-03-10 19:30:00;NORTE;33;0;33;1
2019-03-10 20:00:00;NORTE;26;0;26;1
2019-03-10 20:30:00;NORTE;30;0;30;1
2019-03-10 21:00:00;NORTE;32;0;32;1
2019-03-10 21:30:00;NORTE;29;0;29;1
2019-03-10 22:00:00;NORTE;17;0;17;1
2019-03-10 22:30:00;NORTE;18;0;18;1
2019-03-10 23:00:00;NORTE;20;0;20;1
2019-03-10 23:30:00;NORTE;5;0;5;1
2019-03-11 00:00:00;NORTE;5;0;5;1
2019-03-11 00:30:00;NORTE;1;0;1;1
2019-03-11 01:00:00;NORTE;1;0;1;1
2019-03-11 01:30:00;NORTE;2;0;2;1
2019-03-11 02:30:00;NORTE;1;0;1;1
2019-03-11 03:00:00;NORTE;1;0;1;1
2019-03-11 03:30:00;NORTE;3;0;3;1
2019-03-11 04:00:00;NORTE;2;0;2;1
2019-03-11 04:30:00;NORTE;6;0;6;1
2019-03-11 05:00:00;NORTE;10;0;10;1
2019-03-11 05:30:00;NORTE;19;0;19;1
2019-03-11 06:00:00;NORTE;21;0;21;1
2019-03-11 06:30:00;NORTE;37;0;37;1
2019-03-11 07:00:00;NORTE;23;0;23;1
2019-03-11 07:30:00;NORTE;21;0;21;1
2019-03-11 08:00:00;NORTE;37;0;37;1
2019-03-11 08:30:00;SUR;1;28;29;1
2019-03-11 09:00:00;SUR;0;31;31;1
2019-03-11 09:30:00;SUR;0;36;36;1
2019-03-11 10:00:00;CONFLICTIVA;18;8;26;2
2019-03-11 10:30:00;NORTE;40;1;41;1
2019-03-11 11:00:00;NORTE;33;0;33;1
2019-03-11 11:30:00;NORTE;31;0;31;1
2019-03-11 12:00:00;NORTE;20;0;20;1
2019-03-11 12:30:00;NORTE;25;0;25;1
2019-03-11 13:00:00;NORTE;23;0;23;1
2019-03-11 13:30:00;NORTE;25;0;25;1
2019-03-11 14:00:00;NORTE;38;0;38;1
2019-03-11 14:30:00;NORTE;37;0;37;1
2019-03-11 15:00:00;NORTE;38;0;38;1
2019-03-11 15:30:00;NORTE;36;0;36;1
2019-03-11 16:00:00;NORTE;29;0;29;1
2019-03-11 16:30:00;SUR;0;22;22;1
2019-03-11 17:00:00;SUR;0;24;24;1
2019-03-11 17:30:00;SUR;0;36;36;1
2019-03-11 18:00:00;SUR;0;27;27;1
2019-03-11 18:30:00;SUR;0;28;28;1
2019-03-11 19:00:00;SUR;0;37;37;1
2019-03-11 19:30:00;SUR;0;31;31;1
2019-03-11 20:00:00;SUR;0;28;28;1
2019-03-11 20:30:00;SUR;0;27;27;1
2019-03-11 21:00:00;SUR;0;31;31;1
2019-03-11 21:30:00;SUR;0;23;23;1
2019-03-11 22:00:00;NORTE;20;0;20;1
2019-03-11 22:30:00;NORTE;10;0;10;1
2019-03-11 23:00:00;NORTE;12;0;12;1
2019-03-11 23:30:00;NORTE;2;0;2;1
2019-03-12 00:00:00;NORTE;2;0;2;1
2019-03-12 01:30:00;NORTE;1;0;1;1
2019-03-12 02:30:00;NORTE;3;0;3;1
2019-03-12 03:00:00;NORTE;5;0;5;1
2019-03-12 03:30:00;NORTE;3;0;3;1
2019-03-12 04:00:00;NORTE;2;0;2;1
2019-03-12 04:30:00;NORTE;8;0;8;1
2019-03-12 05:00:00;NORTE;15;0;15;1
2019-03-12 05:30:00;NORTE;15;0;15;1
2019-03-12 06:00:00;NORTE;24;0;24;1
2019-03-12 06:30:00;NORTE;41;0;41;1
2019-03-12 07:00:00;NORTE;18;0;18;1
2019-03-12 07:30:00;CONFLICTIVA;11;7;18;2
2019-03-12 08:00:00;SUR;0;35;35;1
2019-03-12 08:30:00;SUR;0;32;32;1
2019-03-12 09:00:00;SUR;0;37;37;1
2019-03-12 09:30:00;SUR;0;29;29;1
2019-03-12 10:00:00;CONFLICTIVA;7;14;21;2
2019-03-12 10:30:00;NORTE;36;0;36;1
2019-03-12 11:00:00;NORTE;41;0;41;1
2019-03-12 11:30:00;NORTE;28;0;28;1
2019-03-12 12:00:00;CONFLICTIVA;3;21;24;2
2019-03-12 12:30:00;SUR;0;25;25;1
2019-03-12 13:00:00;SUR;0;25;25;1
2019-03-12 13:30:00;SUR;0;27;27;1
2019-03-12 14:00:00;SUR;0;32;32;1
2019-03-12 14:30:00;SUR;0;27;27;1
2019-03-12 15:00:00;SUR;0;28;28;1
2019-03-12 15:30:00;SUR;0;26;26;1
2019-03-12 16:00:00;SUR;0;32;32;1
2019-03-12 16:30:00;SUR;0;27;27;1
2019-03-12 17:00:00;SUR;0;25;25;1
2019-03-12 17:30:00;SUR;0;30;30;1
2019-03-12 18:00:00;SUR;2;23;25;1
2019-03-12 18:30:00;NORTE;33;0;33;1
2019-03-12 19:00:00;NORTE;39;0;39;1
2019-03-12 19:30:00;NORTE;25;0;25;1
2019-03-12 20:00:00;CONFLICTIVA;14;5;19;2
2019-03-12 20:30:00;SUR;0;28;28;1
2019-03-12 21:00:00;SUR;0;26;26;1
2019-03-12 21:30:00;SUR;0;22;22;1
2019-03-12 22:00:00;CONFLICTIVA;5;9;14;2
2019-03-12 22:30:00;NORTE;17;0;17;1
2019-03-12 23:00:00;NORTE;14;0;14;1
2019-03-12 23:30:00;NORTE;6;0;6;1
2019-03-13 00:00:00;NORTE;1;0;1;1
2019-03-13 01:00:00;NORTE;1;0;1;1
2019-03-13 02:30:00;NORTE;1;0;1;1
2019-03-13 03:00:00;NORTE;1;0;1;1
2019-03-13 03:30:00;NORTE;3;0;3;1
2019-03-13 04:00:00;NORTE;3;0;3;1
2019-03-13 04:30:00;NORTE;8;0;8;1
2019-03-13 05:00:00;NORTE;10;0;10;1
2019-03-13 05:30:00;NORTE;12;0;12;1
2019-03-13 06:00:00;NORTE;22;0;22;1
2019-03-13 06:30:00;NORTE;41;0;41;1
2019-03-13 07:00:00;NORTE;21;0;21;1
2019-03-13 07:30:00;NORTE;21;0;21;1
2019-03-13 08:00:00;NORTE;38;0;38;1
2019-03-13 08:30:00;NORTE;26;1;27;1
2019-03-13 09:00:00;NORTE;32;0;32;1
2019-03-13 09:30:00;NORTE;26;0;26;1
2019-03-13 10:00:00;NORTE;28;0;28;1
2019-03-13 10:30:00;NORTE;43;0;43;1
2019-03-13 11:00:00;NORTE;37;0;37;1
2019-03-13 11:30:00;NORTE;32;0;32;1
2019-03-13 12:00:00;NORTE;29;0;29;1
2019-03-13 12:30:00;NORTE;21;0;21;1
2019-03-13 13:00:00;NORTE;24;0;24;1
2019-03-13 13:30:00;NORTE;25;0;25;1
2019-03-13 14:00:00;NORTE;38;0;38;1
2019-03-13 14:30:00;NORTE;31;0;31;1
2019-03-13 15:00:00;NORTE;39;0;39;1
2019-03-13 15:30:00;NORTE;36;0;36;1
2019-03-13 16:00:00;NORTE;26;0;26;1
2019-03-13 16:30:00;NORTE;18;0;18;1
2019-03-13 17:00:00;NORTE;23;0;23;1
2019-03-13 17:30:00;NORTE;26;0;26;1
2019-03-13 18:00:00;NORTE;26;0;26;1
2019-03-13 18:30:00;NORTE;28;0;28;1
2019-03-13 19:00:00;NORTE;37;0;37;1
2019-03-13 19:30:00;NORTE;27;0;27;1
2019-03-13 20:00:00;CONFLICTIVA;11;11;22;2
2019-03-13 20:30:00;SUR;0;29;29;1
2019-03-13 21:00:00;CONFLICTIVA;12;14;26;2
2019-03-13 21:30:00;NORTE;24;0;24;1
2019-03-13 22:00:00;NORTE;16;0;16;1
2019-03-13 22:30:00;NORTE;14;0;14;1
2019-03-13 23:00:00;NORTE;10;0;10;1
2019-03-13 23:30:00;NORTE;3;0;3;1
2019-03-14 00:00:00;NORTE;1;0;1;1
2019-03-14 00:30:00;NORTE;1;0;1;1
2019-03-14 01:00:00;NORTE;2;0;2;1
2019-03-14 01:30:00;NORTE;1;0;1;1
2019-03-14 02:30:00;NORTE;3;0;3;1
2019-03-14 03:00:00;NORTE;1;0;1;1
2019-03-14 03:30:00;NORTE;2;0;2;1
2019-03-14 04:00:00;NORTE;2;0;2;1
2019-03-14 04:30:00;NORTE;6;0;6;1
2019-03-14 05:00:00;NORTE;10;0;10;1
2019-03-14 05:30:00;NORTE;17;0;17;1
2019-03-14 06:00:00;NORTE;19;0;19;1
2019-03-14 06:30:00;NORTE;36;0;36;1
2019-03-14 07:00:00;NORTE;17;0;17;1
2019-03-14 07:30:00;CONFLICTIVA;13;2;15;2
2019-03-14 08:00:00;SUR;0;34;34;1
2019-03-14 08:30:00;SUR;0;37;37;1
2019-03-14 09:00:00;SUR;0;34;34;1
2019-03-14 09:30:00;SUR;0;35;35;1
2019-03-14 10:00:00;NORTE;18;0;18;1
2019-03-14 10:30:00;NORTE;39;0;39;1
2019-03-14 11:00:00;NORTE;44;0;44;1
2019-03-14 11:30:00;NORTE;21;0;21;1
2019-03-14 12:00:00;CONFLICTIVA;19;6;25;2
2019-03-14 12:30:00;SUR;0;34;34;1
2019-03-14 13:00:00;SUR;0;26;26;1
2019-03-14 13:30:00;SUR;0;32;32;1
2019-03-14 14:00:00;CONFLICTIVA;10;16;26;2
2019-03-14 14:30:00;NORTE;35;0;35;1
2019-03-14 15:00:00;NORTE;41;0;41;1
2019-03-14 15:30:00;NORTE;34;0;34;1
2019-03-14 16:00:00;NORTE;24;0;24;1
2019-03-14 16:30:00;CONFLICTIVA;7;11;18;2
2019-03-14 17:00:00;SUR;0;26;26;1
2019-03-14 17:30:00;SUR;0;31;31;1
2019-03-14 18:00:00;SUR;0;28;28;1
2019-03-14 18:30:00;SUR;0;28;28;1
2019-03-14 19:00:00;SUR;0;33;33;1
2019-03-14 19:30:00;SUR;0;32;32;1
2019-03-14 20:00:00;SUR;0;32;32;1
2019-03-14 20:30:00;SUR;0;28;28;1
2019-03-14 21:00:00;SUR;0;29;29;1
2019-03-14 21:30:00;SUR;1;21;22;1
2019-03-14 22:00:00;NORTE;19;0;19;1
2019-03-14 22:30:00;NORTE;14;0;14;1
2019-03-14 23:00:00;NORTE;13;0;13;1
2019-03-14 23:30:00;NORTE;2;0;2;1
2019-03-15 00:00:00;NORTE;1;0;1;1
2019-03-15 01:00:00;NORTE;2;0;2;1
2019-03-15 01:30:00;NORTE;2;0;2;1
2019-03-15 02:00:00;NORTE;1;0;1;1
2019-03-15 03:00:00;NORTE;2;0;2;1
2019-03-15 03:30:00;NORTE;3;0;3;1
2019-03-15 04:00:00;NORTE;6;0;6;1
2019-03-15 04:30:00;NORTE;5;0;5;1
2019-03-15 05:00:00;NORTE;11;0;11;1
2019-03-15 05:30:00;NORTE;19;0;19;1
2019-03-15 06:00:00;NORTE;20;0;20;1
2019-03-15 06:30:00;NORTE;29;0;29;1
2019-03-15 07:00:00;NORTE;21;0;21;1
2019-03-15 07:30:00;NORTE;26;0;26;1
2019-03-15 08:00:00;CONFLICTIVA;21;9;30;2
2019-03-15 08:30:00;SUR;0;33;33;1
2019-03-15 09:00:00;SUR;0;39;39;1
2019-03-15 09:30:00;SUR;0;38;38;1
2019-03-15 10:00:00;CONFLICTIVA;9;14;23;2
2019-03-15 10:30:00;NORTE;40;0;40;1
2019-03-15 11:00:00;NORTE;33;0;33;1
2019-03-15 11:30:00;NORTE;30;0;30;1
2019-03-15 12:00:00;SUR;1;25;26;1
2019-03-15 12:30:00;SUR;0;24;24;1
2019-03-15 13:00:00;SUR;0;29;29;1
2019-03-15 13:30:00;SUR;0;29;29;1
2019-03-15 14:00:00;SUR;0;27;27;1
2019-03-15 14:30:00;CONFLICTIVA;3;21;24;2
2019-03-15 15:00:00;NORTE;40;0;40;1
2019-03-15 15:30:00;NORTE;40;0;40;1
2019-03-15 16:00:00;CONFLICTIVA;17;7;24;2
2019-03-15 16:30:00;SUR;0;28;28;1
2019-03-15 17:00:00;SUR;0;25;25;1
2019-03-15 17:30:00;SUR;0;31;31;1
2019-03-15 18:00:00;SUR;0;23;23;1
2019-03-15 18:30:00;SUR;0;37;37;1
2019-03-15 19:00:00;SUR;0;37;37;1
2019-03-15 19:30:00;SUR;0;27;27;1
2019-03-15 20:00:00;SUR;0;33;33;1
2019-03-15 20:30:00;SUR;0;31;31;1
2019-03-15 21:00:00;SUR;0;30;30;1
2019-03-15 21:30:00;SUR;0;24;24;1
2019-03-15 22:00:00;NORTE;15;0;15;1
2019-03-15 22:30:00;NORTE;15;0;15;1
2019-03-15 23:00:00;NORTE;9;0;9;1
2019-03-15 23:30:00;NORTE;3;0;3;1
2019-03-16 00:00:00;NORTE;2;0;2;1
2019-03-16 00:30:00;NORTE;1;0;1;1
2019-03-16 01:00:00;NORTE;1;0;1;1
2019-03-16 03:00:00;NORTE;3;0;3;1
2019-03-16 03:30:00;NORTE;2;0;2;1
2019-03-16 04:00:00;NORTE;1;0;1;1
2019-03-16 04:30:00;NORTE;3;0;3;1
2019-03-16 05:00:00;NORTE;11;0;11;1
2019-03-16 05:30:00;NORTE;21;0;21;1
2019-03-16 06:00:00;NORTE;23;0;23;1
2019-03-16 06:30:00;NORTE;24;0;24;1
2019-03-16 07:00:00;NORTE;10;0;10;1
2019-03-16 07:30:00;CONFLICTIVA;8;6;14;2
2019-03-16 08:00:00;SUR;0;35;35;1
2019-03-16 08:30:00;SUR;0;39;39;1
2019-03-16 09:00:00;SUR;0;34;34;1
2019-03-16 09:30:00;SUR;0;33;33;1
2019-03-16 10:00:00;CONFLICTIVA;11;10;21;2
2019-03-16 10:30:00;NORTE;39;0;39;1
2019-03-16 11:00:00;NORTE;32;0;32;1
2019-03-16 11:30:00;CONFLICTIVA;16;9;25;2
2019-03-16 12:00:00;SUR;0;29;29;1
2019-03-16 12:30:00;SUR;0;21;21;1
2019-03-16 13:00:00;SUR;0;30;30;1
2019-03-16 13:30:00;SUR;0;31;31;1
2019-03-16 14:00:00;SUR;0;24;24;1
2019-03-16 14:30:00;SUR;0;22;22;1
2019-03-16 15:00:00;SUR;0;22;22;1
2019-03-16 15:30:00;SUR;0;20;20;1
2019-03-16 16:00:00;SUR;0;24;24;1
2019-03-16 16:30:00;SUR;0;25;25;1
2019-03-16 17:00:00;SUR;0;28;28;1
2019-03-16 17:30:00;SUR;0;24;24;1
2019-03-16 18:00:00;CONFLICTIVA;2;14;16;2
2019-03-16 18:30:00;NORTE;21;0;21;1
2019-03-16 19:00:00;NORTE;31;0;31;1
2019-03-16 19:30:00;CONFLICTIVA;17;2;19;2
2019-03-16 20:00:00;SUR;0;14;14;1
2019-03-16 20:30:00;SUR;0;20;20;1
2019-03-16 21:00:00;SUR;0;18;18;1
2019-03-16 21:30:00;SUR;0;21;21;1
2019-03-16 22:00:00;CONFLICTIVA;12;2;14;2
2019-03-16 22:30:00;NORTE;6;0;6;1
2019-03-16 23:00:00;NORTE;12;0;12;1
2019-03-16 23:30:00;NORTE;3;0;3;1
2019-03-17 00:00:00;NORTE;1;0;1;1
2019-03-17 00:30:00;NORTE;1;0;1;1
2019-03-17 02:00:00;NORTE;4;0;4;1
2019-03-17 02:30:00;NORTE;3;0;3;1
2019-03-17 03:30:00;NORTE;4;0;4;1
2019-03-17 04:00:00;NORTE;5;0;5;1
2019-03-17 04:30:00;NORTE;3;0;3;1
2019-03-17 05:00:00;NORTE;8;0;8;1
2019-03-17 05:30:00;NORTE;13;0;13;1
2019-03-17 06:00:00;NORTE;19;0;19;1
2019-03-17 06:30:00;NORTE;18;0;18;1
2019-03-17 07:00:00;NORTE;14;0;14;1
2019-03-17 07:30:00;CONFLICTIVA;11;2;13;2
2019-03-17 08:00:00;SUR;0;25;25;1
2019-03-17 08:30:00;SUR;0;32;32;1
2019-03-17 09:00:00;SUR;0;30;30;1
2019-03-17 09:30:00;SUR;0;30;30;1
2019-03-17 10:00:00;NORTE;24;0;24;1
2019-03-17 10:30:00;NORTE;33;0;33;1
2019-03-17 11:00:00;NORTE;35;0;35;1
2019-03-17 11:30:00;NORTE;33;1;34;1
2019-03-17 12:00:00;NORTE;27;0;27;1
2019-03-17 12:30:00;NORTE;19;0;19;1
2019-03-17 13:00:00;NORTE;23;0;23;1
2019-03-17 13:30:00;NORTE;23;0;23;1
2019-03-17 14:00:00;NORTE;29;1;30;1
2019-03-17 14:30:00;NORTE;36;0;36;1
2019-03-17 15:00:00;NORTE;39;0;39;1
2019-03-17 15:30:00;NORTE;38;0;38;1
2019-03-17 16:00:00;NORTE;28;0;28;1
2019-03-17 16:30:00;NORTE;21;0;21;1
2019-03-17 17:00:00;NORTE;23;0;23;1
2019-03-17 17:30:00;NORTE;27;0;27;1
2019-03-17 18:00:00;NORTE;28;0;28;1
2019-03-17 18:30:00;NORTE;32;0;32;1
2019-03-17 19:00:00;NORTE;41;0;41;1
2019-03-17 19:30:00;NORTE;32;0;32;1
2019-03-17 20:00:00;NORTE;30;0;30;1
2019-03-17 20:30:00;NORTE;32;0;32;1
2019-03-17 21:00:00;NORTE;35;0;35;1
2019-03-17 21:30:00;NORTE;20;0;20;1
2019-03-17 22:00:00;NORTE;22;0;22;1
2019-03-17 22:30:00;NORTE;15;0;15;1
2019-03-17 23:00:00;NORTE;14;0;14;1
2019-03-17 23:30:00;NORTE;8;0;8;1
2019-03-18 00:00:00;NORTE;1;0;1;1
2019-03-18 00:30:00;NORTE;3;0;3;1
2019-03-18 01:30:00;NORTE;1;0;1;1
2019-03-18 02:00:00;NORTE;1;0;1;1
2019-03-18 02:30:00;NORTE;1;0;1;1
2019-03-18 03:00:00;NORTE;4;0;4;1
2019-03-18 03:30:00;NORTE;4;0;4;1
2019-03-18 04:00:00;NORTE;2;0;2;1
2019-03-18 04:30:00;NORTE;5;0;5;1
2019-03-18 05:00:00;NORTE;9;0;9;1
2019-03-18 05:30:00;NORTE;14;0;14;1
2019-03-18 06:00:00;NORTE;21;0;21;1
2019-03-18 06:30:00;NORTE;28;0;28;1
2019-03-18 07:00:00;NORTE;29;0;29;1
2019-03-18 07:30:00;NORTE;23;0;23;1
2019-03-18 08:00:00;NORTE;41;0;41;1
2019-03-18 08:30:00;NORTE;27;0;27;1
2019-03-18 09:00:00;NORTE;35;0;35;1
2019-03-18 09:30:00;NORTE;30;0;30;1
2019-03-18 10:00:00;NORTE;20;0;20;1
2019-03-18 10:30:00;NORTE;41;0;41;1
2019-03-18 11:00:00;NORTE;37;0;37;1
2019-03-18 11:30:00;NORTE;34;0;34;1
2019-03-18 12:00:00;NORTE;24;0;24;1
2019-03-18 12:30:00;NORTE;25;0;25;1
2019-03-18 13:00:00;NORTE;24;0;24;1
2019-03-18 13:30:00;NORTE;23;0;23;1
2019-03-18 14:00:00;NORTE;31;0;31;1
2019-03-18 14:30:00;NORTE;39;0;39;1
2019-03-18 15:00:00;NORTE;46;0;46;1
2019-03-18 15:30:00;NORTE;33;0;33;1
2019-03-18 16:00:00;NORTE;26;0;26;1
2019-03-18 16:30:00;NORTE;20;0;20;1
2019-03-18 17:00:00;CONFLICTIVA;3;18;21;2
2019-03-18 17:30:00;SUR;0;31;31;1
2019-03-18 18:00:00;SUR;0;29;29;1
2019-03-18 18:30:00;CONFLICTIVA;21;5;26;2
2019-03-18 19:00:00;NORTE;35;0;35;1
2019-03-18 19:30:00;NORTE;32;0;32;1
2019-03-18 20:00:00;NORTE;28;0;28;1
2019-03-18 20:30:00;NORTE;30;0;30;1
2019-03-18 21:00:00;NORTE;27;0;27;1
2019-03-18 21:30:00;NORTE;24;0;24;1
2019-03-18 22:00:00;NORTE;21;0;21;1
2019-03-18 22:30:00;NORTE;8;0;8;1
2019-03-18 23:00:00;NORTE;14;0;14;1
2019-03-18 23:30:00;NORTE;4;0;4;1
2019-03-19 00:30:00;NORTE;1;0;1;1
2019-03-19 02:00:00;NORTE;1;0;1;1
2019-03-19 02:30:00;NORTE;2;0;2;1
2019-03-19 03:00:00;NORTE;1;0;1;1
2019-03-19 03:30:00;NORTE;4;0;4;1
2019-03-19 04:00:00;NORTE;4;0;4;1
2019-03-19 04:30:00;NORTE;5;0;5;1
2019-03-19 05:00:00;NORTE;10;0;10;1
2019-03-19 05:30:00;NORTE;17;0;17;1
2019-03-19 06:00:00;NORTE;22;0;22;1
2019-03-19 06:30:00;NORTE;34;0;34;1
2019-03-19 07:00:00;NORTE;26;0;26;1
2019-03-19 07:30:00;NORTE;13;0;13;1
2019-03-19 08:00:00;NORTE;32;0;32;1
2019-03-19 08:30:00;SUR;2;21;23;1
2019-03-19 09:00:00;SUR;0;37;37;1
2019-03-19 09:30:00;SUR;0;31;31;1
2019-03-19 10:00:00;CONFLICTIVA;15;9;24;2
2019-03-19 10:30:00;NORTE;38;0;38;1
2019-03-19 11:00:00;NORTE;34;0;34;1
2019-03-19 11:30:00;NORTE;32;0;32;1
2019-03-19 12:00:00;NORTE;20;0;20;1
2019-03-19 12:30:00;NORTE;25;0;25;1
2019-03-19 13:00:00;NORTE;17;0;17;1
2019-03-19 13:30:00;NORTE;26;0;26;1
2019-03-19 14:00:00;NORTE;32;0;32;1
2019-03-19 14:30:00;NORTE;34;0;34;1
2019-03-19 15:00:00;NORTE;39;0;39;1
2019-03-19 15:30:00;NORTE;32;0;32;1
2019-03-19 16:00:00;NORTE;33;0;33;1
2019-03-19 16:30:00;NORTE;25;0;25;1
2019-03-19 17:00:00;NORTE;21;0;21;1
2019-03-19 17:30:00;NORTE;30;0;30;1
2019-03-19 18:00:00;NORTE;28;0;28;1
2019-03-19 18:30:00;NORTE;27;0;27;1
2019-03-19 19:00:00;NORTE;31;0;31;1
2019-03-19 19:30:00;NORTE;25;0;25;1
2019-03-19 20:00:00;NORTE;19;0;19;1
2019-03-19 20:30:00;NORTE;26;0;26;1
2019-03-19 21:00:00;NORTE;27;0;27;1
2019-03-19 21:30:00;NORTE;21;0;21;1
2019-03-19 22:00:00;NORTE;18;0;18;1
2019-03-19 22:30:00;NORTE;6;0;6;1
2019-03-19 23:00:00;NORTE;14;0;14;1
2019-03-19 23:30:00;NORTE;1;0;1;1
2019-03-20 00:00:00;NORTE;1;0;1;1
2019-03-20 01:30:00;NORTE;1;0;1;1
2019-03-20 02:30:00;NORTE;1;0;1;1
2019-03-20 03:00:00;NORTE;2;0;2;1
2019-03-20 03:30:00;NORTE;2;0;2;1
2019-03-20 04:00:00;NORTE;4;0;4;1
2019-03-20 04:30:00;NORTE;6;0;6;1
2019-03-20 05:00:00;NORTE;8;0;8;1
2019-03-20 05:30:00;NORTE;20;0;20;1
2019-03-20 06:00:00;NORTE;19;0;19;1
2019-03-20 06:30:00;NORTE;35;0;35;1
2019-03-20 07:00:00;NORTE;20;0;20;1
2019-03-20 07:30:00;NORTE;23;0;23;1
2019-03-20 08:00:00;NORTE;37;0;37;1
2019-03-20 08:30:00;NORTE;30;0;30;1
2019-03-20 09:00:00;NORTE;30;0;30;1
2019-03-20 09:30:00;NORTE;26;0;26;1
2019-03-20 10:00:00;NORTE;28;0;28;1
2019-03-20 10:30:00;NORTE;38;0;38;1
2019-03-20 11:00:00;NORTE;38;0;38;1
2019-03-20 11:30:00;NORTE;34;0;34;1
2019-03-20 12:00:00;NORTE;30;0;30;1
2019-03-20 12:30:00;NORTE;26;0;26;1
2019-03-20 13:00:00;NORTE;21;0;21;1
2019-03-20 13:30:00;NORTE;29;0;29;1
2019-03-20 14:00:00;NORTE;37;0;37;1
2019-03-20 14:30:00;NORTE;36;0;36;1
2019-03-20 15:00:00;NORTE;31;0;31;1
2019-03-20 15:30:00;NORTE;26;0;26;1
2019-03-20 16:00:00;NORTE;29;0;29;1
2019-03-20 16:30:00;NORTE;16;0;16;1
2019-03-20 17:00:00;NORTE;20;0;20;1
2019-03-20 17:30:00;NORTE;29;0;29;1
2019-03-20 18:00:00;NORTE;28;0;28;1
2019-03-20 18:30:00;NORTE;28;0;28;1
2019-03-20 19:00:00;NORTE;32;0;32;1
2019-03-20 19:30:00;CONFLICTIVA;4;25;29;2
2019-03-20 20:00:00;SUR;0;20;20;1
2019-03-20 20:30:00;CONFLICTIVA;3;19;22;2
2019-03-20 21:00:00;NORTE;31;0;31;1
2019-03-20 21:30:00;NORTE;27;0;27;1
2019-03-20 22:00:00;NORTE;22;0;22;1
2019-03-20 22:30:00;NORTE;12;0;12;1
2019-03-20 23:00:00;NORTE;9;0;9;1
2019-03-20 23:30:00;NORTE;5;0;5;1
2019-03-21 00:30:00;NORTE;2;0;2;1
2019-03-21 01:30:00;NORTE;1;0;1;1
2019-03-21 02:00:00;NORTE;2;0;2;1
2019-03-21 02:30:00;NORTE;1;0;1;1
2019-03-21 03:00:00;NORTE;3;0;3;1
2019-03-21 03:30:00;NORTE;2;0;2;1
2019-03-21 04:00:00;NORTE;5;0;5;1
2019-03-21 04:30:00;NORTE;7;0;7;1
2019-03-21 05:00:00;NORTE;9;0;9;1
2019-03-21 05:30:00;NORTE;16;0;16;1
2019-03-21 06:00:00;NORTE;23;0;23;1
2019-03-21 06:30:00;NORTE;35;0;35;1
2019-03-21 07:00:00;NORTE;23;0;23;1
2019-03-21 07:30:00;NORTE;20;0;20;1
2019-03-21 08:00:00;CONFLICTIVA;26;5;31;2
2019-03-21 08:30:00;SUR;0;36;36;1
2019-03-21 09:00:00;SUR;0;37;37;1
2019-03-21 09:30:00;SUR;0;30;30;1
2019-03-21 10:00:00;CONFLICTIVA;9;9;18;2
2019-03-21 10:30:00;NORTE;37;0;37;1
2019-03-21 11:00:00;NORTE;39;0;39;1
2019-03-21 11:30:00;NORTE;28;0;28;1
2019-03-21 12:00:00;CONFLICTIVA;3;14;17;2
2019-03-21 12:30:00;SUR;0;30;30;1
2019-03-21 13:00:00;SUR;0;35;35;1
2019-03-21 13:30:00;SUR;0;26;26;1
2019-03-21 14:00:00;CONFLICTIVA;13;15;28;2
2019-03-21 14:30:00;NORTE;42;0;42;1
2019-03-21 15:00:00;NORTE;38;0;38;1
2019-03-21 15:30:00;NORTE;28;0;28;1
2019-03-21 16:00:00;NORTE;29;0;29;1
2019-03-21 16:30:00;CONFLICTIVA;10;3;13;2
2019-03-21 17:00:00;SUR;0;29;29;1
2019-03-21 17:30:00;SUR;0;32;32;1
2019-03-21 18:00:00;CONFLICTIVA;6;20;26;2
2019-03-21 18:30:00;NORTE;33;0;33;1
2019-03-21 19:00:00;NORTE;38;0;38;1
2019-03-21 19:30:00;NORTE;32;0;32;1
2019-03-21 20:00:00;NORTE;26;0;26;1
2019-03-21 20:30:00;NORTE;25;0;25;1
2019-03-21 21:00:00;NORTE;33;0;33;1
2019-03-21 21:30:00;NORTE;22;0;22;1
2019-03-21 22:00:00;NORTE;15;0;15;1
2019-03-21 22:30:00;NORTE;13;0;13;1
2019-03-21 23:00:10;NORTE;1;0;1;1
2019-03-21 23:01:24;NORTE;1;0;1;1
2019-03-21 23:05:22;NORTE;1;0;1;1
2019-03-21 23:07:50;NORTE;1;0;1;1
2019-03-21 23:14:25;NORTE;1;0;1;1
2019-03-21 23:14:58;NORTE;1;0;1;1
2019-03-21 23:16:19;NORTE;1;0;1;1
2019-03-21 23:18:44;NORTE;1;0;1;1
2019-03-21 23:20:27;NORTE;1;0;1;1
2019-03-21 23:40:56;NORTE;1;0;1;1
2019-03-21 23:42:54;NORTE;1;0;1;1
2019-03-21 23:45:56;NORTE;1;0;1;1
2019-03-21 23:49:55;NORTE;1;0;1;1
2019-03-21 23:52:27;NORTE;1;0;1;1
2019-03-22 00:07:56;NORTE;1;0;1;1
2019-03-22 00:15:28;NORTE;1;0;1;1
2019-03-22 00:31:53;NORTE;1;0;1;1
2019-03-22 00:52:22;NORTE;1;0;1;1
2019-03-22 00:56:30;NORTE;1;0;1;1
2019-03-22 01:17:16;NORTE;1;0;1;1
2019-03-22 01:21:05;NORTE;1;0;1;1
2019-03-22 01:30:00;NORTE;2;0;2;1
2019-03-22 02:03:58;NORTE;1;0;1;1
2019-03-22 02:30:00;NORTE;1;0;1;1
2019-03-22 03:15:51;NORTE;1;0;1;1
2019-03-22 03:27:23;NORTE;1;0;1;1
2019-03-22 03:30:33;NORTE;1;0;1;1
2019-03-22 03:32:58;NORTE;1;0;1;1
2019-03-22 03:49:43;NORTE;1;0;1;1
2019-03-22 04:00:02;NORTE;1;0;1;1
2019-03-22 04:09:11;NORTE;1;0;1;1
2019-03-22 04:22:36;NORTE;1;0;1;1
2019-03-22 04:29:39;NORTE;1;0;1;1
2019-03-22 04:30:00;NORTE;7;0;7;1
2019-03-22 05:00:00;NORTE;10;0;10;1
2019-03-22 05:30:00;NORTE;13;0;13;1
2019-03-22 06:00:00;NORTE;22;1;23;1
2019-03-22 06:30:00;NORTE;27;0;27;1
2019-03-22 07:00:00;NORTE;19;0;19;1
2019-03-22 07:30:00;NORTE;28;0;28;1
2019-03-22 08:00:00;NORTE;31;0;31;1
2019-03-22 08:30:00;SUR;2;23;25;1
2019-03-22 09:00:00;SUR;0;43;43;1
2019-03-22 09:30:00;SUR;0;28;28;1
2019-03-22 10:00:00;SUR;1;23;24;1
2019-03-22 10:30:00;NORTE;40;0;40;1
2019-03-22 11:00:00;NORTE;41;0;41;1
2019-03-22 11:30:00;NORTE;30;0;30;1
2019-03-22 12:00:00;CONFLICTIVA;9;10;19;2
2019-03-22 12:30:00;SUR;0;30;30;1
2019-03-22 13:00:00;SUR;0;35;35;1
2019-03-22 13:30:00;SUR;2;25;27;1
2019-03-22 14:00:00;NORTE;34;0;34;1
2019-03-22 14:30:48;NORTE;1;0;1;1
2019-03-22 14:31:04;NORTE;1;0;1;1
2019-03-22 14:31:32;NORTE;1;0;1;1
2019-03-22 14:31:56;NORTE;1;0;1;1
2019-03-22 14:32:56;NORTE;1;0;1;1
2019-03-22 14:33:13;NORTE;1;0;1;1
2019-03-22 14:34:28;NORTE;1;0;1;1
2019-03-22 14:34:34;NORTE;1;0;1;1
2019-03-22 14:35:23;NORTE;1;0;1;1
2019-03-22 14:36:17;NORTE;1;0;1;1
2019-03-22 14:37:29;NORTE;1;0;1;1
2019-03-22 14:37:59;NORTE;1;0;1;1
2019-03-22 14:38:06;NORTE;1;0;1;1
2019-03-22 14:39:53;NORTE;1;0;1;1
2019-03-22 14:40:14;NORTE;1;0;1;1
2019-03-22 14:41:30;NORTE;1;0;1;1
2019-03-22 14:43:28;NORTE;1;0;1;1
2019-03-22 14:43:37;NORTE;1;0;1;1
2019-03-22 14:44:06;NORTE;1;0;1;1
2019-03-22 14:45:10;NORTE;1;0;1;1
2019-03-22 14:45:23;NORTE;1;0;1;1
2019-03-22 14:45:24;NORTE;1;0;1;1
2019-03-22 14:46:03;NORTE;1;0;1;1
2019-03-22 14:47:20;NORTE;1;0;1;1
2019-03-22 14:48:02;NORTE;1;0;1;1
2019-03-22 14:48:48;NORTE;1;0;1;1
2019-03-22 14:49:32;NORTE;1;0;1;1
2019-03-22 14:49:46;NORTE;1;0;1;1
2019-03-22 14:50:02;NORTE;1;0;1;1
2019-03-22 14:51:19;NORTE;1;0;1;1
2019-03-22 14:52:28;NORTE;1;0;1;1
2019-03-22 14:52:44;NORTE;1;0;1;1
2019-03-22 14:54:33;NORTE;1;0;1;1
2019-03-22 14:54:57;NORTE;1;0;1;1
2019-03-22 14:56:11;NORTE;1;0;1;1
2019-03-22 14:56:23;NORTE;1;0;1;1
2019-03-22 14:57:24;NORTE;1;0;1;1
2019-03-22 14:58:28;NORTE;1;0;1;1
2019-03-22 14:58:51;NORTE;1;0;1;1
2019-03-22 15:00:00;NORTE;38;0;38;1
2019-03-22 15:30:00;NORTE;35;0;35;1
2019-03-22 16:00:00;CONFLICTIVA;18;4;22;2
2019-03-22 16:30:00;SUR;0;25;25;1
2019-03-22 17:00:00;SUR;0;25;25;1
2019-03-22 17:30:00;SUR;0;33;33;1
2019-03-22 18:00:00;SUR;0;21;21;1
2019-03-22 18:30:00;SUR;0;33;33;1
2019-03-22 19:00:00;SUR;0;30;30;1
2019-03-22 19:30:00;SUR;0;36;36;1
2019-03-22 20:00:00;SUR;0;31;31;1
2019-03-22 20:30:00;SUR;0;30;30;1
2019-03-22 21:00:00;SUR;0;23;23;1
2019-03-22 21:30:00;SUR;0;31;31;1
2019-03-22 22:00:00;SUR;1;11;12;1
2019-03-22 22:30:00;NORTE;3;0;3;1
2019-03-22 23:00:00;NORTE;12;0;12;1
2019-03-22 23:30:00;NORTE;2;0;2;1
2019-03-23 00:00:00;NORTE;1;0;1;1
2019-03-23 00:30:00;NORTE;2;0;2;1
2019-03-23 01:00:00;NORTE;1;0;1;1
2019-03-23 01:30:00;NORTE;1;0;1;1
2019-03-23 02:30:00;NORTE;1;0;1;1
2019-03-23 03:00:00;NORTE;3;0;3;1
2019-03-23 03:30:00;NORTE;2;0;2;1
2019-03-23 04:00:00;NORTE;1;0;1;1
2019-03-23 04:34:10;NORTE;1;0;1;1
2019-03-23 04:43:44;NORTE;1;0;1;1
2019-03-23 04:53:28;NORTE;1;0;1;1
2019-03-23 05:00:00;NORTE;11;0;11;1
2019-03-23 05:30:00;NORTE;17;0;17;1
2019-03-23 06:00:00;NORTE;18;0;18;1
2019-03-23 06:30:00;NORTE;26;0;26;1
2019-03-23 07:00:00;NORTE;14;0;14;1
2019-03-23 07:30:00;CONFLICTIVA;10;11;21;2
2019-03-23 08:00:00;SUR;0;26;26;1
2019-03-23 08:30:00;SUR;0;37;37;1
2019-03-23 09:00:00;SUR;0;38;38;1
2019-03-23 09:30:00;SUR;0;31;31;1
2019-03-23 10:00:00;CONFLICTIVA;16;3;19;2
2019-03-23 10:34:36;NORTE;1;0;1;1
2019-03-23 10:35:00;NORTE;1;0;1;1
2019-03-23 10:35:29;NORTE;1;0;1;1
2019-03-23 10:36:55;NORTE;1;0;1;1
2019-03-23 10:37:22;NORTE;1;0;1;1
2019-03-23 10:38:47;NORTE;1;0;1;1
2019-03-23 10:39:03;NORTE;1;0;1;1
2019-03-23 10:40:11;NORTE;1;0;1;1
2019-03-23 10:40:17;NORTE;1;0;1;1
2019-03-23 10:40:23;NORTE;1;0;1;1
2019-03-23 10:41:48;NORTE;1;0;1;1
2019-03-23 10:42:15;NORTE;1;0;1;1
2019-03-23 10:42:25;NORTE;1;0;1;1
2019-03-23 10:43:15;NORTE;1;0;1;1
2019-03-23 10:43:49;NORTE;1;0;1;1
2019-03-23 10:45:28;NORTE;1;0;1;1
2019-03-23 10:46:33;NORTE;1;0;1;1
2019-03-23 10:47:02;NORTE;1;0;1;1
2019-03-23 10:47:45;NORTE;1;0;1;1
2019-03-23 10:48:10;NORTE;1;0;1;1
2019-03-23 10:48:23;NORTE;1;0;1;1
2019-03-23 10:48:28;NORTE;1;0;1;1
2019-03-23 10:49:01;NORTE;1;0;1;1
2019-03-23 10:50:25;NORTE;1;0;1;1
2019-03-23 10:50:44;NORTE;1;0;1;1
2019-03-23 10:51:35;NORTE;1;0;1;1
2019-03-23 10:52:15;NORTE;1;0;1;1
2019-03-23 10:52:28;NORTE;1;0;1;1
2019-03-23 10:53:06;NORTE;1;0;1;1
2019-03-23 10:54:05;NORTE;1;0;1;1
2019-03-23 10:54:37;NORTE;1;0;1;1
2019-03-23 10:54:42;NORTE;1;0;1;1
2019-03-23 10:55:45;NORTE;1;0;1;1
2019-03-23 10:56:34;NORTE;1;0;1;1
2019-03-23 10:57:11;NORTE;1;0;1;1
2019-03-23 10:58:07;NORTE;1;0;1;1
2019-03-23 10:59:07;NORTE;1;0;1;1
2019-03-23 10:59:25;NORTE;1;0;1;1
2019-03-23 10:59:44;NORTE;1;0;1;1
2019-03-23 11:00:00;NORTE;34;0;34;1
2019-03-23 11:30:00;NORTE;30;0;30;1
2019-03-23 12:00:00;NORTE;24;0;24;1
2019-03-23 12:30:00;NORTE;25;0;25;1
2019-03-23 13:00:00;NORTE;26;0;26;1
2019-03-23 13:30:00;NORTE;21;0;21;1
2019-03-23 14:00:00;NORTE;34;1;35;1
2019-03-23 14:30:00;NORTE;36;0;36;1
2019-03-23 15:00:00;NORTE;31;0;31;1
2019-03-23 15:30:00;NORTE;27;0;27;1
2019-03-23 16:00:00;NORTE;25;0;25;1
2019-03-23 16:31:15;NORTE;1;0;1;1
2019-03-23 16:34:36;NORTE;1;0;1;1
2019-03-23 16:35:36;NORTE;1;0;1;1
2019-03-23 16:37:37;NORTE;1;0;1;1
2019-03-23 16:39:04;NORTE;1;0;1;1
2019-03-23 16:39:47;NORTE;1;0;1;1
2019-03-23 16:43:05;NORTE;1;0;1;1
2019-03-23 16:49:23;NORTE;1;0;1;1
2019-03-23 16:55:22;NORTE;1;0;1;1
2019-03-23 16:58:25;NORTE;1;0;1;1
2019-03-23 16:59:19;NORTE;1;0;1;1
2019-03-23 17:00:00;NORTE;25;0;25;1
2019-03-23 17:30:00;CONFLICTIVA;7;18;25;2
2019-03-23 18:00:00;SUR;0;22;22;1
2019-03-23 18:30:00;SUR;0;21;21;1
2019-03-23 19:00:00;SUR;0;30;30;1
2019-03-23 19:30:00;SUR;0;19;19;1
2019-03-23 20:00:00;SUR;0;16;16;1
2019-03-23 20:30:00;SUR;0;23;23;1
2019-03-23 21:00:00;SUR;0;18;18;1
2019-03-23 21:30:00;SUR;0;17;17;1
2019-03-23 22:00:00;NORTE;8;0;8;1
2019-03-23 22:30:00;NORTE;10;0;10;1
2019-03-23 23:00:00;NORTE;10;0;10;1
2019-03-23 23:30:00;NORTE;1;0;1;1
2019-03-24 01:00:00;NORTE;1;0;1;1
2019-03-24 01:30:00;NORTE;1;0;1;1
2019-03-24 02:00:00;NORTE;2;0;2;1
2019-03-24 02:30:00;NORTE;1;0;1;1
2019-03-24 03:00:00;NORTE;2;0;2;1
2019-03-24 03:30:00;NORTE;6;0;6;1
2019-03-24 04:00:00;NORTE;1;0;1;1
2019-03-24 04:30:00;NORTE;6;0;6;1
2019-03-24 05:00:00;NORTE;6;0;6;1
2019-03-24 05:30:00;NORTE;14;0;14;1
2019-03-24 06:00:00;NORTE;18;0;18;1
2019-03-24 06:30:00;NORTE;25;0;25;1
2019-03-24 07:00:00;NORTE;10;0;10;1
2019-03-24 07:30:00;CONFLICTIVA;11;3;14;2
2019-03-24 08:00:00;SUR;0;25;25;1
2019-03-24 08:30:00;SUR;0;29;29;1
2019-03-24 09:00:00;SUR;0;36;36;1
2019-03-24 09:30:00;SUR;0;27;27;1
2019-03-24 10:00:00;CONFLICTIVA;22;3;25;2
2019-03-24 10:30:00;NORTE;41;0;41;1
2019-03-24 11:00:00;NORTE;36;0;36;1
2019-03-24 11:30:00;CONFLICTIVA;18;7;25;2
2019-03-24 12:00:00;SUR;0;29;29;1
2019-03-24 12:30:00;SUR;0;27;27;1
2019-03-24 13:00:00;SUR;0;27;27;1
2019-03-24 13:30:00;SUR;0;28;28;1
2019-03-24 14:00:00;CONFLICTIVA;10;15;25;2
2019-03-24 14:30:00;NORTE;45;0;45;1
2019-03-24 15:00:00;NORTE;37;0;37;1
2019-03-24 15:30:00;NORTE;26;0;26;1
2019-03-24 16:00:00;CONFLICTIVA;8;14;22;2
2019-03-24 16:30:00;SUR;0;19;19;1
2019-03-24 17:00:00;SUR;0;24;24;1
2019-03-24 17:30:00;SUR;0;27;27;1
2019-03-24 18:00:00;CONFLICTIVA;6;21;27;2
2019-03-24 18:30:00;NORTE;37;0;37;1
2019-03-24 19:00:00;NORTE;40;0;40;1
2019-03-24 19:30:00;CONFLICTIVA;17;10;27;2
2019-03-24 20:00:00;SUR;0;34;34;1
2019-03-24 20:30:00;SUR;0;33;33;1
2019-03-24 21:00:00;SUR;0;26;26;1
2019-03-24 21:30:00;SUR;0;26;26;1
2019-03-24 22:00:00;NORTE;15;0;15;1
2019-03-24 22:30:00;NORTE;16;0;16;1
2019-03-24 23:00:00;NORTE;9;0;9;1
2019-03-24 23:30:00;NORTE;2;0;2;1
2019-03-25 00:00:00;NORTE;2;0;2;1
2019-03-25 00:30:00;NORTE;1;0;1;1
2019-03-25 01:00:00;NORTE;2;0;2;1
2019-03-25 01:30:00;NORTE;3;0;3;1
2019-03-25 02:30:00;NORTE;1;0;1;1
2019-03-25 03:00:00;NORTE;5;0;5;1
2019-03-25 03:30:00;NORTE;3;0;3;1
2019-03-25 04:00:00;NORTE;3;0;3;1
2019-03-25 04:30:00;NORTE;7;0;7;1
2019-03-25 05:00:00;NORTE;4;0;4;1
2019-03-25 05:30:00;NORTE;15;0;15;1
2019-03-25 06:00:00;NORTE;17;0;17;1
2019-03-25 06:30:00;NORTE;36;0;36;1
2019-03-25 07:00:00;NORTE;23;0;23;1
2019-03-25 07:30:00;NORTE;29;0;29;1
2019-03-25 08:00:00;NORTE;36;0;36;1
2019-03-25 08:30:00;NORTE;27;0;27;1
2019-03-25 09:00:00;NORTE;41;0;41;1
2019-03-25 09:30:00;NORTE;35;0;35;1
2019-03-25 10:00:00;NORTE;24;0;24;1
2019-03-25 10:30:00;NORTE;36;0;36;1
2019-03-25 11:00:00;NORTE;36;0;36;1
2019-03-25 11:30:00;NORTE;34;0;34;1
2019-03-25 12:00:00;NORTE;22;0;22;1
2019-03-25 12:30:00;NORTE;28;0;28;1
2019-03-25 13:00:00;NORTE;27;0;27;1
2019-03-25 13:30:00;NORTE;20;0;20;1
2019-03-25 14:00:22;NORTE;1;0;1;1
2019-03-25 14:00:58;NORTE;1;0;1;1
2019-03-25 14:02:24;NORTE;1;0;1;1
2019-03-25 14:02:31;NORTE;1;0;1;1
2019-03-25 14:04:31;NORTE;1;0;1;1
2019-03-25 14:04:40;NORTE;1;0;1;1
2019-03-25 14:06:12;NORTE;1;0;1;1
2019-03-25 14:06:36;NORTE;1;0;1;1
2019-03-25 14:08:35;NORTE;1;0;1;1
2019-03-25 14:09:40;NORTE;1;0;1;1
2019-03-25 14:09:42;NORTE;1;0;1;1
2019-03-25 14:10:55;NORTE;1;0;1;1
2019-03-25 14:11:18;NORTE;1;0;1;1
2019-03-25 14:11:56;NORTE;1;0;1;1
2019-03-25 14:12:18;NORTE;1;0;1;1
2019-03-25 14:12:48;NORTE;1;0;1;1
2019-03-25 14:15:21;NORTE;1;0;1;1
2019-03-25 14:15:45;NORTE;1;0;1;1
2019-03-25 14:16:07;NORTE;1;0;1;1
2019-03-25 14:16:18;NORTE;1;0;1;1
2019-03-25 14:17:37;NORTE;1;0;1;1
2019-03-25 14:17:48;NORTE;1;0;1;1
2019-03-25 14:18:50;NORTE;1;0;1;1
2019-03-25 14:20:04;NORTE;1;0;1;1
2019-03-25 14:20:08;NORTE;1;0;1;1
2019-03-25 14:21:10;NORTE;1;0;1;1
2019-03-25 14:21:21;NORTE;1;0;1;1
2019-03-25 14:22:38;NORTE;1;0;1;1
2019-03-25 14:22:42;NORTE;1;0;1;1
2019-03-25 14:22:49;NORTE;1;0;1;1
2019-03-25 14:24:47;NORTE;1;0;1;1
2019-03-25 14:25:44;NORTE;1;0;1;1
2019-03-25 14:27:06;NORTE;1;0;1;1
2019-03-25 14:27:49;NORTE;1;0;1;1
2019-03-25 14:30:17;NORTE;1;0;1;1
2019-03-25 14:32:35;NORTE;1;0;1;1
2019-03-25 14:32:49;NORTE;1;0;1;1
2019-03-25 14:32:50;NORTE;1;0;1;1
2019-03-25 14:36:28;NORTE;1;0;1;1
2019-03-25 14:37:08;NORTE;1;0;1;1
2019-03-25 14:40:04;NORTE;1;0;1;1
2019-03-25 14:40:07;NORTE;1;0;1;1
2019-03-25 14:40:35;NORTE;1;0;1;1
2019-03-25 14:42:26;NORTE;1;0;1;1
2019-03-25 14:44:05;NORTE;1;0;1;1
2019-03-25 14:44:57;NORTE;1;0;1;1
2019-03-25 14:47:04;NORTE;1;0;1;1
2019-03-25 14:48:19;NORTE;1;0;1;1
2019-03-25 14:50:31;NORTE;1;0;1;1
2019-03-25 14:50:39;NORTE;1;0;1;1
2019-03-25 14:52:04;NORTE;1;0;1;1
2019-03-25 14:53:24;NORTE;1;0;1;1
2019-03-25 14:54:08;NORTE;1;0;1;1
2019-03-25 14:54:10;NORTE;1;0;1;1
2019-03-25 14:55:39;NORTE;1;0;1;1
2019-03-25 14:55:48;NORTE;1;0;1;1
2019-03-25 14:57:00;NORTE;1;0;1;1
2019-03-25 14:57:02;NORTE;1;0;1;1
2019-03-25 14:57:32;NORTE;1;0;1;1
2019-03-25 14:58:50;NORTE;1;0;1;1
2019-03-25 14:59:08;NORTE;1;0;1;1
2019-03-25 14:59:19;NORTE;1;0;1;1
2019-03-25 15:00:00;NORTE;26;0;26;1
2019-03-25 15:30:00;NORTE;26;0;26;1
2019-03-25 16:30:00;NORTE;20;0;20;1
2019-03-25 17:00:00;NORTE;28;0;28;1
2019-03-25 17:30:00;NORTE;32;0;32;1
2019-03-25 18:00:00;NORTE;19;0;19;1
2019-03-25 18:30:00;NORTE;32;0;32;1
2019-03-25 19:00:00;NORTE;35;0;35;1
2019-03-25 19:30:00;NORTE;33;0;33;1
2019-03-25 20:00:00;NORTE;25;0;25;1
2019-03-25 20:30:00;NORTE;28;0;28;1
2019-03-25 21:00:00;NORTE;9;0;9;1
2019-03-26 08:00:00;NORTE;21;0;21;1
2019-03-26 08:30:00;NORTE;34;0;34;1
2019-03-26 09:00:00;NORTE;36;0;36;1
2019-03-26 09:30:00;NORTE;28;0;28;1
2019-03-26 10:00:00;NORTE;24;0;24;1
2019-03-26 10:30:00;NORTE;33;0;33;1
2019-03-26 11:00:00;NORTE;36;0;36;1
2019-03-26 11:30:00;NORTE;34;0;34;1
2019-03-26 12:00:00;NORTE;25;0;25;1
2019-03-26 12:30:00;NORTE;24;0;24;1
2019-03-26 13:00:00;NORTE;27;0;27;1
2019-03-26 13:30:00;NORTE;32;0;32;1
2019-03-26 14:00:00;NORTE;41;0;41;1
2019-03-26 14:30:00;NORTE;22;0;22;1
2019-03-26 15:00:00;NORTE;25;0;25;1
2019-03-26 15:30:00;NORTE;29;0;29;1
2019-03-26 16:00:00;NORTE;40;0;40;1
2019-03-26 16:30:00;NORTE;19;0;19;1
2019-03-26 17:00:00;NORTE;25;0;25;1
2019-03-26 17:30:00;NORTE;32;0;32;1
2019-03-26 18:00:00;NORTE;28;0;28;1
2019-03-26 18:30:00;NORTE;29;0;29;1
2019-03-26 19:00:00;NORTE;36;0;36;1
2019-03-26 19:30:00;NORTE;28;0;28;1
2019-03-26 20:00:00;NORTE;24;0;24;1
2019-03-26 20:30:00;NORTE;27;0;27;1
2019-03-26 21:00:00;NORTE;25;0;25;1
2019-03-26 21:30:00;NORTE;18;0;18;1
2019-03-26 22:00:00;NORTE;13;0;13;1
2019-03-26 22:30:00;NORTE;9;0;9;1
2019-03-26 23:00:00;NORTE;14;0;14;1
2019-03-26 23:30:00;NORTE;4;0;4;1
2019-03-27 00:00:00;NORTE;1;0;1;1
2019-03-27 01:00:00;NORTE;1;0;1;1
2019-03-27 01:30:00;NORTE;1;0;1;1
2019-03-27 02:00:00;NORTE;1;0;1;1
2019-03-27 02:30:00;NORTE;2;0;2;1
2019-03-27 03:00:00;NORTE;3;0;3;1
2019-03-27 03:30:00;NORTE;3;0;3;1
2019-03-27 04:00:00;NORTE;6;0;6;1
2019-03-27 04:30:00;NORTE;7;0;7;1
2019-03-27 05:00:00;NORTE;8;0;8;1
2019-03-27 05:30:00;NORTE;16;0;16;1
2019-03-27 06:00:00;NORTE;21;0;21;1
2019-03-27 06:30:00;NORTE;39;0;39;1
2019-03-27 07:00:00;NORTE;18;0;18;1
2019-03-27 07:30:00;NORTE;29;0;29;1
2019-03-27 08:00:00;NORTE;34;0;34;1
2019-03-27 08:30:00;NORTE;27;0;27;1
2019-03-27 09:00:00;NORTE;40;0;40;1
2019-03-27 09:30:00;NORTE;24;0;24;1
2019-03-27 10:00:00;NORTE;22;0;22;1
2019-03-27 10:30:00;NORTE;41;0;41;1
2019-03-27 11:00:00;NORTE;30;0;30;1
2019-03-27 11:30:00;NORTE;37;0;37;1
2019-03-27 12:00:00;NORTE;25;0;25;1
2019-03-27 12:30:00;NORTE;29;0;29;1
2019-03-27 13:00:00;NORTE;28;0;28;1
2019-03-27 13:30:00;NORTE;30;0;30;1
2019-03-27 14:00:00;NORTE;38;0;38;1
2019-03-27 14:30:00;NORTE;26;0;26;1
2019-03-27 15:00:00;NORTE;32;0;32;1
2019-03-27 15:30:00;NORTE;31;0;31;1
2019-03-27 16:00:00;NORTE;19;0;19;1
2019-03-27 16:30:00;NORTE;21;0;21;1
2019-03-27 17:00:00;NORTE;26;0;26;1
2019-03-27 17:30:00;NORTE;32;0;32;1
2019-03-27 18:00:00;NORTE;27;0;27;1
2019-03-27 18:30:00;NORTE;26;0;26;1
2019-03-27 19:00:00;NORTE;40;0;40;1
2019-03-27 19:30:00;NORTE;27;0;27;1
2019-03-27 20:00:00;SUR;0;28;28;1
2019-03-27 20:30:00;SUR;0;30;30;1
2019-03-27 21:00:00;SUR;0;34;34;1
2019-03-27 21:30:00;SUR;0;15;15;1
2019-03-27 22:00:00;NORTE;20;0;20;1
2019-03-27 22:30:00;NORTE;11;0;11;1
2019-03-27 23:00:00;NORTE;10;0;10;1
2019-03-27 23:30:00;NORTE;4;0;4;1
2019-03-28 00:30:00;NORTE;1;0;1;1
2019-03-28 01:00:00;NORTE;1;0;1;1
2019-03-28 01:30:00;NORTE;2;0;2;1
2019-03-28 02:30:00;NORTE;1;0;1;1
2019-03-28 03:00:00;NORTE;3;0;3;1
2019-03-28 03:30:00;NORTE;2;0;2;1
2019-03-28 04:00:00;NORTE;2;0;2;1
2019-03-28 04:30:00;NORTE;10;0;10;1
2019-03-28 05:00:00;NORTE;9;0;9;1
2019-03-28 05:30:00;NORTE;17;0;17;1
2019-03-28 06:00:00;NORTE;23;0;23;1
2019-03-28 06:30:00;NORTE;38;0;38;1
2019-03-28 07:00:00;NORTE;20;0;20;1
2019-03-28 07:30:00;NORTE;23;0;23;1
2019-03-28 08:00:00;NORTE;41;0;41;1
2019-03-28 08:30:00;NORTE;30;0;30;1
2019-03-28 09:00:00;NORTE;34;0;34;1
2019-03-28 09:30:00;NORTE;30;0;30;1
2019-03-28 10:00:00;NORTE;24;0;24;1
2019-03-28 10:30:00;NORTE;39;0;39;1
2019-03-28 11:00:00;NORTE;35;0;35;1
2019-03-28 11:30:00;NORTE;35;0;35;1
2019-03-28 12:00:00;NORTE;26;0;26;1
2019-03-28 12:30:00;NORTE;23;0;23;1
2019-03-28 13:00:00;NORTE;29;0;29;1
2019-03-28 13:30:00;NORTE;34;0;34;1
2019-03-28 14:00:00;NORTE;35;0;35;1
2019-03-28 14:30:00;NORTE;32;0;32;1
2019-03-28 15:00:00;NORTE;39;0;39;1
2019-03-28 15:30:00;NORTE;28;0;28;1
2019-03-28 16:00:00;NORTE;26;0;26;1
2019-03-28 16:30:00;NORTE;19;0;19;1
2019-03-28 17:00:00;NORTE;18;0;18;1
2019-03-28 17:30:00;NORTE;29;0;29;1
2019-03-28 18:00:00;NORTE;32;0;32;1
2019-03-28 18:30:00;NORTE;30;0;30;1
2019-03-28 19:00:00;CONFLICTIVA;22;6;28;2
2019-03-28 19:30:00;SUR;0;39;39;1
2019-03-28 20:00:00;SUR;0;35;35;1
2019-03-28 20:30:00;SUR;0;30;30;1
2019-03-28 21:00:00;SUR;0;31;31;1
2019-03-28 21:30:00;SUR;0;22;22;1
2019-03-28 22:00:00;CONFLICTIVA;6;7;13;2
2019-03-28 22:30:00;NORTE;7;0;7;1
2019-03-28 23:00:00;NORTE;11;0;11;1
2019-03-28 23:30:00;NORTE;5;0;5;1
2019-03-29 00:00:00;NORTE;2;0;2;1
2019-03-29 00:30:00;NORTE;2;0;2;1
2019-03-29 01:00:00;NORTE;1;0;1;1
2019-03-29 01:30:00;NORTE;2;0;2;1
2019-03-29 02:00:00;NORTE;1;0;1;1
2019-03-29 02:30:00;NORTE;2;0;2;1
2019-03-29 03:00:00;NORTE;3;0;3;1
2019-03-29 03:30:00;NORTE;3;0;3;1
2019-03-29 04:00:00;NORTE;6;0;6;1
2019-03-29 04:30:00;NORTE;9;0;9;1
2019-03-29 05:00:00;NORTE;7;0;7;1
2019-03-29 05:30:00;NORTE;13;0;13;1
2019-03-29 06:00:00;NORTE;22;0;22;1
2019-03-29 06:30:00;NORTE;39;0;39;1
2019-03-29 07:00:00;NORTE;16;0;16;1
2019-03-29 07:30:00;NORTE;26;0;26;1
2019-03-29 08:00:00;NORTE;34;0;34;1
2019-03-29 08:30:00;NORTE;32;0;32;1
2019-03-29 09:00:00;NORTE;43;0;43;1
2019-03-29 09:30:00;NORTE;26;0;26;1
2019-03-29 10:00:00;NORTE;26;0;26;1
2019-03-29 10:30:00;CONFLICTIVA;5;29;34;2
2019-03-29 11:00:00;SUR;0;25;25;1
2019-03-29 11:30:00;SUR;0;28;28;1
2019-03-29 12:00:00;SUR;0;26;26;1
2019-03-29 12:30:00;SUR;0;24;24;1
2019-03-29 13:00:00;SUR;0;31;31;1
2019-03-29 13:30:00;SUR;0;35;35;1
2019-03-29 14:00:00;SUR;0;35;35;1
2019-03-29 14:30:00;SUR;0;31;31;1
2019-03-29 15:00:00;SUR;0;38;38;1
2019-03-29 15:30:00;SUR;0;31;31;1
2019-03-29 16:00:00;SUR;0;32;32;1
2019-03-29 16:30:00;SUR;0;24;24;1
2019-03-29 17:00:00;SUR;0;20;20;1
2019-03-29 17:30:00;SUR;0;31;31;1
2019-03-29 18:00:00;SUR;0;30;30;1
2019-03-29 18:30:00;SUR;0;28;28;1
2019-03-29 19:00:00;SUR;0;35;35;1
2019-03-29 19:30:00;SUR;0;32;32;1
2019-03-29 20:00:00;SUR;0;31;31;1
2019-03-29 20:30:00;SUR;0;38;38;1
2019-03-29 21:00:00;SUR;0;31;31;1
2019-03-29 21:30:00;SUR;0;25;25;1
2019-03-29 22:00:00;SUR;0;13;13;1
2019-03-29 22:30:00;SUR;0;6;6;1
2019-03-29 23:00:00;SUR;0;17;17;1
2019-03-29 23:30:00;SUR;0;4;4;1
2019-03-30 00:00:00;SUR;0;2;2;1
2019-03-30 00:30:00;SUR;0;1;1;1
2019-03-30 02:30:00;NORTE;1;0;1;1
2019-03-30 03:00:00;NORTE;4;0;4;1
2019-03-30 03:30:00;NORTE;3;0;3;1
2019-03-30 04:00:00;NORTE;4;0;4;1
2019-03-30 04:30:00;NORTE;5;0;5;1
2019-03-30 05:00:00;NORTE;8;0;8;1
2019-03-30 05:30:00;NORTE;20;0;20;1
2019-03-30 06:00:00;NORTE;22;0;22;1
2019-03-30 06:30:00;NORTE;29;0;29;1
2019-03-30 07:00:00;NORTE;11;0;11;1
2019-03-30 07:30:00;NORTE;26;0;26;1
2019-03-30 08:00:00;NORTE;36;0;36;1
2019-03-30 08:30:00;NORTE;29;0;29;1
2019-03-30 09:00:00;NORTE;35;0;35;1
2019-03-30 09:30:00;NORTE;30;0;30;1
2019-03-30 10:00:00;NORTE;21;0;21;1
2019-03-30 10:30:00;NORTE;44;0;44;1
2019-03-30 11:00:00;NORTE;35;0;35;1
2019-03-30 11:30:00;NORTE;28;0;28;1
2019-03-30 12:00:00;NORTE;26;0;26;1
2019-03-30 12:30:00;NORTE;29;0;29;1
2019-03-30 13:00:00;NORTE;25;0;25;1
2019-03-30 13:30:00;NORTE;28;0;28;1
2019-03-30 14:00:00;NORTE;40;0;40;1
2019-03-30 14:30:00;NORTE;26;0;26;1
2019-03-30 15:00:00;NORTE;33;0;33;1
2019-03-30 15:30:00;NORTE;27;0;27;1
2019-03-30 16:00:00;NORTE;21;0;21;1
2019-03-30 16:30:00;NORTE;15;0;15;1
2019-03-30 17:00:00;NORTE;25;0;25;1
2019-03-30 17:30:00;NORTE;30;0;30;1
2019-03-30 18:00:00;NORTE;14;0;14;1
2019-03-30 18:30:00;NORTE;24;0;24;1
2019-03-30 19:00:00;NORTE;32;0;32;1
2019-03-30 19:30:00;NORTE;17;0;17;1
2019-03-30 20:00:00;NORTE;21;0;21;1
2019-03-30 20:30:00;NORTE;23;0;23;1
2019-03-30 21:00:00;NORTE;12;0;12;1
2019-03-30 21:30:00;NORTE;17;0;17;1
2019-03-30 22:00:00;NORTE;9;0;9;1
2019-03-30 22:30:00;NORTE;4;0;4;1
2019-03-30 23:00:00;NORTE;10;0;10;1
2019-03-30 23:30:00;NORTE;5;0;5;1
2019-03-31 00:00:00;NORTE;1;0;1;1
2019-03-31 01:00:00;NORTE;2;0;2;1
2019-03-31 03:00:00;NORTE;5;0;5;1
2019-03-31 03:30:00;NORTE;5;0;5;1
2019-03-31 04:00:00;NORTE;8;0;8;1
2019-03-31 04:30:00;NORTE;12;0;12;1
2019-03-31 05:00:00;NORTE;18;0;18;1
2019-03-31 05:30:00;NORTE;25;0;25;1
2019-03-31 06:00:00;NORTE;16;0;16;1
2019-03-31 06:30:00;NORTE;28;0;28;1
2019-03-31 07:00:00;NORTE;32;0;32;1
2019-03-31 07:30:00;NORTE;22;0;22;1
2019-03-31 08:00:00;NORTE;37;0;37;1
2019-03-31 08:30:00;NORTE;36;0;36;1
2019-03-31 09:00:00;NORTE;26;0;26;1
2019-03-31 09:30:00;NORTE;34;0;34;1
2019-03-31 10:00:00;NORTE;35;0;35;1
2019-03-31 10:30:00;NORTE;37;0;37;1
2019-03-31 11:00:00;SUR;1;23;24;1
2019-03-31 11:30:00;SUR;0;33;33;1
2019-03-31 12:00:00;SUR;0;29;29;1
2019-03-31 12:30:00;SUR;0;32;32;1
2019-03-31 13:00:00;SUR;0;42;42;1
2019-03-31 13:30:00;SUR;0;30;30;1
2019-03-31 14:00:00;SUR;0;40;40;1
2019-03-31 14:30:00;SUR;0;29;29;1
2019-03-31 15:00:00;SUR;0;32;32;1
2019-03-31 15:30:00;SUR;0;14;14;1
2019-03-31 16:00:00;SUR;0;25;25;1
2019-03-31 16:30:00;SUR;0;32;32;1
2019-03-31 17:00:00;SUR;0;23;23;1
2019-03-31 17:30:00;SUR;0;31;31;1
2019-03-31 18:00:00;SUR;3;32;35;1
2019-03-31 18:30:00;NORTE;37;0;37;1
2019-03-31 19:00:00;NORTE;37;0;37;1
2019-03-31 19:30:00;NORTE;26;0;26;1
2019-03-31 20:00:00;NORTE;30;0;30;1
2019-03-31 20:30:00;NORTE;28;0;28;1
2019-03-31 21:00:00;NORTE;21;0;21;1
2019-03-31 21:30:00;NORTE;15;0;15;1
2019-03-31 22:00:00;NORTE;12;0;12;1
2019-03-31 22:30:00;NORTE;7;0;7;1
2019-03-31 23:00:00;NORTE;2;0;2;1
2019-03-31 23:30:00;NORTE;2;0;2;1
2019-04-01 00:00:00;NORTE;2;0;2;1
2019-04-01 00:30:00;NORTE;1;0;1;1
2019-04-01 01:00:00;NORTE;2;0;2;1
2019-04-01 01:30:00;NORTE;2;0;2;1
2019-04-01 02:00:00;NORTE;3;0;3;1
2019-04-01 02:30:00;NORTE;4;0;4;1
2019-04-01 03:00:00;NORTE;4;0;4;1
2019-04-01 03:30:00;NORTE;4;0;4;1
2019-04-01 04:00:00;NORTE;7;0;7;1
2019-04-01 04:30:00;NORTE;16;0;16;1
2019-04-01 05:00:00;NORTE;17;0;17;1
2019-04-01 05:30:00;NORTE;46;0;46;1
2019-04-01 06:00:00;NORTE;25;0;25;1
2019-04-01 06:30:00;NORTE;24;0;24;1
2019-04-01 07:00:00;NORTE;32;0;32;1
2019-04-01 07:30:00;NORTE;31;0;31;1
2019-04-01 08:00:00;NORTE;32;0;32;1
2019-04-01 08:30:00;NORTE;37;0;37;1
2019-04-01 09:00:00;NORTE;24;0;24;1
2019-04-01 09:30:00;NORTE;33;0;33;1
2019-04-01 10:00:00;NORTE;36;0;36;1
2019-04-01 10:30:00;NORTE;25;0;25;1
2019-04-01 11:00:00;NORTE;32;0;32;1
2019-04-01 11:30:00;NORTE;24;0;24;1
2019-04-01 12:00:00;NORTE;23;0;23;1
2019-04-01 12:30:00;NORTE;35;0;35;1
2019-04-01 13:00:00;NORTE;42;0;42;1
2019-04-01 13:30:00;NORTE;27;0;27;1
2019-04-01 14:00:00;NORTE;41;0;41;1
2019-04-01 14:30:00;NORTE;27;0;27;1
2019-04-01 15:00:00;NORTE;26;0;26;1
2019-04-01 15:30:00;NORTE;26;0;26;1
2019-04-01 16:00:00;NORTE;17;0;17;1
2019-04-01 16:30:00;NORTE;38;0;38;1
2019-04-01 17:00:00;NORTE;24;0;24;1
2019-04-01 17:30:00;NORTE;25;0;25;1
2019-04-01 18:00:00;NORTE;43;0;43;1
2019-04-01 18:30:00;NORTE;27;0;27;1
2019-04-01 19:00:00;NORTE;34;0;34;1
2019-04-01 19:30:00;NORTE;26;0;26;1
2019-04-01 20:00:00;NORTE;30;0;30;1
2019-04-01 20:30:00;NORTE;23;0;23;1
2019-04-01 21:00:00;NORTE;11;0;11;1
2019-04-01 21:30:00;NORTE;7;0;7;1
2019-04-01 22:00:00;NORTE;15;0;15;1
2019-04-01 22:30:00;NORTE;4;0;4;1
2019-04-01 23:00:00;NORTE;3;0;3;1
2019-04-02 00:00:00;NORTE;1;0;1;1
2019-04-02 01:00:00;NORTE;2;0;2;1
2019-04-02 01:30:00;NORTE;1;0;1;1
2019-04-02 02:00:00;NORTE;6;0;6;1
2019-04-02 02:30:00;NORTE;1;0;1;1
2019-04-02 03:00:00;NORTE;1;0;1;1
2019-04-02 03:30:00;NORTE;8;0;8;1
2019-04-02 04:00:00;NORTE;12;0;12;1
2019-04-02 04:30:00;NORTE;14;0;14;1
2019-04-02 05:00:00;NORTE;23;0;23;1
2019-04-02 05:30:00;NORTE;40;0;40;1
2019-04-02 06:00:00;NORTE;22;0;22;1
2019-04-02 06:30:00;NORTE;29;0;29;1
2019-04-02 07:00:00;NORTE;31;0;31;1
2019-04-02 07:30:00;NORTE;33;0;33;1
2019-04-02 08:00:00;NORTE;33;0;33;1
2019-04-02 08:30:00;NORTE;36;0;36;1
2019-04-02 09:00:00;NORTE;22;0;22;1
2019-04-02 09:30:00;NORTE;30;0;30;1
2019-04-02 10:00:00;NORTE;44;0;44;1
2019-04-02 10:30:00;NORTE;27;0;27;1
2019-04-02 11:00:00;NORTE;30;0;30;1
2019-04-02 11:30:00;NORTE;33;0;33;1
2019-04-02 12:00:00;NORTE;13;0;13;1
2019-04-02 12:21:00;NORTE;8;0;8;1
2019-04-02 12:30:00;NORTE;27;0;27;1
2019-04-02 13:00:00;NORTE;27;0;27;1
2019-04-02 13:30:00;NORTE;30;0;30;1
2019-04-02 14:00:00;NORTE;37;0;37;1
2019-04-02 14:30:00;NORTE;34;0;34;1
2019-04-02 15:00:00;NORTE;32;0;32;1
2019-04-02 15:30:00;NORTE;21;0;21;1
2019-04-02 16:00:00;NORTE;17;0;17;1
2019-04-02 16:30:00;NORTE;32;0;32;1
2019-04-02 17:00:00;NORTE;23;0;23;1
2019-04-02 17:30:00;NORTE;28;0;28;1
2019-04-02 18:00:00;NORTE;39;0;39;1
2019-04-02 18:30:00;CONFLICTIVA;11;14;25;2
2019-04-02 19:00:00;SUR;0;32;32;1
2019-04-02 19:30:00;SUR;0;26;26;1
2019-04-02 20:00:00;SUR;0;41;41;1
2019-04-02 20:30:00;SUR;0;23;23;1
2019-04-02 21:00:00;SUR;0;16;16;1
2019-04-02 21:30:00;SUR;0;7;7;1
2019-04-02 22:00:00;SUR;0;13;13;1
2019-04-02 22:30:00;SUR;0;6;6;1
2019-04-02 23:00:00;SUR;0;2;2;1
2019-04-02 23:30:00;SUR;0;2;2;1
2019-04-03 00:30:00;SUR;0;2;2;1
2019-04-03 01:00:00;SUR;0;1;1;1
2019-04-03 01:30:00;NORTE;1;0;1;1
2019-04-03 02:00:00;NORTE;5;0;5;1
2019-04-03 02:30:00;NORTE;3;0;3;1
2019-04-03 03:00:00;NORTE;3;0;3;1
2019-04-03 03:30:00;NORTE;7;0;7;1
2019-04-03 04:00:00;NORTE;12;0;12;1
2019-04-03 04:30:00;NORTE;10;0;10;1
2019-04-03 05:00:00;NORTE;17;0;17;1
2019-04-03 05:30:00;NORTE;38;0;38;1
2019-04-03 06:00:00;NORTE;24;0;24;1
2019-04-03 06:30:00;NORTE;23;0;23;1
2019-04-03 07:00:00;NORTE;38;0;38;1
2019-04-03 07:30:00;NORTE;34;0;34;1
2019-04-03 08:00:00;NORTE;32;0;32;1
2019-04-03 08:30:00;NORTE;34;0;34;1
2019-04-03 09:00:00;NORTE;30;0;30;1
2019-04-03 09:30:00;NORTE;31;0;31;1
2019-04-03 10:00:00;NORTE;30;0;30;1
2019-04-03 10:30:00;NORTE;32;0;32;1
2019-04-03 11:00:00;NORTE;33;0;33;1
2019-04-03 11:30:00;NORTE;28;0;28;1
2019-04-03 12:00:00;NORTE;25;0;25;1
2019-04-03 12:30:00;NORTE;26;0;26;1
2019-04-03 13:00:00;NORTE;34;0;34;1
2019-04-03 13:30:00;NORTE;39;0;39;1
2019-04-03 14:00:00;NORTE;42;0;42;1
2019-04-03 14:30:00;NORTE;28;0;28;1
2019-04-03 15:00:00;NORTE;31;0;31;1
2019-04-03 15:30:00;NORTE;18;0;18;1
2019-04-03 16:00:00;NORTE;26;0;26;1
2019-04-03 16:30:00;NORTE;29;0;29;1
2019-04-03 17:00:00;NORTE;19;0;19;1
2019-04-03 17:30:00;NORTE;34;0;34;1
2019-04-03 18:00:00;NORTE;33;0;33;1
2019-04-03 18:30:00;NORTE;33;0;33;1
2019-04-03 19:00:00;NORTE;34;0;34;1
2019-04-03 19:30:00;NORTE;35;0;35;1
2019-04-03 20:00:00;NORTE;28;0;28;1
2019-04-03 20:30:00;NORTE;30;0;30;1
2019-04-03 21:00:00;NORTE;13;0;13;1
2019-04-03 21:30:00;NORTE;11;0;11;1
2019-04-03 22:00:00;NORTE;11;0;11;1
2019-04-03 22:30:00;NORTE;8;0;8;1
2019-04-03 23:00:00;NORTE;1;0;1;1
2019-04-03 23:30:00;NORTE;2;0;2;1
2019-04-04 00:00:00;NORTE;1;0;1;1
2019-04-04 01:30:00;NORTE;2;0;2;1
2019-04-04 02:00:00;NORTE;5;0;5;1
2019-04-04 02:30:00;NORTE;2;0;2;1
2019-04-04 03:00:00;NORTE;2;0;2;1
2019-04-04 03:30:00;NORTE;7;0;7;1
2019-04-04 04:00:00;NORTE;14;0;14;1
2019-04-04 04:30:00;NORTE;14;0;14;1
2019-04-04 05:00:00;NORTE;22;0;22;1
2019-04-04 05:30:00;NORTE;36;0;36;1
2019-04-04 06:00:00;NORTE;23;0;23;1
2019-04-04 06:30:00;NORTE;25;0;25;1
2019-04-04 07:00:00;NORTE;34;0;34;1
2019-04-04 07:30:00;NORTE;26;0;26;1
2019-04-04 08:00:00;NORTE;36;0;36;1
2019-04-04 08:30:00;NORTE;44;0;44;1
2019-04-04 09:00:00;NORTE;21;0;21;1
2019-04-04 09:30:00;SUR;2;33;35;1
2019-04-04 10:00:00;SUR;0;31;31;1
2019-04-04 10:30:00;SUR;0;34;34;1
2019-04-04 11:00:00;SUR;0;34;34;1
2019-04-04 11:30:00;SUR;0;27;27;1
2019-04-04 12:00:00;SUR;0;20;20;1
2019-04-04 12:30:00;SUR;0;28;28;1
2019-04-04 13:00:00;SUR;0;42;42;1
2019-04-04 13:30:00;SUR;0;28;28;1
2019-04-04 14:00:00;SUR;0;34;34;1
2019-04-04 14:30:00;SUR;0;35;35;1
2019-04-04 15:00:00;SUR;0;30;30;1
2019-04-04 15:30:00;SUR;0;16;16;1
2019-04-04 16:00:00;SUR;0;16;16;1
2019-04-04 16:30:00;SUR;0;26;26;1
2019-04-04 17:00:00;SUR;0;21;21;1
2019-04-04 17:30:00;SUR;0;32;32;1
2019-04-04 18:00:00;SUR;0;34;34;1
2019-04-04 18:30:00;SUR;0;30;30;1
2019-04-04 19:00:00;SUR;0;25;25;1
2019-04-04 19:30:00;SUR;0;31;31;1
2019-04-04 20:00:00;SUR;0;30;30;1
2019-04-04 20:30:00;SUR;0;27;27;1
2019-04-04 21:00:00;SUR;0;11;11;1
2019-04-04 21:30:00;SUR;0;17;17;1
2019-04-04 22:00:00;SUR;0;11;11;1
2019-04-04 22:30:00;SUR;0;6;6;1
2019-04-04 23:00:00;SUR;0;2;2;1
2019-04-04 23:30:00;SUR;0;4;4;1
2019-04-05 00:00:00;SUR;0;1;1;1
2019-04-05 01:00:00;SUR;0;1;1;1
2019-04-05 02:00:00;SUR;0;3;3;1
2019-04-05 02:30:00;SUR;0;5;5;1
2019-04-05 03:00:00;SUR;0;3;3;1
2019-04-05 03:30:00;SUR;0;10;10;1
2019-04-05 04:00:00;SUR;0;7;7;1
2019-04-05 04:30:00;SUR;0;8;8;1
2019-04-05 05:00:00;SUR;0;18;18;1
2019-04-05 05:30:00;SUR;0;40;40;1
2019-04-05 06:00:00;SUR;0;19;19;1
2019-04-05 06:30:00;SUR;0;27;27;1
2019-04-05 07:00:00;SUR;0;29;29;1
2019-04-05 07:30:00;SUR;0;28;28;1
2019-04-05 08:00:00;SUR;0;31;31;1
2019-04-05 08:30:00;SUR;0;38;38;1
2019-04-05 09:00:00;SUR;0;20;20;1
2019-04-05 09:19:00;SUR;0;8;8;1
2019-04-05 09:30:00;SUR;0;35;35;1
2019-04-05 10:00:00;SUR;0;31;31;1
2019-04-05 10:30:00;SUR;0;35;35;1
2019-04-05 11:00:00;SUR;0;33;33;1
2019-04-05 11:30:00;SUR;0;27;27;1
2019-04-05 12:00:00;SUR;0;24;24;1
2019-04-05 12:30:00;SUR;0;3;3;1
2019-04-05 12:38:00;SUR;0;6;6;1
2019-04-05 12:50:00;SUR;0;8;8;1
2019-04-05 13:00:00;SUR;0;36;36;1
2019-04-05 13:30:00;SUR;0;41;41;1
2019-04-05 14:00:00;SUR;0;37;37;1
2019-04-05 14:30:00;SUR;0;31;31;1
2019-04-05 15:00:00;SUR;0;24;24;1
2019-04-05 15:30:00;SUR;0;38;38;1
2019-04-05 16:00:00;SUR;0;19;19;1
2019-04-05 16:23:00;SUR;0;2;2;1
2019-04-05 16:30:00;SUR;0;11;11;1
2019-04-05 16:46:00;SUR;0;8;8;1
2019-04-05 17:00:00;NORTE;26;0;26;1
2019-04-05 17:30:00;NORTE;33;0;33;1
2019-04-05 18:00:00;NORTE;36;0;36;1
2019-04-05 18:30:00;NORTE;30;0;30;1
2019-04-05 19:00:00;NORTE;31;0;31;1
2019-04-05 19:30:00;NORTE;23;0;23;1
2019-04-05 20:00:00;NORTE;43;0;43;1
2019-04-05 20:30:00;NORTE;21;0;21;1
2019-04-05 21:00:00;NORTE;15;0;15;1
2019-04-05 21:30:00;NORTE;13;0;13;1
2019-04-05 22:00:00;NORTE;17;0;17;1
2019-04-05 22:30:00;NORTE;4;0;4;1
2019-04-05 23:00:00;NORTE;2;0;2;1
2019-04-06 00:00:00;NORTE;2;0;2;1
2019-04-06 00:30:00;NORTE;1;0;1;1
2019-04-06 01:00:00;NORTE;1;0;1;1
2019-04-06 02:00:00;NORTE;4;0;4;1
2019-04-06 02:30:00;NORTE;4;0;4;1
2019-04-06 03:00:00;NORTE;4;0;4;1
2019-04-06 03:30:00;NORTE;6;0;6;1
2019-04-06 04:00:00;NORTE;7;0;7;1
2019-04-06 04:30:00;SUR;0;9;9;1
2019-04-06 05:00:00;SUR;0;19;19;1
2019-04-06 05:30:00;SUR;0;25;25;1
2019-04-06 06:00:00;SUR;0;24;24;1
2019-04-06 06:30:00;SUR;0;26;26;1
2019-04-06 07:00:00;SUR;0;39;39;1
2019-04-06 07:30:00;SUR;0;25;25;1
2019-04-06 08:00:00;SUR;0;34;34;1
2019-04-06 08:30:00;SUR;0;36;36;1
2019-04-06 09:00:00;SUR;0;29;29;1
2019-04-06 09:30:00;SUR;0;25;25;1
2019-04-06 10:00:00;SUR;0;27;27;1
2019-04-06 10:23:00;SUR;0;11;11;1
2019-04-06 10:30:00;SUR;0;26;26;1
2019-04-06 11:00:00;SUR;0;23;23;1
2019-04-06 11:30:00;SUR;0;27;27;1
2019-04-06 12:00:00;SUR;0;24;24;1
2019-04-06 12:30:00;SUR;0;28;28;1
2019-04-06 13:00:00;SUR;0;36;36;1
2019-04-06 13:30:00;SUR;0;26;26;1
2019-04-06 14:00:00;SUR;0;35;35;1
2019-04-06 14:30:00;SUR;0;28;28;1
2019-04-06 15:00:00;SUR;0;5;5;1
2019-04-06 15:11:00;SUR;0;6;6;1
2019-04-06 15:30:00;CONFLICTIVA;7;1;8;2
2019-04-06 15:42:00;NORTE;15;0;15;1
2019-04-06 16:00:00;NORTE;27;0;27;1
2019-04-06 16:30:00;NORTE;23;0;23;1
2019-04-06 17:00:00;NORTE;12;0;12;1
2019-04-06 17:16:00;NORTE;8;0;8;1
2019-04-06 17:30:00;NORTE;18;0;18;1
2019-04-06 18:00:00;NORTE;28;0;28;1
2019-04-06 18:30:00;NORTE;22;0;22;1
2019-04-06 19:00:00;NORTE;26;0;26;1
2019-04-06 19:30:00;NORTE;24;0;24;1
2019-04-06 20:00:00;NORTE;27;0;27;1
2019-04-06 20:30:00;NORTE;22;0;22;1
2019-04-06 21:00:00;NORTE;10;0;10;1
2019-04-06 21:30:00;NORTE;10;0;10;1
2019-04-06 22:00:00;SUR;0;14;14;1
2019-04-06 22:30:00;SUR;0;5;5;1
2019-04-06 23:00:00;SUR;0;6;6;1
2019-04-06 23:30:00;SUR;0;1;1;1
2019-04-07 00:00:00;SUR;0;2;2;1
2019-04-07 00:30:00;SUR;0;2;2;1
2019-04-07 01:00:00;SUR;0;1;1;1
2019-04-07 01:30:00;SUR;0;2;2;1
2019-04-07 02:00:00;SUR;0;2;2;1
2019-04-07 02:30:00;SUR;0;3;3;1
2019-04-07 03:00:00;SUR;0;1;1;1
2019-04-07 03:30:00;SUR;0;4;4;1
2019-04-07 04:00:00;SUR;0;8;8;1
2019-04-07 04:30:00;SUR;0;10;10;1
2019-04-07 05:00:00;SUR;0;16;16;1
2019-04-07 05:30:00;SUR;0;24;24;1
2019-04-07 06:00:00;SUR;0;23;23;1
2019-04-07 06:30:00;SUR;0;22;22;1
2019-04-07 07:00:00;SUR;0;36;36;1
2019-04-07 07:30:00;SUR;0;26;26;1
2019-04-07 08:00:00;SUR;0;36;36;1
2019-04-07 08:30:00;SUR;0;37;37;1
2019-04-07 09:00:00;CONFLICTIVA;8;4;12;2
2019-04-07 09:30:00;NORTE;35;0;35;1
2019-04-07 10:00:00;NORTE;38;0;38;1
2019-04-07 10:30:00;NORTE;29;0;29;1
2019-04-07 11:00:00;NORTE;33;0;33;1
2019-04-07 11:30:00;NORTE;30;0;30;1
2019-04-07 12:00:00;NORTE;29;0;29;1
2019-04-07 12:30:00;NORTE;29;0;29;1
2019-04-07 13:00:00;NORTE;33;0;33;1
2019-04-07 13:30:00;NORTE;31;0;31;1
2019-04-07 14:00:00;NORTE;36;0;36;1
2019-04-07 14:30:00;NORTE;30;0;30;1
2019-04-07 15:00:00;NORTE;26;0;26;1
2019-04-07 15:30:00;CONFLICTIVA;7;14;21;2
2019-04-07 16:00:00;SUR;0;16;16;1
2019-04-07 16:30:00;SUR;0;28;28;1
2019-04-07 17:00:00;SUR;2;19;21;1
2019-04-07 17:30:00;NORTE;29;0;29;1
2019-04-07 18:00:00;NORTE;37;0;37;1
2019-04-07 18:30:00;NORTE;29;0;29;1
2019-04-07 19:00:00;NORTE;29;0;29;1
2019-04-07 19:30:00;NORTE;28;0;28;1
2019-04-07 20:00:00;NORTE;33;0;33;1
2019-04-07 20:30:00;NORTE;30;0;30;1
2019-04-07 21:00:00;NORTE;15;0;15;1
2019-04-07 21:30:00;NORTE;14;0;14;1
2019-04-07 22:00:00;NORTE;11;0;11;1
2019-04-07 22:30:00;NORTE;6;0;6;1
2019-04-07 23:00:00;NORTE;3;0;3;1
2019-04-08 00:00:00;NORTE;5;0;5;1
2019-04-08 01:00:00;NORTE;2;0;2;1
2019-04-08 01:30:00;NORTE;2;0;2;1
2019-04-08 02:00:00;NORTE;4;0;4;1
2019-04-08 02:44:00;NORTE;2;0;2;1
2019-04-08 03:00:00;NORTE;3;0;3;1
2019-04-08 03:30:00;NORTE;5;0;5;1
2019-04-08 04:00:00;NORTE;8;0;8;1
2019-04-08 04:30:00;NORTE;7;0;7;1
2019-04-08 04:52:00;NORTE;3;0;3;1
2019-04-08 05:00:00;NORTE;12;0;12;1
2019-04-08 05:21:00;NORTE;7;0;7;1
2019-04-08 05:30:00;NORTE;21;0;21;1
2019-04-08 05:46:00;NORTE;14;0;14;1
2019-04-08 06:00:00;NORTE;24;0;24;1
2019-04-08 06:30:00;NORTE;28;0;28;1
2019-04-08 07:00:00;NORTE;34;0;34;1
2019-04-08 07:30:00;NORTE;32;0;32;1
2019-04-08 08:00:00;CONFLICTIVA;18;7;25;2
2019-04-08 08:30:00;SUR;0;39;39;1
2019-04-08 09:00:00;SUR;0;25;25;1
2019-04-08 09:30:00;SUR;0;31;31;1
2019-04-08 10:00:00;SUR;0;31;31;1
2019-04-08 10:30:00;SUR;0;29;29;1
2019-04-08 11:00:00;SUR;0;28;28;1
2019-04-08 11:30:00;SUR;0;25;25;1
2019-04-08 12:00:00;NORTE;22;0;22;1
2019-04-08 12:30:00;NORTE;28;0;28;1
2019-04-08 13:00:00;NORTE;39;0;39;1
2019-04-08 13:30:00;NORTE;35;0;35;1
2019-04-08 14:00:00;NORTE;32;0;32;1
2019-04-08 14:30:00;NORTE;34;0;34;1
2019-04-08 15:00:00;NORTE;30;0;30;1
2019-04-08 15:30:00;NORTE;19;0;19;1
2019-04-08 16:00:00;NORTE;24;0;24;1
2019-04-08 16:30:00;NORTE;30;0;30;1
2019-04-08 17:00:00;NORTE;26;0;26;1
2019-04-08 17:30:00;NORTE;28;0;28;1
2019-04-08 18:00:00;NORTE;36;0;36;1
2019-04-08 18:30:00;NORTE;31;0;31;1
2019-04-08 19:00:00;NORTE;29;0;29;1
2019-04-08 19:30:00;NORTE;30;0;30;1
2019-04-08 20:00:00;NORTE;31;0;31;1
2019-04-08 20:30:00;NORTE;18;0;18;1
2019-04-08 21:00:00;NORTE;19;0;19;1
2019-04-08 21:30:00;NORTE;11;0;11;1
2019-04-08 22:00:00;NORTE;15;0;15;1
2019-04-08 22:30:00;NORTE;4;0;4;1
2019-04-08 23:00:00;NORTE;3;0;3;1
2019-04-08 23:30:00;NORTE;1;0;1;1
2019-04-09 01:00:00;NORTE;1;0;1;1
2019-04-09 01:30:00;NORTE;2;0;2;1
2019-04-09 02:00:00;NORTE;9;0;9;1
2019-04-09 02:30:00;NORTE;1;0;1;1
2019-04-09 03:00:00;NORTE;2;0;2;1
2019-04-09 03:30:00;NORTE;8;0;8;1
2019-04-09 04:00:00;NORTE;7;0;7;1
2019-04-09 04:30:00;NORTE;13;0;13;1
2019-04-09 05:00:00;NORTE;27;0;27;1
2019-04-09 05:30:00;NORTE;37;0;37;1
2019-04-09 06:00:00;NORTE;20;0;20;1
2019-04-09 06:30:00;NORTE;25;0;25;1
2019-04-09 07:00:00;NORTE;32;0;32;1
2019-04-09 07:30:00;NORTE;25;0;25;1
2019-04-09 08:00:00;NORTE;34;0;34;1
2019-04-09 08:30:00;NORTE;34;0;34;1
2019-04-09 09:00:00;CONFLICTIVA;24;3;27;2
2019-04-09 09:30:00;SUR;0;34;34;1
2019-04-09 10:00:00;SUR;0;35;35;1
2019-04-09 10:30:00;SUR;0;31;31;1
2019-04-09 11:00:00;SUR;0;27;27;1
2019-04-09 11:30:00;SUR;0;30;30;1
2019-04-09 12:00:00;SUR;0;25;25;1
2019-04-09 12:30:00;SUR;0;27;27;1
2019-04-09 13:00:00;SUR;0;15;15;1
2019-04-09 13:18:00;CONFLICTIVA;1;4;5;2
2019-04-09 13:30:00;NORTE;33;0;33;1
2019-04-09 14:00:00;NORTE;40;0;40;1
2019-04-09 14:30:00;NORTE;29;0;29;1
2019-04-09 15:00:00;NORTE;34;0;34;1
2019-04-09 15:30:00;NORTE;19;0;19;1
2019-04-09 16:00:00;NORTE;24;0;24;1
2019-04-09 16:30:00;NORTE;33;0;33;1
2019-04-09 17:00:00;NORTE;30;0;30;1
2019-04-09 17:30:00;NORTE;24;0;24;1
2019-04-09 18:00:00;NORTE;38;0;38;1
2019-04-09 18:30:00;NORTE;31;0;31;1
2019-04-09 19:00:00;NORTE;23;0;23;1
2019-04-09 19:30:00;NORTE;31;0;31;1
2019-04-09 20:00:00;NORTE;28;0;28;1
2019-04-09 20:30:00;NORTE;29;0;29;1
2019-04-09 21:00:00;NORTE;17;0;17;1
2019-04-09 21:30:00;NORTE;15;0;15;1
2019-04-09 22:00:00;NORTE;13;0;13;1
2019-04-09 22:30:00;NORTE;4;0;4;1
2019-04-09 23:00:00;NORTE;4;0;4;1
2019-04-10 00:00:00;NORTE;1;0;1;1
2019-04-10 00:30:00;NORTE;2;0;2;1
2019-04-10 01:30:00;NORTE;1;0;1;1
2019-04-10 02:00:00;NORTE;3;0;3;1
2019-04-10 02:30:00;NORTE;3;0;3;1
2019-04-10 03:00:00;NORTE;1;0;1;1
2019-04-10 03:30:00;NORTE;11;0;11;1
2019-04-10 04:00:00;NORTE;9;0;9;1
2019-04-10 04:30:00;NORTE;12;0;12;1
2019-04-10 05:00:00;NORTE;21;0;21;1
2019-04-10 05:30:00;NORTE;38;0;38;1
2019-04-10 06:00:00;NORTE;22;0;22;1
2019-04-10 06:30:00;NORTE;26;0;26;1
2019-04-10 07:00:00;NORTE;39;0;39;1
2019-04-10 07:30:00;NORTE;26;0;26;1
2019-04-10 08:00:00;NORTE;28;0;28;1
2019-04-10 08:30:00;NORTE;36;0;36;1
2019-04-10 09:00:00;NORTE;26;0;26;1
2019-04-10 09:30:00;NORTE;33;0;33;1
2019-04-10 10:00:00;NORTE;36;0;36;1
2019-04-10 10:30:00;NORTE;31;0;31;1
2019-04-10 11:00:00;NORTE;30;0;30;1
2019-04-10 11:30:00;NORTE;26;0;26;1
2019-04-10 12:00:00;NORTE;26;0;26;1
2019-04-10 12:30:00;NORTE;30;0;30;1
2019-04-10 13:00:00;NORTE;40;0;40;1
2019-04-10 13:30:00;NORTE;30;0;30;1
2019-04-10 14:00:00;NORTE;36;0;36;1
2019-04-10 14:30:00;NORTE;35;0;35;1
2019-04-10 15:00:00;NORTE;25;0;25;1
2019-04-10 15:30:00;NORTE;23;0;23;1
2019-04-10 16:00:00;NORTE;16;0;16;1
2019-04-10 16:30:00;NORTE;25;0;25;1
2019-04-10 17:00:00;NORTE;26;0;26;1
2019-04-10 17:30:00;NORTE;32;0;32;1
2019-04-10 18:00:00;NORTE;40;0;40;1
2019-04-10 18:30:00;NORTE;35;0;35;1
2019-04-10 19:00:00;NORTE;33;0;33;1
2019-04-10 19:30:00;NORTE;25;0;25;1
2019-04-10 20:00:00;NORTE;34;0;34;1
2019-04-10 20:30:00;NORTE;29;0;29;1
2019-04-10 21:00:00;NORTE;15;0;15;1
2019-04-10 21:30:00;NORTE;11;0;11;1
2019-04-10 22:00:00;NORTE;10;0;10;1
2019-04-11 08:00:00;NORTE;29;0;29;1
2019-04-11 08:30:00;NORTE;32;0;32;1
2019-04-11 09:00:00;NORTE;21;0;21;1
2019-04-11 09:30:00;NORTE;33;0;33;1
2019-04-11 10:00:00;NORTE;30;0;30;1
2019-04-11 10:30:00;NORTE;28;0;28;1
2019-04-11 11:00:00;NORTE;31;0;31;1
2019-04-11 11:30:00;NORTE;25;0;25;1
2019-04-11 12:00:00;NORTE;23;0;23;1
2019-04-11 12:30:00;NORTE;32;0;32;1
2019-04-11 13:00:00;NORTE;42;0;42;1
2019-04-11 13:30:00;NORTE;25;0;25;1
2019-04-11 14:00:00;NORTE;40;0;40;1
2019-04-11 14:30:00;NORTE;38;0;38;1
2019-04-11 15:00:00;NORTE;24;0;24;1
2019-04-11 15:30:00;NORTE;21;0;21;1
2019-04-11 16:00:00;NORTE;19;0;19;1
2019-04-11 16:30:00;NORTE;25;0;25;1
2019-04-11 17:00:00;NORTE;29;0;29;1
2019-04-11 17:30:00;NORTE;26;0;26;1
2019-04-11 18:00:00;NORTE;37;0;37;1
2019-04-11 18:30:00;NORTE;34;0;34;1
2019-04-11 19:00:00;NORTE;31;0;31;1
2019-04-11 19:30:00;NORTE;28;0;28;1
2019-04-11 20:00:00;NORTE;29;0;29;1
2019-04-11 20:30:00;NORTE;27;0;27;1
2019-04-11 21:00:00;NORTE;13;0;13;1
2019-04-11 21:30:00;NORTE;17;0;17;1
2019-04-11 22:00:00;NORTE;10;0;10;1
2019-04-11 22:30:00;NORTE;5;0;5;1
2019-04-11 23:00:00;NORTE;1;0;1;1
2019-04-11 23:30:00;NORTE;1;0;1;1
2019-04-12 00:00:00;NORTE;1;0;1;1
2019-04-12 00:30:00;NORTE;3;0;3;1
2019-04-12 01:30:00;NORTE;2;0;2;1
2019-04-12 02:00:00;NORTE;3;0;3;1
2019-04-12 02:30:00;NORTE;3;0;3;1
2019-04-12 03:00:00;NORTE;7;0;7;1
2019-04-12 03:30:00;NORTE;9;0;9;1
2019-04-12 04:00:00;NORTE;12;0;12;1
2019-04-12 04:30:00;NORTE;10;0;10;1
2019-04-12 05:00:00;NORTE;17;0;17;1
2019-04-12 05:30:00;NORTE;35;0;35;1
2019-04-12 06:00:00;NORTE;32;0;32;1
2019-04-12 06:30:00;NORTE;24;0;24;1
2019-04-12 07:00:00;NORTE;41;0;41;1
2019-04-12 07:30:00;NORTE;26;0;26;1
2019-04-12 08:00:00;NORTE;34;0;34;1
2019-04-12 08:30:00;NORTE;36;0;36;1
2019-04-12 09:00:00;NORTE;20;0;20;1
2019-04-12 09:30:00;NORTE;35;0;35;1
2019-04-12 10:00:00;NORTE;38;0;38;1
2019-04-12 10:30:00;NORTE;32;0;32;1
2019-04-12 11:00:00;NORTE;30;0;30;1
2019-04-12 11:30:00;NORTE;28;0;28;1
2019-04-12 12:00:00;NORTE;27;0;27;1
2019-04-12 12:30:00;NORTE;36;0;36;1
2019-04-12 13:00:00;NORTE;32;0;32;1
2019-04-12 13:30:00;NORTE;31;0;31;1
2019-04-12 14:00:00;NORTE;37;0;37;1
2019-04-12 14:30:00;NORTE;31;0;31;1
2019-04-12 15:00:00;NORTE;30;0;30;1
2019-04-12 15:30:00;NORTE;26;0;26;1
2019-04-12 16:00:00;NORTE;23;0;23;1
2019-04-12 16:30:00;NORTE;35;0;35;1
2019-04-12 17:00:00;NORTE;30;0;30;1
2019-04-12 17:30:00;NORTE;24;0;24;1
2019-04-12 18:00:00;NORTE;37;0;37;1
2019-04-12 18:30:00;NORTE;25;0;25;1
2019-04-12 19:00:00;NORTE;36;0;36;1
2019-04-12 19:30:00;NORTE;34;0;34;1
2019-04-12 20:00:00;NORTE;28;0;28;1
2019-04-12 20:30:00;NORTE;26;0;26;1
2019-04-12 21:00:00;NORTE;22;0;22;1
2019-04-12 21:30:00;NORTE;19;0;19;1
2019-04-12 22:00:00;NORTE;13;0;13;1
2019-04-12 22:30:00;NORTE;10;0;10;1
2019-04-13 00:00:00;NORTE;5;0;5;1
2019-04-13 01:00:00;NORTE;2;0;2;1
2019-04-13 01:30:00;NORTE;1;0;1;1
2019-04-13 02:00:00;NORTE;4;0;4;1
2019-04-13 02:30:00;NORTE;4;0;4;1
2019-04-13 03:00:00;NORTE;1;0;1;1
2019-04-13 03:30:00;NORTE;6;0;6;1
2019-04-13 04:00:00;NORTE;12;0;12;1
2019-04-13 04:30:00;NORTE;9;0;9;1
2019-04-13 05:00:00;NORTE;21;0;21;1
2019-04-13 05:30:00;NORTE;31;0;31;1
2019-04-13 06:00:00;NORTE;21;0;21;1
2019-04-13 06:30:00;NORTE;21;0;21;1
2019-04-13 07:00:00;NORTE;43;0;43;1
2019-04-13 07:30:00;NORTE;28;0;28;1
2019-04-13 08:00:00;NORTE;29;0;29;1
2019-04-13 08:30:00;NORTE;39;0;39;1
2019-04-13 09:00:00;NORTE;21;0;21;1
2019-04-13 09:30:00;NORTE;35;0;35;1
2019-04-13 10:00:00;NORTE;27;0;27;1
2019-04-13 10:30:00;NORTE;39;0;39;1
2019-04-13 11:00:00;NORTE;32;0;32;1
2019-04-13 11:30:00;NORTE;17;0;17;1
2019-04-13 12:00:00;NORTE;20;0;20;1
2019-04-13 12:30:00;NORTE;32;0;32;1
2019-04-13 13:00:00;NORTE;35;0;35;1
2019-04-13 13:30:00;NORTE;30;0;30;1
2019-04-13 14:00:00;NORTE;35;0;35;1
2019-04-13 14:30:00;NORTE;31;0;31;1
2019-04-13 15:00:00;NORTE;25;0;25;1
2019-04-13 15:30:00;NORTE;21;0;21;1
2019-04-13 16:00:00;NORTE;19;0;19;1
2019-04-13 16:30:00;NORTE;27;0;27;1
2019-04-13 17:00:00;NORTE;13;0;13;1
2019-04-13 17:30:00;NORTE;18;0;18;1
2019-04-13 18:00:00;NORTE;41;0;41;1
2019-04-13 18:30:00;NORTE;23;0;23;1
2019-04-13 19:00:00;NORTE;28;0;28;1
2019-04-13 19:30:00;NORTE;25;0;25;1
2019-04-13 20:00:00;NORTE;27;0;27;1
2019-04-13 20:30:00;NORTE;17;0;17;1
2019-04-13 21:00:00;NORTE;10;0;10;1
2019-04-13 21:30:00;NORTE;11;0;11;1
2019-04-13 22:00:00;NORTE;11;0;11;1
2019-04-13 22:30:00;NORTE;7;0;7;1
2019-04-13 23:00:00;NORTE;4;0;4;1
2019-04-13 23:30:00;NORTE;2;0;2;1
2019-04-14 00:00:00;NORTE;1;0;1;1
2019-04-14 00:30:00;NORTE;3;0;3;1
2019-04-14 01:00:00;NORTE;2;0;2;1
2019-04-14 01:30:00;NORTE;1;0;1;1
2019-04-14 02:00:00;NORTE;2;0;2;1
2019-04-14 02:30:00;NORTE;3;0;3;1
2019-04-14 03:00:00;NORTE;3;0;3;1
2019-04-14 03:30:00;NORTE;3;0;3;1
2019-04-14 04:00:00;NORTE;10;0;10;1
2019-04-14 04:30:00;NORTE;7;0;7;1
2019-04-14 05:00:00;NORTE;16;0;16;1
2019-04-14 05:30:00;NORTE;28;0;28;1
2019-04-14 06:00:00;NORTE;15;0;15;1
2019-04-14 06:30:00;NORTE;25;0;25;1
2019-04-14 07:00:00;NORTE;31;0;31;1
2019-04-14 07:30:00;NORTE;24;0;24;1
2019-04-14 08:00:00;NORTE;33;0;33;1
2019-04-14 08:30:00;NORTE;41;0;41;1
2019-04-14 09:00:00;NORTE;25;0;25;1
2019-04-14 09:30:00;NORTE;26;0;26;1
2019-04-14 10:00:00;NORTE;37;0;37;1
2019-04-14 10:30:00;NORTE;33;0;33;1
2019-04-14 11:00:00;NORTE;28;0;28;1
2019-04-14 11:30:00;NORTE;28;0;28;1
2019-04-14 12:00:00;NORTE;31;0;31;1
2019-04-14 12:30:00;NORTE;32;0;32;1
2019-04-14 13:00:00;NORTE;35;0;35;1
2019-04-14 13:30:00;CONFLICTIVA;17;6;23;2
2019-04-14 14:00:00;SUR;0;42;42;1
2019-04-14 14:30:00;SUR;0;33;33;1
2019-04-14 15:00:00;SUR;0;24;24;1
2019-04-14 15:30:00;SUR;0;19;19;1
2019-04-14 16:00:00;SUR;0;18;18;1
2019-04-14 16:30:00;SUR;0;31;31;1
2019-04-14 17:00:00;SUR;0;27;27;1
2019-04-14 17:30:00;SUR;0;24;24;1
2019-04-14 18:00:00;SUR;0;37;37;1
2019-04-14 18:30:00;SUR;0;35;35;1
2019-04-14 19:00:00;SUR;0;34;34;1
2019-04-14 19:30:00;SUR;0;29;29;1
2019-04-14 20:00:00;CONFLICTIVA;25;4;29;2
2019-04-14 20:30:00;NORTE;35;0;35;1
2019-04-14 21:00:00;NORTE;15;0;15;1
2019-04-14 21:30:00;NORTE;14;0;14;1
2019-04-14 22:00:00;NORTE;13;0;13;1
2019-04-14 22:30:00;NORTE;8;0;8;1
2019-04-14 23:00:00;NORTE;4;0;4;1
2019-04-14 23:30:00;NORTE;3;0;3;1
2019-04-15 00:00:00;NORTE;1;0;1;1
2019-04-15 00:30:00;NORTE;2;0;2;1
2019-04-15 01:00:00;NORTE;2;0;2;1
2019-04-15 01:30:00;NORTE;1;0;1;1
2019-04-15 02:00:00;NORTE;4;0;4;1
2019-04-15 02:30:00;NORTE;4;0;4;1
2019-04-15 03:00:00;NORTE;4;0;4;1
2019-04-15 03:30:00;NORTE;6;0;6;1
2019-04-15 04:00:00;NORTE;7;0;7;1
2019-04-15 04:30:00;NORTE;10;0;10;1
2019-04-15 05:00:00;NORTE;19;0;19;1
2019-04-15 05:30:00;NORTE;38;0;38;1
2019-04-15 06:00:00;NORTE;17;0;17;1
2019-04-15 06:30:00;NORTE;28;0;28;1
2019-04-15 07:00:00;NORTE;31;0;31;1
2019-04-15 07:30:00;NORTE;31;0;31;1
2019-04-15 08:00:00;NORTE;29;0;29;1
2019-04-15 08:30:00;NORTE;28;0;28;1
2019-04-15 09:00:00;NORTE;21;0;21;1
2019-04-15 09:30:00;NORTE;34;0;34;1
2019-04-15 10:00:00;NORTE;36;0;36;1
2019-04-15 10:30:00;NORTE;28;0;28;1
2019-04-15 11:00:00;CONFLICTIVA;12;11;23;2
2019-04-15 11:30:00;SUR;0;29;29;1
2019-04-15 12:00:00;SUR;0;28;28;1
2019-04-15 12:30:00;SUR;0;34;34;1
2019-04-15 13:00:00;SUR;0;30;30;1
2019-04-15 13:30:00;SUR;0;25;25;1
2019-04-15 14:00:00;SUR;0;37;37;1
2019-04-15 14:30:00;SUR;0;35;35;1
2019-04-15 15:00:00;SUR;0;25;25;1
2019-04-15 15:30:00;SUR;0;22;22;1
2019-04-15 16:00:00;SUR;0;25;25;1
2019-04-15 16:30:00;SUR;0;26;26;1
2019-04-15 17:00:00;SUR;0;21;21;1
2019-04-15 17:30:00;SUR;0;21;21;1
2019-04-15 18:00:00;SUR;0;33;33;1
2019-04-15 18:30:00;CONFLICTIVA;18;8;26;2
2019-04-15 19:00:00;NORTE;32;0;32;1
2019-04-15 19:30:00;NORTE;28;0;28;1
2019-04-15 20:00:00;NORTE;24;0;24;1
2019-04-15 20:30:00;NORTE;22;0;22;1
2019-04-15 21:00:00;NORTE;11;0;11;1
2019-04-15 21:30:00;NORTE;14;0;14;1
2019-04-15 22:00:00;NORTE;15;0;15;1
2019-04-15 22:30:00;NORTE;5;0;5;1
2019-04-15 23:00:00;NORTE;2;0;2;1
2019-04-16 00:30:00;NORTE;1;0;1;1
2019-04-16 01:00:00;NORTE;2;0;2;1
2019-04-16 01:30:00;NORTE;1;0;1;1
2019-04-16 02:00:00;NORTE;4;0;4;1
2019-04-16 02:30:00;NORTE;4;0;4;1
2019-04-16 03:30:00;NORTE;7;0;7;1
2019-04-16 04:00:00;NORTE;8;0;8;1
2019-04-16 04:30:00;NORTE;9;0;9;1
2019-04-16 05:00:00;NORTE;18;0;18;1
2019-04-16 05:30:00;NORTE;36;0;36;1
2019-04-16 06:00:00;NORTE;20;0;20;1
2019-04-16 06:30:00;NORTE;26;0;26;1
2019-04-16 07:00:00;NORTE;31;0;31;1
2019-04-16 07:30:00;NORTE;27;0;27;1
2019-04-16 08:00:00;NORTE;28;0;28;1
2019-04-16 08:30:00;NORTE;28;0;28;1
2019-04-16 09:00:00;NORTE;29;0;29;1
2019-04-16 09:30:00;NORTE;30;0;30;1
2019-04-16 10:00:00;NORTE;37;0;37;1
2019-04-16 10:30:00;NORTE;31;0;31;1
2019-04-16 11:00:00;NORTE;31;0;31;1
2019-04-16 11:30:00;NORTE;27;0;27;1
2019-04-16 12:00:00;NORTE;18;0;18;1
2019-04-16 12:30:00;NORTE;31;0;31;1
2019-04-16 13:00:00;CONFLICTIVA;14;17;31;2
2019-04-16 13:30:00;SUR;0;31;31;1
2019-04-16 14:00:00;SUR;0;36;36;1
2019-04-16 14:30:00;SUR;0;29;29;1
2019-04-16 15:00:00;SUR;0;25;25;1
2019-04-16 15:30:00;SUR;0;22;22;1
2019-04-16 16:00:00;SUR;0;19;19;1
2019-04-16 16:30:00;SUR;0;20;20;1
2019-04-16 17:00:00;SUR;0;22;22;1
2019-04-16 17:30:00;SUR;0;31;31;1
2019-04-16 18:00:00;SUR;0;37;37;1
2019-04-16 18:30:00;SUR;0;30;30;1
2019-04-16 19:00:00;SUR;0;29;29;1
2019-04-16 19:30:00;NORTE;22;2;24;1
2019-04-16 20:00:00;NORTE;24;0;24;1
2019-04-16 20:30:00;NORTE;17;0;17;1
2019-04-16 21:00:00;NORTE;16;0;16;1
2019-04-16 21:30:00;NORTE;11;0;11;1
2019-04-16 22:00:00;NORTE;11;0;11;1
2019-04-16 22:30:00;CONFLICTIVA;4;3;7;2
2019-04-16 23:00:00;SUR;0;4;4;1
2019-04-16 23:30:00;SUR;0;2;2;1
2019-04-17 00:30:00;SUR;0;2;2;1
2019-04-17 01:00:00;SUR;0;3;3;1
2019-04-17 01:30:00;SUR;0;1;1;1
2019-04-17 02:00:00;SUR;0;1;1;1
2019-04-17 02:30:00;SUR;0;5;5;1
2019-04-17 03:00:00;SUR;0;3;3;1
2019-04-17 03:30:00;SUR;0;9;9;1
2019-04-17 04:00:00;SUR;0;13;13;1
2019-04-17 04:30:00;SUR;0;7;7;1
2019-04-17 05:00:00;SUR;0;21;21;1
2019-04-17 05:30:00;SUR;0;34;34;1
2019-04-17 06:00:00;SUR;0;20;20;1
2019-04-17 06:30:00;SUR;0;25;25;1
2019-04-17 07:00:00;SUR;0;31;31;1
2019-04-17 07:30:00;SUR;0;21;21;1
2019-04-17 08:00:00;SUR;0;34;34;1
2019-04-17 08:30:00;SUR;0;34;34;1
2019-04-17 09:00:00;SUR;0;19;19;1
2019-04-17 09:30:00;SUR;0;34;34;1
2019-04-17 10:00:00;SUR;0;41;41;1
2019-04-17 10:30:00;SUR;0;32;32;1
2019-04-17 11:00:00;SUR;0;27;27;1
2019-04-17 11:30:00;SUR;0;23;23;1
2019-04-17 12:00:00;SUR;0;9;9;1
2019-04-17 12:30:00;SUR;0;23;23;1
2019-04-17 13:00:00;SUR;0;36;36;1
2019-04-17 13:30:00;SUR;0;32;32;1
2019-04-17 14:00:00;SUR;0;40;40;1
2019-04-17 14:30:00;SUR;0;33;33;1
2019-04-17 15:00:00;SUR;0;25;25;1
2019-04-17 15:30:00;SUR;0;21;21;1
2019-04-17 16:00:00;SUR;0;20;20;1
2019-04-17 16:30:00;SUR;0;33;33;1
2019-04-17 17:00:00;SUR;0;23;23;1
2019-04-17 17:30:00;SUR;0;26;26;1
2019-04-17 18:00:00;SUR;0;35;35;1
2019-04-17 18:30:00;SUR;0;25;25;1
2019-04-17 19:00:00;SUR;0;32;32;1
2019-04-17 19:30:00;SUR;0;31;31;1
2019-04-17 20:00:00;SUR;0;31;31;1
2019-04-17 20:30:00;SUR;0;25;25;1
2019-04-17 21:00:00;CONFLICTIVA;8;4;12;2
2019-04-17 21:30:00;NORTE;23;0;23;1
2019-04-17 22:00:00;NORTE;10;1;11;1
2019-04-17 22:30:00;SUR;0;5;5;1
2019-04-17 23:00:00;SUR;0;2;2;1
2019-04-18 00:00:00;SUR;0;1;1;1
2019-04-18 00:30:00;SUR;0;2;2;1
2019-04-18 01:12:00;SUR;0;3;3;1
2019-04-18 01:30:00;SUR;0;1;1;1
2019-04-18 02:00:00;SUR;0;2;2;1
2019-04-18 02:30:00;CONFLICTIVA;1;2;3;2
2019-04-18 03:00:00;NORTE;3;0;3;1
2019-04-18 03:30:00;NORTE;10;0;10;1
2019-04-18 04:00:00;NORTE;8;0;8;1
2019-04-18 04:30:00;NORTE;2;0;2;1
2019-04-18 04:37:00;NORTE;8;0;8;1
2019-04-18 05:00:00;NORTE;15;0;15;1
2019-04-18 05:30:00;NORTE;36;0;36;1
2019-04-18 06:00:00;NORTE;17;0;17;1
2019-04-18 06:30:00;NORTE;29;0;29;1
2019-04-18 07:00:00;NORTE;30;0;30;1
2019-04-18 07:30:00;NORTE;31;0;31;1
2019-04-18 08:00:00;NORTE;34;0;34;1
2019-04-18 08:30:00;NORTE;29;0;29;1
2019-04-18 09:00:00;NORTE;26;0;26;1
2019-04-18 09:30:00;NORTE;35;0;35;1
2019-04-18 10:00:00;NORTE;28;0;28;1
2019-04-18 10:18:00;NORTE;13;0;13;1
2019-04-18 10:30:00;NORTE;25;0;25;1
2019-04-18 11:00:00;NORTE;32;0;32;1
2019-04-18 11:30:00;NORTE;25;0;25;1
2019-04-18 12:00:00;NORTE;27;0;27;1
2019-04-18 12:30:00;NORTE;28;0;28;1
2019-04-18 13:00:00;NORTE;41;0;41;1
2019-04-18 13:30:00;NORTE;30;0;30;1
2019-04-18 14:00:00;NORTE;37;0;37;1
2019-04-18 14:30:00;NORTE;38;0;38;1
2019-04-18 15:00:00;NORTE;24;0;24;1
2019-04-18 15:30:00;NORTE;18;0;18;1
2019-04-18 16:00:00;NORTE;20;0;20;1
2019-04-18 16:30:00;NORTE;23;0;23;1
2019-04-18 17:00:00;NORTE;22;0;22;1
2019-04-18 17:30:00;NORTE;28;0;28;1
2019-04-18 18:00:00;NORTE;25;0;25;1
2019-04-18 18:22:00;NORTE;4;0;4;1
2019-04-18 18:30:00;NORTE;35;0;35;1
2019-04-18 19:00:00;NORTE;28;0;28;1
2019-04-18 19:30:00;NORTE;35;0;35;1
2019-04-18 20:00:00;NORTE;29;0;29;1
2019-04-18 20:30:00;NORTE;18;0;18;1
2019-04-18 21:00:00;NORTE;14;0;14;1
2019-04-18 21:30:00;NORTE;17;0;17;1
2019-04-18 22:00:00;NORTE;5;0;5;1
2019-04-18 22:14:00;NORTE;6;0;6;1
2019-04-18 22:30:00;NORTE;5;0;5;1
2019-04-18 23:00:00;NORTE;3;0;3;1
2019-04-19 00:00:00;NORTE;1;0;1;1
2019-04-19 01:00:00;NORTE;2;0;2;1
2019-04-19 01:30:00;NORTE;1;0;1;1
2019-04-19 02:00:00;NORTE;4;0;4;1
2019-04-19 02:30:00;NORTE;2;0;2;1
2019-04-19 03:00:00;NORTE;3;0;3;1
2019-04-19 03:30:00;NORTE;8;0;8;1
2019-04-19 04:00:00;NORTE;10;0;10;1
2019-04-19 04:30:00;NORTE;9;0;9;1
2019-04-19 05:00:00;NORTE;15;0;15;1
2019-04-19 05:30:00;NORTE;32;0;32;1
2019-04-19 06:00:00;NORTE;17;0;17;1
2019-04-19 06:30:00;NORTE;25;0;25;1
2019-04-19 07:00:00;NORTE;39;0;39;1
2019-04-19 07:30:00;NORTE;27;0;27;1
2019-04-19 08:00:00;NORTE;32;0;32;1
2019-04-19 08:30:00;NORTE;32;0;32;1
2019-04-19 09:00:00;NORTE;20;0;20;1
2019-04-19 09:30:00;NORTE;31;0;31;1
2019-04-19 10:00:00;NORTE;32;0;32;1
2019-04-19 10:30:00;NORTE;32;0;32;1
2019-04-19 11:00:00;NORTE;27;0;27;1
2019-04-19 11:30:00;NORTE;32;0;32;1
2019-04-19 12:00:00;NORTE;28;0;28;1
2019-04-19 12:30:00;NORTE;22;0;22;1
2019-04-19 13:00:00;NORTE;36;0;36;1
2019-04-19 13:30:00;NORTE;31;0;31;1
2019-04-19 14:00:00;NORTE;38;0;38;1
2019-04-19 14:30:00;NORTE;25;0;25;1
2019-04-19 15:00:00;NORTE;26;0;26;1
2019-04-19 15:30:00;NORTE;25;0;25;1
2019-04-19 16:00:00;NORTE;5;0;5;1
2019-04-19 16:09:00;NORTE;15;0;15;1
2019-04-19 16:30:00;NORTE;33;0;33;1
2019-04-19 17:00:00;NORTE;31;0;31;1
2019-04-19 17:30:00;NORTE;21;0;21;1
2019-04-19 18:00:00;NORTE;40;0;40;1
2019-04-19 18:30:00;NORTE;29;0;29;1
2019-04-19 19:00:00;NORTE;26;0;26;1
2019-04-19 19:30:00;NORTE;26;0;26;1
2019-04-19 20:00:00;NORTE;24;0;24;1
2019-04-19 20:30:00;NORTE;21;0;21;1
2019-04-19 21:00:00;NORTE;15;0;15;1
2019-04-19 21:30:00;NORTE;12;0;12;1
2019-04-19 22:00:00;NORTE;11;0;11;1
2019-04-19 22:30:00;NORTE;4;0;4;1
2019-04-19 23:30:00;NORTE;1;0;1;1
2019-04-20 00:00:00;NORTE;2;0;2;1
2019-04-20 01:00:00;NORTE;2;0;2;1
2019-04-20 02:00:00;NORTE;3;0;3;1
2019-04-20 02:30:00;NORTE;3;0;3;1
2019-04-20 03:30:00;NORTE;5;0;5;1
2019-04-20 04:00:00;NORTE;10;0;10;1
2019-04-20 04:30:00;NORTE;10;0;10;1
2019-04-20 05:00:00;NORTE;22;0;22;1
2019-04-20 05:30:00;NORTE;29;0;29;1
2019-04-20 06:00:00;NORTE;19;0;19;1
2019-04-20 06:30:00;NORTE;23;0;23;1
2019-04-20 07:00:00;NORTE;34;0;34;1
2019-04-20 07:30:00;NORTE;27;0;27;1
2019-04-20 08:00:00;NORTE;31;0;31;1
2019-04-20 08:30:00;NORTE;32;0;32;1
2019-04-20 09:00:00;NORTE;25;0;25;1
2019-04-20 09:30:00;NORTE;32;0;32;1
2019-04-20 10:00:00;NORTE;31;0;31;1
2019-04-20 10:30:00;NORTE;35;0;35;1
2019-04-20 11:00:00;NORTE;25;0;25;1
2019-04-20 11:30:00;NORTE;22;0;22;1
2019-04-20 12:00:00;NORTE;24;0;24;1
2019-04-20 12:30:00;NORTE;32;0;32;1
2019-04-20 13:00:00;NORTE;33;0;33;1
2019-04-20 13:30:00;NORTE;32;0;32;1
2019-04-20 14:00:00;NORTE;35;0;35;1
2019-04-20 14:30:00;NORTE;24;0;24;1
2019-04-20 15:00:00;NORTE;26;0;26;1
2019-04-20 15:30:00;NORTE;18;0;18;1
2019-04-20 16:00:00;NORTE;22;0;22;1
2019-04-20 16:30:00;NORTE;22;0;22;1
2019-04-20 17:00:00;NORTE;17;0;17;1
2019-04-20 17:30:00;NORTE;17;0;17;1
2019-04-20 18:00:00;NORTE;37;0;37;1
2019-04-20 18:30:00;NORTE;19;0;19;1
2019-04-20 19:00:00;NORTE;25;0;25;1
2019-04-20 19:30:00;NORTE;28;0;28;1
2019-04-20 20:00:00;NORTE;17;0;17;1
2019-04-20 20:30:00;NORTE;18;0;18;1
2019-04-20 21:00:00;NORTE;12;0;12;1
2019-04-20 21:30:00;CONFLICTIVA;6;3;9;2
2019-04-20 22:00:00;SUR;0;18;18;1
2019-04-20 22:30:00;SUR;0;8;8;1
2019-04-20 23:00:00;NORTE;2;0;2;1
2019-04-20 23:30:00;NORTE;1;0;1;1
2019-04-21 00:00:00;NORTE;2;0;2;1
2019-04-21 00:30:00;NORTE;1;0;1;1
2019-04-21 01:00:00;NORTE;2;0;2;1
2019-04-21 01:30:00;NORTE;2;0;2;1
2019-04-21 02:00:00;NORTE;2;0;2;1
2019-04-21 02:30:00;NORTE;3;0;3;1
2019-04-21 03:00:00;NORTE;3;0;3;1
2019-04-21 03:30:00;NORTE;5;0;5;1
2019-04-21 04:00:00;NORTE;8;0;8;1
2019-04-21 04:30:00;NORTE;13;0;13;1
2019-04-21 05:00:00;NORTE;15;0;15;1
2019-04-21 05:30:00;NORTE;28;0;28;1
2019-04-21 06:00:00;NORTE;15;0;15;1
2019-04-21 06:30:00;NORTE;31;0;31;1
2019-04-21 07:00:00;NORTE;33;0;33;1
2019-04-21 07:30:00;NORTE;24;0;24;1
2019-04-21 08:00:00;NORTE;37;0;37;1
2019-04-21 08:30:00;NORTE;33;0;33;1
2019-04-21 09:00:00;NORTE;21;0;21;1
2019-04-21 09:30:00;NORTE;31;0;31;1
2019-04-21 10:00:00;NORTE;34;0;34;1
2019-04-21 10:30:00;NORTE;36;0;36;1
2019-04-21 11:00:00;NORTE;31;0;31;1
2019-04-21 11:30:00;NORTE;32;0;32;1
2019-04-21 12:00:00;NORTE;21;0;21;1
2019-04-21 12:30:00;NORTE;33;0;33;1
2019-04-21 13:00:00;NORTE;35;0;35;1
2019-04-21 13:30:00;NORTE;36;0;36;1
2019-04-21 14:00:00;NORTE;41;0;41;1
2019-04-21 14:30:00;NORTE;32;0;32;1
2019-04-21 15:00:00;NORTE;31;0;31;1
2019-04-21 15:30:00;NORTE;23;0;23;1
2019-04-21 16:00:00;NORTE;20;0;20;1
2019-04-21 16:30:00;NORTE;29;0;29;1
2019-04-21 17:00:00;NORTE;29;0;29;1
2019-04-21 17:30:00;NORTE;29;0;29;1
2019-04-21 18:00:00;NORTE;38;0;38;1
2019-04-21 18:30:00;NORTE;39;0;39;1
2019-04-21 19:00:00;NORTE;27;0;27;1
2019-04-21 19:30:00;NORTE;30;0;30;1
2019-04-21 20:00:00;NORTE;32;0;32;1
2019-04-21 20:30:00;NORTE;26;0;26;1
2019-04-21 21:00:00;NORTE;15;0;15;1
2019-04-21 21:30:00;NORTE;11;0;11;1
2019-04-21 22:00:00;NORTE;15;0;15;1
2019-04-21 22:30:00;NORTE;13;0;13;1
2019-04-21 23:00:00;NORTE;4;0;4;1
2019-04-21 23:30:00;NORTE;1;0;1;1
2019-04-22 00:00:00;NORTE;1;0;1;1
2019-04-22 00:30:00;NORTE;1;0;1;1
2019-04-22 01:00:00;NORTE;3;0;3;1
2019-04-22 01:30:00;NORTE;2;0;2;1
2019-04-22 02:00:00;NORTE;2;0;2;1
2019-04-22 02:30:00;NORTE;2;0;2;1
2019-04-22 03:00:00;NORTE;2;0;2;1
2019-04-22 03:30:00;NORTE;6;0;6;1
2019-04-22 04:00:00;NORTE;9;0;9;1
2019-04-22 04:30:00;NORTE;10;0;10;1
2019-04-22 05:00:00;NORTE;16;0;16;1
2019-04-22 05:30:00;NORTE;43;0;43;1
2019-04-22 06:00:00;NORTE;26;0;26;1
2019-04-22 06:30:00;NORTE;27;0;27;1
2019-04-22 07:00:00;NORTE;34;0;34;1
2019-04-22 07:30:00;NORTE;34;0;34;1
2019-04-22 08:00:00;NORTE;39;0;39;1
2019-04-22 08:30:00;NORTE;37;0;37;1
2019-04-22 09:00:00;NORTE;23;0;23;1
2019-04-22 09:30:00;NORTE;36;0;36;1
2019-04-22 10:00:00;NORTE;29;0;29;1
2019-04-22 10:30:00;NORTE;31;0;31;1
2019-04-22 11:00:00;NORTE;34;0;34;1
2019-04-22 11:30:00;NORTE;28;0;28;1
2019-04-22 12:00:00;NORTE;26;0;26;1
2019-04-22 12:30:00;NORTE;37;0;37;1
2019-04-22 13:00:00;NORTE;42;0;42;1
2019-04-22 13:30:00;NORTE;26;0;26;1
2019-04-22 14:00:00;NORTE;39;0;39;1
2019-04-22 14:30:00;NORTE;29;0;29;1
2019-04-22 15:00:00;NORTE;29;0;29;1
2019-04-22 15:30:00;NORTE;27;0;27;1
2019-04-22 16:00:00;NORTE;23;0;23;1
2019-04-22 16:30:00;NORTE;34;0;34;1
2019-04-22 17:00:00;NORTE;21;0;21;1
2019-04-22 17:30:00;NORTE;29;0;29;1
2019-04-22 18:00:00;NORTE;35;0;35;1
2019-04-22 18:30:00;NORTE;34;0;34;1
2019-04-22 19:00:00;NORTE;36;0;36;1
2019-04-22 19:30:00;NORTE;25;0;25;1
2019-04-22 20:00:00;NORTE;26;0;26;1
2019-04-22 20:30:00;NORTE;22;0;22;1
2019-04-22 21:00:00;NORTE;18;0;18;1
2019-04-22 21:30:00;NORTE;11;0;11;1
2019-04-22 22:00:00;NORTE;16;0;16;1
2019-04-22 22:30:00;NORTE;7;0;7;1
2019-04-22 23:00:00;NORTE;1;0;1;1
2019-04-23 00:30:00;SUR;0;1;1;1
2019-04-23 01:00:00;SUR;0;1;1;1
2019-04-23 01:30:00;SUR;0;1;1;1
2019-04-23 02:00:00;SUR;0;3;3;1
2019-04-23 02:30:00;SUR;0;7;7;1
2019-04-23 03:00:00;SUR;0;3;3;1
2019-04-23 03:30:00;SUR;0;6;6;1
2019-04-23 04:00:00;SUR;0;8;8;1
2019-04-23 04:30:00;SUR;0;13;13;1
2019-04-23 05:00:00;SUR;0;21;21;1
2019-04-23 05:30:00;SUR;0;42;42;1
2019-04-23 06:00:00;SUR;0;25;25;1
2019-04-23 06:30:00;SUR;0;24;24;1
2019-04-23 07:00:00;SUR;0;31;31;1
2019-04-23 07:30:00;SUR;0;23;23;1
2019-04-23 08:00:00;SUR;0;35;35;1
2019-04-23 08:30:00;SUR;0;30;30;1
2019-04-23 09:00:00;SUR;0;29;29;1
2019-04-23 09:30:00;SUR;0;31;31;1
2019-04-23 10:00:00;SUR;0;32;32;1
2019-04-23 10:30:00;SUR;0;33;33;1
2019-04-23 11:00:00;SUR;0;28;28;1
2019-04-23 11:30:00;SUR;0;31;31;1
2019-04-23 12:00:00;SUR;1;27;28;1
2019-04-23 12:30:00;SUR;0;24;24;1
2019-04-23 13:00:00;SUR;0;33;33;1
2019-04-23 13:30:00;SUR;0;35;35;1
2019-04-23 14:00:00;SUR;0;39;39;1
2019-04-23 14:30:00;SUR;0;26;26;1
2019-04-23 15:00:00;SUR;0;10;10;1
2019-04-23 15:11:00;SUR;0;12;12;1
2019-04-23 15:30:00;SUR;0;19;19;1
2019-04-23 16:00:00;SUR;0;21;21;1
2019-04-23 16:30:00;SUR;0;28;28;1
2019-04-23 17:00:00;SUR;0;23;23;1
2019-04-23 17:30:00;SUR;0;27;27;1
2019-04-23 18:00:00;SUR;0;40;40;1
2019-04-23 18:30:00;SUR;0;32;32;1
2019-04-23 19:00:00;SUR;0;22;22;1
2019-04-23 19:30:00;SUR;0;28;28;1
2019-04-23 20:00:20;SUR;0;1;1;1
2019-04-23 20:00:43;SUR;0;1;1;1
2019-04-23 20:00:57;SUR;0;1;1;1
2019-04-23 20:04:00;SUR;0;1;1;1
2019-04-23 20:05:05;SUR;0;1;1;1
2019-04-23 20:05:23;SUR;0;1;1;1
2019-04-23 20:06:49;SUR;0;1;1;1
2019-04-23 20:08:10;SUR;0;1;1;1
2019-04-23 20:08:38;SUR;0;1;1;1
2019-04-23 20:09:35;SUR;0;1;1;1
2019-04-23 20:10:34;SUR;0;1;1;1
2019-04-23 20:11:21;SUR;0;1;1;1
2019-04-23 20:12:15;SUR;0;1;1;1
2019-04-23 20:12:37;SUR;0;1;1;1
2019-04-23 20:13:07;SUR;0;1;1;1
2019-04-23 20:14:00;SUR;0;1;1;1
2019-04-23 20:15:34;SUR;0;1;1;1
2019-04-23 20:16:24;SUR;0;1;1;1
2019-04-23 20:17:36;SUR;0;1;1;1
2019-04-23 20:18:41;SUR;0;2;2;1
2019-04-23 20:19:20;SUR;0;1;1;1
2019-04-23 20:20:06;SUR;0;1;1;1
2019-04-23 20:22:17;SUR;0;1;1;1
2019-04-23 20:23:42;SUR;0;1;1;1
2019-04-23 20:24:56;SUR;0;1;1;1
2019-04-23 20:25:13;SUR;0;1;1;1
2019-04-23 20:26:49;SUR;0;1;1;1
2019-04-23 20:27:55;SUR;0;1;1;1
2019-04-23 20:28:35;SUR;0;1;1;1
2019-04-23 20:29:05;SUR;0;1;1;1
2019-04-23 20:29:23;SUR;0;1;1;1
2019-04-23 20:31:12;SUR;0;1;1;1
2019-04-23 20:31:32;SUR;0;1;1;1
2019-04-23 20:32:29;SUR;0;1;1;1
2019-04-23 20:32:35;SUR;0;1;1;1
2019-04-23 20:34:17;SUR;0;1;1;1
2019-04-23 20:35:32;SUR;0;1;1;1
2019-04-23 20:36:26;SUR;0;1;1;1
2019-04-23 20:37:25;SUR;0;1;1;1
2019-04-23 20:38:04;SUR;0;1;1;1
2019-04-23 20:39:43;SUR;0;1;1;1
2019-04-23 20:39:56;SUR;0;1;1;1
2019-04-23 20:40:06;SUR;0;1;1;1
2019-04-23 20:41:15;SUR;0;1;1;1
2019-04-23 20:43:44;SUR;0;1;1;1
2019-04-23 20:44:41;SUR;0;1;1;1
2019-04-23 20:46:03;SUR;0;1;1;1
2019-04-23 20:48:30;SUR;0;1;1;1
2019-04-23 20:50:14;SUR;0;1;1;1
2019-04-23 20:51:41;SUR;0;1;1;1
2019-04-23 20:53:03;SUR;0;1;1;1
2019-04-23 20:53:28;SUR;0;1;1;1
2019-04-23 20:55:24;SUR;0;1;1;1
2019-04-23 20:55:44;SUR;0;1;1;1
2019-04-23 20:58:10;SUR;0;1;1;1
2019-04-23 20:58:53;SUR;0;1;1;1
2019-04-23 21:01:58;SUR;0;1;1;1
2019-04-23 21:02:01;SUR;0;1;1;1
2019-04-23 21:02:08;SUR;0;1;1;1
2019-04-23 21:03:40;SUR;0;1;1;1
2019-04-23 21:04:34;SUR;0;1;1;1
2019-04-23 21:06:33;SUR;0;1;1;1
2019-04-23 21:06:55;SUR;0;1;1;1
2019-04-23 21:07:09;SUR;0;1;1;1
2019-04-23 21:10:38;SUR;0;1;1;1
2019-04-23 21:11:26;SUR;0;1;1;1
2019-04-23 21:11:32;SUR;0;1;1;1
2019-04-23 21:12:37;SUR;0;1;1;1
2019-04-23 21:13:37;SUR;0;1;1;1
2019-04-23 21:14:47;SUR;0;1;1;1
2019-04-23 21:15:15;SUR;0;1;1;1
2019-04-23 21:15:56;SUR;0;1;1;1
2019-04-23 21:16:09;SUR;0;1;1;1
2019-04-23 21:17:33;SUR;0;1;1;1
2019-04-23 21:18:27;SUR;0;1;1;1
2019-04-23 21:19:59;SUR;0;1;1;1
2019-04-23 21:21:03;SUR;0;1;1;1
2019-04-23 21:22:54;SUR;0;1;1;1
2019-04-23 21:24:01;SUR;0;1;1;1
2019-04-23 21:24:54;SUR;0;1;1;1
2019-04-23 21:26:11;SUR;0;1;1;1
2019-04-23 21:27:00;SUR;0;1;1;1
2019-04-23 21:28:40;SUR;0;1;1;1
2019-04-23 21:30:00;SUR;0;18;18;1
2019-04-23 22:00:00;SUR;0;10;10;1
2019-04-23 22:30:00;SUR;0;7;7;1
2019-04-23 23:00:00;SUR;0;2;2;1
2019-04-24 00:00:00;SUR;0;2;2;1
2019-04-24 00:30:00;SUR;0;4;4;1
2019-04-24 02:00:00;SUR;0;2;2;1
2019-04-24 02:30:00;SUR;0;7;7;1
2019-04-24 03:00:00;SUR;0;3;3;1
2019-04-24 03:30:00;SUR;0;10;10;1
2019-04-24 04:00:00;SUR;0;14;14;1
2019-04-24 04:30:00;SUR;0;12;12;1
2019-04-24 05:00:00;SUR;0;27;27;1
2019-04-24 05:30:00;SUR;0;36;36;1
2019-04-24 06:00:00;SUR;0;19;19;1
2019-04-24 06:30:00;SUR;0;4;4;1
2019-04-24 06:40:00;SUR;0;20;20;1
2019-04-24 07:00:00;SUR;0;31;31;1
2019-04-24 07:30:00;SUR;0;26;26;1
2019-04-24 08:00:00;SUR;0;31;31;1
2019-04-24 08:30:00;SUR;0;33;33;1
2019-04-24 09:00:00;SUR;0;23;23;1
2019-04-24 09:30:00;SUR;0;27;27;1
2019-04-24 10:00:00;SUR;0;28;28;1
2019-04-24 10:30:00;SUR;0;31;31;1
2019-04-24 11:00:00;SUR;0;26;26;1
2019-04-24 11:30:00;SUR;0;34;34;1
2019-04-24 12:00:00;SUR;0;19;19;1
2019-04-24 12:30:00;SUR;0;27;27;1
2019-04-24 13:00:00;SUR;0;33;33;1
2019-04-24 13:30:00;SUR;0;30;30;1
2019-04-24 14:00:00;SUR;0;32;32;1
2019-04-24 14:30:00;SUR;0;34;34;1
2019-04-24 15:00:00;SUR;0;36;36;1
2019-04-24 15:30:00;SUR;0;20;20;1
2019-04-24 16:00:00;SUR;0;25;25;1
2019-04-24 16:30:00;SUR;0;26;26;1
2019-04-24 17:00:00;SUR;0;16;16;1
2019-04-24 17:30:00;SUR;0;7;7;1
2019-04-24 17:44:00;SUR;0;15;15;1
2019-04-24 18:00:00;SUR;0;35;35;1
2019-04-24 18:30:00;SUR;0;34;34;1
2019-04-24 19:00:00;SUR;0;32;32;1
2019-04-24 19:30:00;SUR;0;29;29;1
2019-04-24 20:00:00;SUR;0;30;30;1
2019-04-24 20:30:00;SUR;0;29;29;1
2019-04-24 21:00:00;SUR;0;20;20;1
2019-04-24 21:30:00;SUR;0;17;17;1
2019-04-24 22:00:00;SUR;0;15;15;1
2019-04-24 22:30:00;SUR;0;9;9;1
2019-04-24 23:00:00;SUR;0;1;1;1
2019-04-24 23:30:00;SUR;0;2;2;1
2019-04-25 00:00:00;SUR;0;1;1;1
2019-04-25 01:02:15;SUR;0;1;1;1
2019-04-25 01:11:25;SUR;0;1;1;1
2019-04-25 01:18:31;SUR;0;1;1;1
2019-04-25 01:39:08;SUR;0;1;1;1
2019-04-25 01:45:47;SUR;0;1;1;1
2019-04-25 01:48:25;SUR;0;1;1;1
2019-04-25 02:30:00;SUR;0;4;4;1
2019-04-25 03:00:00;SUR;0;1;1;1
2019-04-25 03:30:00;SUR;0;8;8;1
2019-04-25 04:00:00;SUR;0;11;11;1
2019-04-25 04:30:00;SUR;0;14;14;1
2019-04-25 05:00:00;SUR;0;23;23;1
2019-04-25 05:30:00;SUR;0;38;38;1
2019-04-25 06:00:00;SUR;0;23;23;1
2019-04-25 06:30:00;SUR;0;20;20;1
2019-04-25 07:00:00;SUR;0;42;42;1
2019-04-25 07:30:00;SUR;0;27;27;1
2019-04-25 08:00:00;SUR;0;28;28;1
2019-04-25 08:30:00;SUR;0;43;43;1
2019-04-25 09:00:00;SUR;0;29;29;1
2019-04-25 09:30:00;SUR;0;26;26;1
2019-04-25 10:00:00;SUR;0;30;30;1
2019-04-25 10:30:00;SUR;0;27;27;1
2019-04-25 11:00:00;SUR;0;32;32;1
2019-04-25 11:30:00;SUR;0;28;28;1
2019-04-25 12:00:00;SUR;0;28;28;1
2019-04-25 12:30:00;SUR;0;21;21;1
2019-04-25 13:00:00;SUR;0;35;35;1
2019-04-25 13:30:00;SUR;0;37;37;1
2019-04-25 14:00:00;SUR;0;43;43;1
2019-04-25 14:30:00;SUR;0;37;37;1
2019-04-25 15:00:00;SUR;0;24;24;1
2019-04-25 15:30:00;SUR;0;20;20;1
2019-04-25 16:00:00;SUR;0;23;23;1
2019-04-25 16:30:00;SUR;0;25;25;1
2019-04-25 17:00:00;SUR;0;24;24;1
2019-04-25 17:30:00;SUR;0;28;28;1
2019-04-25 18:00:00;SUR;0;39;39;1
2019-04-25 18:30:00;SUR;0;32;32;1
2019-04-25 19:00:00;SUR;0;34;34;1
2019-04-25 19:30:00;SUR;0;33;33;1
2019-04-25 20:00:00;SUR;0;31;31;1
2019-04-25 20:30:00;SUR;0;27;27;1
2019-04-25 21:00:00;SUR;0;24;24;1
2019-04-25 21:30:00;SUR;0;15;15;1
2019-04-25 22:00:00;NORTE;12;0;12;1
2019-04-25 22:30:00;NORTE;8;0;8;1
2019-04-25 23:00:00;CONFLICTIVA;7;1;8;2
2019-04-25 23:30:00;NORTE;1;0;1;1
2019-04-26 00:00:00;NORTE;2;0;2;1
2019-04-26 01:00:00;NORTE;2;0;2;1
2019-04-26 01:30:00;NORTE;1;0;1;1
2019-04-26 02:00:00;NORTE;2;0;2;1
2019-04-26 02:30:00;NORTE;2;0;2;1
2019-04-26 03:00:00;NORTE;3;0;3;1
2019-04-26 03:30:00;NORTE;8;0;8;1
2019-04-26 04:00:00;NORTE;10;0;10;1
2019-04-26 04:30:00;NORTE;13;0;13;1
2019-04-26 05:00:00;NORTE;17;0;17;1
2019-04-26 05:30:00;NORTE;37;0;37;1
2019-04-26 06:00:00;NORTE;20;0;20;1
2019-04-26 06:30:00;NORTE;26;0;26;1
2019-04-26 07:00:00;NORTE;36;0;36;1
2019-04-26 07:30:00;NORTE;34;1;35;1
2019-04-26 08:00:00;NORTE;34;0;34;1
2019-04-26 08:30:00;NORTE;40;0;40;1
2019-04-26 09:00:00;NORTE;24;0;24;1
2019-04-26 09:30:00;NORTE;33;0;33;1
2019-04-26 10:00:00;NORTE;38;0;38;1
2019-04-26 10:30:00;NORTE;30;0;30;1
2019-04-26 11:00:00;NORTE;29;0;29;1
2019-04-26 11:30:00;NORTE;30;1;31;1
2019-04-26 12:00:00;NORTE;27;0;27;1
2019-04-26 12:30:00;NORTE;27;0;27;1
2019-04-26 13:00:00;NORTE;43;0;43;1
2019-04-26 13:30:00;NORTE;38;0;38;1
2019-04-26 14:00:00;NORTE;39;0;39;1
2019-04-26 14:30:00;NORTE;37;0;37;1
2019-04-26 15:00:00;NORTE;25;0;25;1
2019-04-26 15:30:00;NORTE;29;0;29;1
2019-04-26 16:00:00;NORTE;27;0;27;1
2019-04-26 16:30:00;NORTE;32;0;32;1
2019-04-26 17:00:00;NORTE;29;0;29;1
2019-04-26 17:30:00;NORTE;31;0;31;1
2019-04-26 18:00:00;NORTE;38;0;38;1
2019-04-26 18:30:00;NORTE;37;0;37;1
2019-04-26 19:00:00;NORTE;27;1;28;1
2019-04-26 19:30:00;NORTE;29;0;29;1
2019-04-26 20:00:00;NORTE;32;0;32;1
2019-04-26 20:30:00;NORTE;27;0;27;1
2019-04-26 21:00:00;NORTE;23;0;23;1
2019-04-26 21:30:00;NORTE;15;0;15;1
2019-04-26 22:00:00;NORTE;15;0;15;1
2019-04-26 22:30:00;NORTE;2;0;2;1
2019-04-26 23:00:00;NORTE;2;0;2;1
2019-04-26 23:30:00;NORTE;1;0;1;1
2019-04-27 00:00:00;NORTE;2;0;2;1
2019-04-27 01:00:00;NORTE;1;0;1;1
2019-04-27 01:30:00;NORTE;2;0;2;1
2019-04-27 02:00:00;NORTE;2;0;2;1
2019-04-27 02:30:00;NORTE;3;0;3;1
2019-04-27 03:00:00;NORTE;2;0;2;1
2019-04-27 03:30:00;NORTE;3;0;3;1
2019-04-27 04:00:00;NORTE;13;0;13;1
2019-04-27 04:30:00;NORTE;18;0;18;1
2019-04-27 05:00:00;NORTE;19;0;19;1
2019-04-27 05:30:00;NORTE;31;0;31;1
2019-04-27 06:00:00;NORTE;16;0;16;1
2019-04-27 06:30:00;NORTE;27;0;27;1
2019-04-27 07:00:00;NORTE;39;0;39;1
2019-04-27 07:30:00;NORTE;31;0;31;1
2019-04-27 08:00:00;NORTE;35;0;35;1
2019-04-27 08:30:00;NORTE;32;0;32;1
2019-04-27 09:00:00;NORTE;25;0;25;1
2019-04-27 09:30:00;NORTE;34;0;34;1
2019-04-27 10:00:00;NORTE;35;0;35;1
2019-04-27 10:30:00;NORTE;23;0;23;1
2019-04-27 11:00:00;NORTE;32;0;32;1
2019-04-27 11:30:00;NORTE;27;0;27;1
2019-04-27 12:00:00;NORTE;30;0;30;1
2019-04-27 12:30:00;NORTE;31;0;31;1
2019-04-27 13:00:00;NORTE;30;0;30;1
2019-04-27 13:30:00;NORTE;33;0;33;1
2019-04-27 14:00:00;NORTE;37;0;37;1
2019-04-27 14:30:00;NORTE;26;0;26;1
2019-04-27 15:00:00;NORTE;23;0;23;1
2019-04-27 15:30:00;NORTE;22;0;22;1
2019-04-27 16:00:00;NORTE;19;0;19;1
2019-04-27 16:30:00;NORTE;29;0;29;1
2019-04-27 17:00:00;NORTE;18;0;18;1
2019-04-27 17:30:00;NORTE;19;0;19;1
2019-04-27 18:00:00;NORTE;37;0;37;1
2019-04-27 18:30:00;NORTE;23;0;23;1
2019-04-27 19:00:00;NORTE;24;0;24;1
2019-04-27 19:30:00;NORTE;25;0;25;1
2019-04-27 20:00:00;NORTE;21;0;21;1
2019-04-27 20:30:00;NORTE;18;0;18;1
2019-04-27 21:00:00;NORTE;10;0;10;1
2019-04-27 21:30:00;NORTE;14;0;14;1
2019-04-27 22:00:00;NORTE;16;0;16;1
2019-04-27 22:30:00;NORTE;4;0;4;1
2019-04-27 23:00:00;NORTE;2;0;2;1
2019-04-28 00:00:00;NORTE;1;0;1;1
2019-04-28 00:30:00;NORTE;1;0;1;1
2019-04-28 01:00:00;NORTE;3;0;3;1
2019-04-28 01:30:00;NORTE;1;0;1;1
2019-04-28 02:00:00;NORTE;1;0;1;1
2019-04-28 02:30:00;NORTE;1;0;1;1
2019-04-28 03:00:00;NORTE;4;0;4;1
2019-04-28 03:30:00;NORTE;5;0;5;1
2019-04-28 04:00:00;NORTE;12;0;12;1
2019-04-28 04:30:00;NORTE;8;0;8;1
2019-04-28 05:00:00;NORTE;13;0;13;1
2019-04-28 05:30:00;NORTE;32;0;32;1
2019-04-28 06:00:00;NORTE;24;0;24;1
2019-04-28 06:30:00;NORTE;28;0;28;1
2019-04-28 07:00:00;NORTE;29;0;29;1
2019-04-28 07:30:00;NORTE;34;0;34;1
2019-04-28 08:00:00;NORTE;33;0;33;1
2019-04-28 08:30:00;NORTE;37;0;37;1
2019-04-28 09:00:00;NORTE;22;0;22;1
2019-04-28 09:30:00;NORTE;32;0;32;1
2019-04-28 10:00:00;NORTE;35;0;35;1
2019-04-28 10:30:00;NORTE;38;0;38;1
2019-04-28 11:00:00;NORTE;28;0;28;1
2019-04-28 11:30:00;NORTE;27;0;27;1
2019-04-28 12:00:00;NORTE;28;0;28;1
2019-04-28 12:30:00;NORTE;29;0;29;1
2019-04-28 13:00:00;NORTE;35;0;35;1
2019-04-28 13:30:00;NORTE;28;0;28;1
2019-04-28 14:00:00;NORTE;48;0;48;1
2019-04-28 14:30:00;NORTE;31;0;31;1
2019-04-28 15:00:00;NORTE;29;0;29;1
2019-04-28 15:30:00;NORTE;25;0;25;1
2019-04-28 16:00:00;NORTE;20;0;20;1
2019-04-28 16:30:00;NORTE;32;0;32;1
2019-04-28 17:00:00;NORTE;26;0;26;1
2019-04-28 17:30:00;NORTE;26;0;26;1
2019-04-28 18:00:00;NORTE;41;0;41;1
2019-04-28 18:30:00;NORTE;38;0;38;1
2019-04-28 19:00:00;NORTE;27;0;27;1
2019-04-28 19:30:00;NORTE;34;0;34;1
2019-04-28 20:00:00;NORTE;32;0;32;1
2019-04-28 20:30:00;NORTE;28;0;28;1
2019-04-28 21:00:00;NORTE;14;0;14;1
2019-04-28 21:30:00;NORTE;15;0;15;1
2019-04-28 22:00:00;NORTE;11;0;11;1
2019-04-28 22:30:00;NORTE;7;0;7;1
2019-04-28 23:00:00;NORTE;4;0;4;1
2019-04-28 23:30:00;NORTE;1;0;1;1
2019-04-29 00:00:00;NORTE;2;0;2;1
2019-04-29 00:30:00;NORTE;2;0;2;1
2019-04-29 01:00:00;NORTE;1;0;1;1
2019-04-29 01:30:00;NORTE;1;0;1;1
2019-04-29 02:00:00;NORTE;6;0;6;1
2019-04-29 02:30:00;NORTE;1;0;1;1
2019-04-29 03:00:00;NORTE;2;0;2;1
2019-04-29 03:30:00;NORTE;4;0;4;1
2019-04-29 04:00:00;NORTE;12;0;12;1
2019-04-29 04:30:00;NORTE;10;0;10;1
2019-04-29 05:00:00;NORTE;24;0;24;1
2019-04-29 05:30:00;NORTE;40;0;40;1
2019-04-29 06:00:00;NORTE;23;0;23;1
2019-04-29 06:30:00;NORTE;24;0;24;1
2019-04-29 07:00:00;NORTE;36;0;36;1
2019-04-29 07:30:00;NORTE;30;0;30;1
2019-04-29 08:00:00;NORTE;39;0;39;1
2019-04-29 08:30:00;NORTE;35;0;35;1
2019-04-29 09:00:00;NORTE;28;0;28;1
2019-04-29 09:30:00;NORTE;33;0;33;1
2019-04-29 10:00:00;NORTE;35;0;35;1
2019-04-29 10:30:00;NORTE;33;0;33;1
2019-04-29 11:00:00;NORTE;30;0;30;1
2019-04-29 11:30:00;NORTE;29;0;29;1
2019-04-29 12:00:00;NORTE;21;0;21;1
2019-04-29 12:30:00;NORTE;35;0;35;1
2019-04-29 13:00:00;NORTE;39;0;39;1
2019-04-29 13:30:00;NORTE;30;0;30;1
2019-04-29 14:00:00;NORTE;44;0;44;1
2019-04-29 14:30:00;NORTE;24;0;24;1
2019-04-29 15:00:00;NORTE;28;0;28;1
2019-04-29 15:30:00;NORTE;26;0;26;1
2019-04-29 16:00:00;NORTE;17;0;17;1
2019-04-29 16:30:00;NORTE;36;0;36;1
2019-04-29 17:00:00;NORTE;23;0;23;1
2019-04-29 17:30:00;NORTE;30;0;30;1
2019-04-29 18:00:00;NORTE;37;0;37;1
2019-04-29 18:30:00;NORTE;34;0;34;1
2019-04-29 19:00:00;NORTE;28;0;28;1
2019-04-29 19:30:00;NORTE;32;0;32;1
2019-04-29 20:00:00;NORTE;33;0;33;1
2019-04-29 20:30:00;NORTE;24;0;24;1
2019-04-29 21:00:00;NORTE;15;0;15;1
2019-04-29 21:30:00;NORTE;12;0;12;1
2019-04-29 22:00:00;NORTE;12;0;12;1
2019-04-29 22:30:00;NORTE;5;0;5;1
2019-04-29 23:30:00;NORTE;2;0;2;1
2019-04-30 00:30:00;NORTE;2;0;2;1
2019-04-30 01:00:00;NORTE;1;0;1;1
2019-04-30 01:30:00;NORTE;1;0;1;1
2019-04-30 02:00:00;NORTE;4;0;4;1
2019-04-30 02:30:00;NORTE;4;0;4;1
2019-04-30 03:00:00;NORTE;2;0;2;1
2019-04-30 03:30:00;NORTE;9;0;9;1
2019-04-30 04:00:00;NORTE;11;0;11;1
2019-04-30 04:30:00;NORTE;15;0;15;1
2019-04-30 05:00:00;NORTE;24;0;24;1
2019-04-30 05:30:00;NORTE;42;0;42;1
2019-04-30 06:00:00;NORTE;21;0;21;1
2019-04-30 06:30:00;NORTE;31;0;31;1
2019-04-30 07:00:00;NORTE;35;0;35;1
2019-04-30 07:30:00;NORTE;30;0;30;1
2019-04-30 08:00:00;NORTE;34;0;34;1
2019-04-30 08:30:00;NORTE;36;0;36;1
2019-04-30 09:00:00;NORTE;24;0;24;1
2019-04-30 09:30:00;NORTE;31;0;31;1
2019-04-30 10:00:00;NORTE;37;0;37;1
2019-04-30 10:30:00;NORTE;29;0;29;1
2019-04-30 11:00:00;NORTE;29;0;29;1
2019-04-30 11:30:00;NORTE;27;0;27;1
2019-04-30 12:00:00;NORTE;25;0;25;1
2019-04-30 12:30:00;NORTE;33;0;33;1
2019-04-30 13:00:00;NORTE;36;0;36;1
2019-04-30 13:30:00;NORTE;29;0;29;1
2019-04-30 14:00:00;NORTE;36;0;36;1
2019-04-30 14:30:00;NORTE;35;0;35;1
2019-04-30 15:00:00;NORTE;24;0;24;1
2019-04-30 15:30:00;NORTE;26;0;26;1
2019-04-30 16:00:00;NORTE;23;0;23;1
2019-04-30 16:30:00;NORTE;33;0;33;1
2019-04-30 17:00:00;NORTE;30;0;30;1
2019-04-30 17:30:00;NORTE;25;0;25;1
2019-04-30 18:00:00;NORTE;38;0;38;1
2019-04-30 18:30:00;NORTE;30;0;30;1
2019-04-30 19:00:00;NORTE;30;0;30;1
2019-04-30 19:30:00;NORTE;32;0;32;1
2019-04-30 20:00:00;NORTE;33;0;33;1
2019-04-30 20:30:00;NORTE;26;0;26;1
2019-04-30 21:00:00;NORTE;18;0;18;1
2019-04-30 21:30:00;NORTE;12;0;12;1
2019-04-30 22:00:00;NORTE;11;0;11;1
2019-04-30 22:30:00;NORTE;6;0;6;1
2019-04-30 23:00:00;NORTE;1;0;1;1
2019-04-30 23:30:00;NORTE;1;0;1;1
2019-05-01 00:00:00;NORTE;2;0;2;1
2019-05-01 01:00:00;NORTE;2;0;2;1
2019-05-01 02:00:00;NORTE;1;0;1;1
2019-05-01 02:30:00;NORTE;2;0;2;1
2019-05-01 03:00:00;NORTE;4;0;4;1
2019-05-01 03:30:00;NORTE;7;0;7;1
2019-05-01 04:00:00;NORTE;11;0;11;1
2019-05-01 04:30:00;NORTE;10;0;10;1
2019-05-01 05:00:00;NORTE;14;0;14;1
2019-05-01 05:30:00;NORTE;35;0;35;1
2019-05-01 06:00:00;NORTE;24;0;24;1
2019-05-01 06:30:00;NORTE;24;0;24;1
2019-05-01 07:00:00;NORTE;36;0;36;1
2019-05-01 07:30:00;NORTE;31;0;31;1
2019-05-01 08:00:00;NORTE;35;0;35;1
2019-05-01 08:30:00;NORTE;23;0;23;1
2019-05-01 09:00:00;NORTE;28;0;28;1
2019-05-01 09:30:00;NORTE;26;0;26;1
2019-05-01 10:00:00;NORTE;35;0;35;1
2019-05-01 10:30:00;NORTE;34;0;34;1
2019-05-01 11:00:00;NORTE;33;0;33;1
2019-05-01 11:30:00;NORTE;28;0;28;1
2019-05-01 12:00:00;NORTE;28;0;28;1
2019-05-01 12:30:00;NORTE;29;0;29;1
2019-05-01 13:00:00;NORTE;38;0;38;1
2019-05-01 13:30:00;NORTE;29;0;29;1
2019-05-01 14:00:00;NORTE;39;0;39;1
2019-05-01 14:30:00;NORTE;29;0;29;1
2019-05-01 15:00:00;NORTE;27;0;27;1
2019-05-01 15:30:00;NORTE;20;0;20;1
2019-05-01 16:00:00;NORTE;20;0;20;1
2019-05-01 16:30:00;NORTE;28;0;28;1
2019-05-01 17:00:00;NORTE;23;0;23;1
2019-05-01 17:30:00;NORTE;34;0;34;1
2019-05-01 18:00:00;NORTE;38;0;38;1
2019-05-01 18:30:00;NORTE;34;0;34;1
2019-05-01 19:00:00;NORTE;27;0;27;1
2019-05-01 19:30:00;NORTE;36;0;36;1
2019-05-01 20:00:00;NORTE;21;0;21;1
2019-05-01 20:30:00;NORTE;13;0;13;1
2019-05-01 21:00:00;NORTE;14;0;14;1
2019-05-01 21:30:00;NORTE;9;0;9;1
2019-05-01 22:00:00;NORTE;11;0;11;1
2019-05-01 22:30:00;NORTE;1;0;1;1
2019-05-01 23:00:00;NORTE;1;0;1;1
2019-05-01 23:30:00;NORTE;2;0;2;1
2019-05-02 00:30:00;NORTE;2;0;2;1
2019-05-02 01:00:00;NORTE;1;0;1;1
2019-05-02 01:30:00;NORTE;2;0;2;1
2019-05-02 02:00:00;NORTE;2;0;2;1
2019-05-02 02:30:00;NORTE;2;0;2;1
2019-05-02 03:00:00;NORTE;1;0;1;1
2019-05-02 03:30:00;NORTE;9;0;9;1
2019-05-02 04:00:00;NORTE;13;0;13;1
2019-05-02 04:30:00;NORTE;11;0;11;1
2019-05-02 05:00:00;NORTE;20;0;20;1
2019-05-02 05:30:00;NORTE;34;0;34;1
2019-05-02 06:00:00;NORTE;19;0;19;1
2019-05-02 06:30:00;NORTE;28;0;28;1
2019-05-02 07:00:00;NORTE;33;0;33;1
2019-05-02 07:30:00;NORTE;27;0;27;1
2019-05-02 08:00:00;NORTE;36;0;36;1
2019-05-02 08:30:00;NORTE;37;0;37;1
2019-05-02 09:00:00;NORTE;21;0;21;1
2019-05-02 09:30:00;NORTE;36;0;36;1
2019-05-02 10:00:00;NORTE;30;0;30;1
2019-05-02 10:30:00;NORTE;40;0;40;1
2019-05-02 11:00:00;NORTE;31;0;31;1
2019-05-02 11:30:00;NORTE;27;0;27;1
2019-05-02 12:00:00;NORTE;25;0;25;1
2019-05-02 12:30:00;NORTE;30;0;30;1
2019-05-02 13:00:00;NORTE;41;0;41;1
2019-05-02 13:30:00;NORTE;31;0;31;1
2019-05-02 14:00:00;NORTE;33;0;33;1
2019-05-02 14:30:00;NORTE;27;0;27;1
2019-05-02 15:00:00;NORTE;33;0;33;1
2019-05-02 15:30:00;NORTE;21;0;21;1
2019-05-02 16:00:00;NORTE;20;0;20;1
2019-05-02 16:30:00;NORTE;29;0;29;1
2019-05-02 17:00:00;NORTE;20;0;20;1
2019-05-02 17:30:00;NORTE;28;0;28;1
2019-05-02 18:00:00;NORTE;39;0;39;1
2019-05-02 18:30:00;NORTE;32;0;32;1
2019-05-02 19:00:00;NORTE;31;0;31;1
2019-05-02 19:30:00;NORTE;29;0;29;1
2019-05-02 20:00:00;CONFLICTIVA;7;3;10;2
2019-05-02 20:30:00;SUR;0;8;8;1
2019-05-02 21:00:00;CONFLICTIVA;11;2;13;2
2019-05-02 21:30:00;NORTE;15;0;15;1
2019-05-02 22:00:00;NORTE;14;0;14;1
2019-05-02 22:30:00;NORTE;7;0;7;1
2019-05-02 23:30:00;NORTE;3;0;3;1
2019-05-03 00:30:00;NORTE;2;0;2;1
2019-05-03 01:00:00;NORTE;1;0;1;1
2019-05-03 01:30:00;NORTE;3;0;3;1
2019-05-03 02:00:00;NORTE;3;0;3;1
2019-05-03 02:30:00;NORTE;5;0;5;1
2019-05-03 03:00:00;NORTE;5;0;5;1
2019-05-03 03:30:00;NORTE;9;0;9;1
2019-05-03 04:00:00;NORTE;13;0;13;1
2019-05-03 04:30:00;NORTE;10;0;10;1
2019-05-03 05:00:00;NORTE;16;0;16;1
2019-05-03 05:30:00;NORTE;38;0;38;1
2019-05-03 06:00:00;NORTE;20;0;20;1
2019-05-03 06:30:00;NORTE;29;0;29;1
2019-05-03 07:00:00;NORTE;41;0;41;1
2019-05-03 07:30:00;NORTE;25;0;25;1
2019-05-03 08:00:00;NORTE;37;0;37;1
2019-05-03 08:30:00;NORTE;36;0;36;1
2019-05-03 09:00:00;NORTE;25;0;25;1
2019-05-03 09:30:00;NORTE;35;0;35;1
2019-05-03 10:00:00;NORTE;39;0;39;1
2019-05-03 10:30:00;NORTE;29;0;29;1
2019-05-03 11:00:00;NORTE;32;0;32;1
2019-05-03 11:30:00;NORTE;32;0;32;1
2019-05-03 12:00:00;NORTE;22;0;22;1
2019-05-03 12:30:00;NORTE;40;0;40;1
2019-05-03 13:00:00;NORTE;34;0;34;1
2019-05-03 13:30:00;NORTE;36;0;36;1
2019-05-03 14:00:00;NORTE;33;0;33;1
2019-05-03 14:30:00;NORTE;37;0;37;1
2019-05-03 15:00:00;NORTE;27;0;27;1
2019-05-03 15:30:00;NORTE;27;0;27;1
2019-05-03 16:00:00;NORTE;25;0;25;1
2019-05-03 16:30:00;NORTE;33;0;33;1
2019-05-03 17:00:00;NORTE;27;0;27;1
2019-05-03 17:30:00;NORTE;25;0;25;1
2019-05-03 18:00:00;NORTE;42;0;42;1
2019-05-03 18:30:00;NORTE;30;0;30;1
2019-05-03 19:00:00;NORTE;28;0;28;1
2019-05-03 19:30:00;NORTE;35;0;35;1
2019-05-03 20:00:00;NORTE;26;0;26;1
2019-05-03 20:30:00;NORTE;23;0;23;1
2019-05-03 21:00:00;NORTE;11;0;11;1
2019-05-03 21:30:00;NORTE;12;0;12;1
2019-05-03 22:00:00;NORTE;14;0;14;1
2019-05-03 22:30:00;NORTE;6;0;6;1
2019-05-03 23:00:00;NORTE;1;0;1;1
2019-05-03 23:30:00;NORTE;1;0;1;1
2019-05-04 00:00:00;NORTE;2;0;2;1
2019-05-04 00:30:00;NORTE;2;0;2;1
2019-05-04 01:30:00;NORTE;2;0;2;1
2019-05-04 02:00:00;NORTE;4;0;4;1
2019-05-04 02:30:00;NORTE;4;0;4;1
2019-05-04 03:00:00;NORTE;2;0;2;1
2019-05-04 03:30:00;NORTE;4;0;4;1
2019-05-04 04:00:00;NORTE;15;0;15;1
2019-05-04 04:30:00;NORTE;10;0;10;1
2019-05-04 05:00:00;NORTE;21;0;21;1
2019-05-04 05:30:00;NORTE;29;0;29;1
2019-05-04 06:00:00;NORTE;22;0;22;1
2019-05-04 06:30:00;NORTE;27;0;27;1
2019-05-04 07:00:00;NORTE;42;0;42;1
2019-05-04 07:30:00;NORTE;31;0;31;1
2019-05-04 08:00:00;NORTE;39;0;39;1
2019-05-04 08:30:00;NORTE;38;0;38;1
2019-05-04 09:00:00;NORTE;21;0;21;1
2019-05-04 09:30:00;NORTE;30;0;30;1
2019-05-04 10:00:00;NORTE;39;0;39;1
2019-05-04 10:30:00;NORTE;28;0;28;1
2019-05-04 11:00:00;NORTE;36;0;36;1
2019-05-04 11:30:00;NORTE;28;0;28;1
2019-05-04 12:00:00;NORTE;24;0;24;1
2019-05-04 12:30:00;NORTE;30;0;30;1
2019-05-04 13:00:00;NORTE;35;0;35;1
2019-05-04 13:30:00;NORTE;37;0;37;1
2019-05-04 14:00:00;NORTE;28;0;28;1
2019-05-04 14:30:00;NORTE;26;0;26;1
2019-05-04 15:00:00;NORTE;34;0;34;1
2019-05-04 15:30:00;NORTE;23;0;23;1
2019-05-04 16:00:00;NORTE;22;0;22;1
2019-05-04 16:30:00;NORTE;29;0;29;1
2019-05-04 17:00:00;NORTE;15;0;15;1
2019-05-04 17:30:00;NORTE;24;0;24;1
2019-05-04 18:00:00;NORTE;35;0;35;1
2019-05-04 18:30:00;NORTE;17;0;17;1
2019-05-04 19:00:00;NORTE;27;0;27;1
2019-05-04 19:30:00;NORTE;28;0;28;1
2019-05-04 20:00:00;NORTE;22;0;22;1
2019-05-04 20:30:00;NORTE;22;0;22;1
2019-05-04 21:00:00;NORTE;11;0;11;1
2019-05-04 21:30:00;NORTE;13;0;13;1
2019-05-04 22:00:00;NORTE;14;0;14;1
2019-05-04 22:30:00;NORTE;7;0;7;1
2019-05-04 23:00:00;NORTE;1;0;1;1
2019-05-05 00:00:00;NORTE;2;0;2;1
2019-05-05 00:30:00;NORTE;3;0;3;1
2019-05-05 01:00:00;NORTE;2;0;2;1
2019-05-05 02:00:00;NORTE;1;0;1;1
2019-05-05 03:00:00;NORTE;3;0;3;1
2019-05-05 03:30:00;NORTE;7;0;7;1
2019-05-05 04:00:00;NORTE;7;0;7;1
2019-05-05 04:30:00;NORTE;14;0;14;1
2019-05-05 05:00:00;NORTE;14;0;14;1
2019-05-05 05:30:00;NORTE;32;0;32;1
2019-05-05 06:00:00;NORTE;17;0;17;1
2019-05-05 06:30:00;NORTE;30;0;30;1
2019-05-05 07:00:00;NORTE;34;0;34;1
2019-05-05 07:30:00;NORTE;24;0;24;1
2019-05-05 08:00:00;NORTE;36;0;36;1
2019-05-05 08:30:00;NORTE;38;0;38;1
2019-05-05 09:00:00;NORTE;28;0;28;1
2019-05-05 09:30:00;NORTE;31;0;31;1
2019-05-05 10:00:00;NORTE;38;0;38;1
2019-05-05 10:30:00;NORTE;29;0;29;1
2019-05-05 11:00:00;NORTE;24;0;24;1
2019-05-05 11:30:00;NORTE;40;0;40;1
2019-05-05 12:00:00;NORTE;28;0;28;1
2019-05-05 12:30:00;NORTE;28;0;28;1
2019-05-05 13:00:00;NORTE;44;0;44;1
2019-05-05 13:30:00;NORTE;31;0;31;1
2019-05-05 14:00:00;NORTE;42;0;42;1
2019-05-05 14:30:00;NORTE;36;0;36;1
2019-05-05 15:00:00;NORTE;21;0;21;1
2019-05-05 15:30:00;NORTE;33;0;33;1
2019-05-05 16:00:00;NORTE;17;0;17;1
2019-05-05 16:30:00;NORTE;35;0;35;1
2019-05-05 17:00:00;NORTE;31;0;31;1
2019-05-05 17:30:00;NORTE;26;0;26;1
2019-05-05 18:00:00;NORTE;34;0;34;1
2019-05-05 18:30:00;NORTE;38;0;38;1
2019-05-05 19:00:00;NORTE;32;0;32;1
2019-05-05 19:30:00;NORTE;36;0;36;1
2019-05-05 20:00:00;NORTE;33;0;33;1
2019-05-05 20:30:00;NORTE;34;0;34;1
2019-05-05 21:00:00;NORTE;20;0;20;1
2019-05-05 21:30:00;NORTE;17;0;17;1
2019-05-05 22:00:00;NORTE;16;0;16;1
2019-05-05 22:30:00;NORTE;9;0;9;1
2019-05-05 23:30:00;NORTE;4;0;4;1
2019-05-06 00:30:00;NORTE;3;0;3;1
2019-05-06 01:00:00;NORTE;1;0;1;1
2019-05-06 01:30:00;NORTE;1;0;1;1
2019-05-06 02:00:00;NORTE;2;0;2;1
2019-05-06 02:30:00;NORTE;5;0;5;1
2019-05-06 03:30:00;NORTE;8;0;8;1
2019-05-06 04:00:00;NORTE;9;0;9;1
2019-05-06 04:30:00;NORTE;13;0;13;1
2019-05-06 05:00:00;NORTE;23;0;23;1
2019-05-06 05:30:00;NORTE;40;0;40;1
2019-05-06 06:00:00;NORTE;20;0;20;1
2019-05-06 06:30:00;NORTE;27;0;27;1
2019-05-06 07:00:00;NORTE;41;0;41;1
2019-05-06 07:30:00;NORTE;27;0;27;1
2019-05-06 08:00:00;NORTE;37;0;37;1
2019-05-06 08:30:00;NORTE;34;0;34;1
2019-05-06 09:00:00;NORTE;22;0;22;1
2019-05-06 09:30:00;NORTE;36;0;36;1
2019-05-06 10:00:00;NORTE;33;0;33;1
2019-05-06 10:30:00;NORTE;30;0;30;1
2019-05-06 11:00:00;NORTE;30;0;30;1
2019-05-06 11:30:00;NORTE;26;0;26;1
2019-05-06 12:00:00;NORTE;28;0;28;1
2019-05-06 12:30:00;NORTE;29;0;29;1
2019-05-06 13:00:00;SUR;0;39;39;1
2019-05-06 13:30:00;SUR;0;34;34;1
2019-05-06 14:00:00;SUR;0;45;45;1
2019-05-06 14:30:00;SUR;0;32;32;1
2019-05-06 15:00:00;SUR;0;32;32;1
2019-05-06 15:30:00;SUR;0;32;32;1
2019-05-06 16:00:00;SUR;0;18;18;1
2019-05-06 16:30:00;SUR;0;30;30;1
2019-05-06 17:00:00;SUR;0;29;29;1
2019-05-06 17:30:00;SUR;0;28;28;1
2019-05-06 18:00:00;SUR;0;36;36;1
2019-05-06 18:30:00;SUR;0;29;29;1
2019-05-06 19:00:00;SUR;0;32;32;1
2019-05-06 19:30:00;SUR;0;29;29;1
2019-05-06 20:00:00;SUR;0;34;34;1
2019-05-06 20:30:00;SUR;0;21;21;1
2019-05-06 21:00:00;SUR;0;20;20;1
2019-05-06 21:30:00;SUR;0;14;14;1
2019-05-06 22:00:00;SUR;0;16;16;1
2019-05-06 22:30:00;SUR;0;5;5;1
2019-05-07 00:30:00;SUR;0;1;1;1
2019-05-07 02:00:00;SUR;0;3;3;1
2019-05-07 02:30:00;SUR;0;2;2;1
2019-05-07 03:00:00;SUR;0;5;5;1
2019-05-07 03:30:00;SUR;0;10;10;1
2019-05-07 04:00:00;CONFLICTIVA;6;3;9;2
2019-05-07 04:30:00;NORTE;14;0;14;1
2019-05-07 05:00:00;NORTE;25;0;25;1
2019-05-07 05:30:00;NORTE;41;0;41;1
2019-05-07 06:00:00;NORTE;23;0;23;1
2019-05-07 06:30:00;NORTE;22;0;22;1
2019-05-07 07:00:00;NORTE;34;0;34;1
2019-05-07 07:30:00;CONFLICTIVA;5;22;27;2
2019-05-07 08:00:00;SUR;0;35;35;1
2019-05-07 08:30:00;SUR;0;37;37;1
2019-05-07 09:00:00;SUR;0;33;33;1
2019-05-07 09:30:00;SUR;0;32;32;1
2019-05-07 10:00:00;SUR;0;37;37;1
2019-05-07 10:30:00;SUR;0;29;29;1
2019-05-07 11:00:00;SUR;0;31;31;1
2019-05-07 11:30:00;SUR;0;36;36;1
2019-05-07 12:00:00;SUR;0;21;21;1
2019-05-07 12:30:00;SUR;0;32;32;1
2019-05-07 13:00:00;SUR;0;35;35;1
2019-05-07 13:30:00;SUR;0;32;32;1
2019-05-07 14:00:00;SUR;0;30;30;1
2019-05-07 14:30:00;SUR;0;32;32;1
2019-05-07 15:00:00;SUR;0;28;28;1
2019-05-07 15:30:00;SUR;0;23;23;1
2019-05-07 16:00:00;SUR;0;25;25;1
2019-05-07 16:30:00;SUR;0;32;32;1
2019-05-07 17:00:00;SUR;0;25;25;1
2019-05-07 17:30:00;SUR;0;30;30;1
2019-05-07 18:00:00;SUR;0;40;40;1
2019-05-07 18:30:00;SUR;0;25;25;1
2019-05-07 19:00:00;SUR;0;36;36;1
2019-05-07 19:30:00;SUR;0;34;34;1
2019-05-07 20:00:00;SUR;0;34;34;1
2019-05-07 20:30:00;SUR;0;23;23;1
2019-05-07 21:00:00;SUR;0;22;22;1
2019-05-07 21:30:00;SUR;0;14;14;1
2019-05-07 22:00:00;SUR;0;13;13;1
2019-05-07 22:30:00;SUR;0;5;5;1
2019-05-07 23:00:00;SUR;0;4;4;1
2019-05-07 23:30:00;SUR;0;1;1;1
2019-05-08 01:00:00;SUR;0;1;1;1
2019-05-08 01:30:00;SUR;0;2;2;1
2019-05-08 02:30:00;CONFLICTIVA;1;5;6;2
2019-05-08 03:00:00;SUR;0;3;3;1
2019-05-08 03:30:00;SUR;0;11;11;1
2019-05-08 04:00:00;SUR;0;15;15;1
2019-05-08 04:30:00;SUR;0;13;13;1
2019-05-08 05:00:00;SUR;0;22;22;1
2019-05-08 05:30:00;SUR;0;39;39;1
2019-05-08 06:00:00;SUR;0;24;24;1
2019-05-08 06:30:00;SUR;0;23;23;1
2019-05-08 07:00:00;SUR;0;31;31;1
2019-05-08 07:30:00;SUR;0;31;31;1
2019-05-08 08:00:00;SUR;0;39;39;1
2019-05-08 08:30:00;SUR;0;33;33;1
2019-05-08 09:00:00;SUR;0;35;35;1
2019-05-08 09:30:00;SUR;0;30;30;1
2019-05-08 10:00:00;SUR;0;36;36;1
2019-05-08 10:30:00;SUR;0;27;27;1
2019-05-08 11:00:00;SUR;0;40;40;1
2019-05-08 11:30:00;SUR;0;31;31;1
2019-05-08 12:00:00;SUR;0;19;19;1
2019-05-08 12:30:00;SUR;0;33;33;1
2019-05-08 13:00:00;SUR;0;36;36;1
2019-05-08 13:30:00;SUR;0;31;31;1
2019-05-08 14:00:00;SUR;0;41;41;1
2019-05-08 14:30:00;SUR;0;36;36;1
2019-05-08 15:00:00;SUR;0;33;33;1
2019-05-08 15:30:00;SUR;0;29;29;1
2019-05-08 16:00:00;SUR;0;17;17;1
2019-05-08 16:30:00;SUR;0;30;30;1
2019-05-08 17:00:00;SUR;0;23;23;1
2019-05-08 17:30:00;SUR;0;26;26;1
2019-05-08 18:00:00;SUR;0;36;36;1
2019-05-08 18:30:00;SUR;0;31;31;1
2019-05-08 19:00:00;SUR;0;32;32;1
2019-05-08 19:30:00;SUR;0;34;34;1
2019-05-08 20:00:00;SUR;0;38;38;1
2019-05-08 20:30:00;SUR;0;23;23;1
2019-05-08 21:00:00;SUR;0;22;22;1
2019-05-08 21:30:00;SUR;0;16;16;1
2019-05-08 22:00:00;SUR;0;13;13;1
2019-05-08 22:30:00;NORTE;13;0;13;1
2019-05-08 23:30:00;NORTE;1;0;1;1
2019-05-09 00:00:00;NORTE;1;0;1;1
2019-05-09 00:30:00;NORTE;1;0;1;1
2019-05-09 01:00:00;NORTE;2;0;2;1
2019-05-09 01:30:00;NORTE;2;0;2;1
2019-05-09 02:00:00;NORTE;2;0;2;1
2019-05-09 02:30:00;NORTE;3;0;3;1
2019-05-09 03:00:00;NORTE;3;0;3;1
2019-05-09 03:30:00;NORTE;4;0;4;1
2019-05-09 04:00:00;NORTE;14;0;14;1
2019-05-09 04:30:00;NORTE;10;0;10;1
2019-05-09 05:00:00;NORTE;18;0;18;1
2019-05-09 05:30:00;NORTE;37;0;37;1
2019-05-09 06:00:00;NORTE;20;0;20;1
2019-05-09 06:30:00;NORTE;25;0;25;1
2019-05-09 07:00:00;NORTE;25;0;25;1
2019-05-09 07:30:00;NORTE;33;0;33;1
2019-05-09 08:00:00;NORTE;28;0;28;1
2019-05-09 08:30:00;NORTE;35;0;35;1
2019-05-09 09:00:00;NORTE;26;0;26;1
2019-05-09 09:30:00;NORTE;32;0;32;1
2019-05-09 10:00:00;NORTE;41;0;41;1
2019-05-09 10:30:00;NORTE;30;0;30;1
2019-05-09 11:00:00;CONFLICTIVA;16;7;23;2
2019-05-09 11:30:00;SUR;0;30;30;1
2019-05-09 12:00:00;SUR;0;19;19;1
2019-05-09 12:30:00;SUR;0;28;28;1
2019-05-09 13:00:00;SUR;0;27;27;1
2019-05-09 13:30:00;SUR;0;24;24;1
2019-05-09 14:00:00;SUR;0;39;39;1
2019-05-09 14:30:00;SUR;0;28;28;1
2019-05-09 15:00:00;SUR;0;33;33;1
2019-05-09 15:30:00;SUR;0;30;30;1
2019-05-09 16:00:00;SUR;0;21;21;1
2019-05-09 16:30:00;SUR;0;26;26;1
2019-05-09 17:00:00;SUR;0;24;24;1
2019-05-09 17:30:00;SUR;0;23;23;1
2019-05-09 18:00:00;SUR;0;31;31;1
2019-05-09 18:30:00;SUR;0;33;33;1
2019-05-09 19:00:00;SUR;0;23;23;1
2019-05-09 19:30:00;SUR;0;24;24;1
2019-05-09 20:00:00;SUR;0;21;21;1
2019-05-09 20:30:00;SUR;0;20;20;1
2019-05-09 21:00:00;SUR;0;26;26;1
2019-05-09 21:30:00;SUR;0;18;18;1
2019-05-09 22:00:00;SUR;0;15;15;1
2019-05-09 22:30:00;SUR;0;9;9;1
2019-05-09 23:00:00;SUR;0;7;7;1
2019-05-09 23:30:00;SUR;0;5;5;1
2019-05-10 00:00:00;SUR;0;2;2;1
2019-05-10 00:30:00;SUR;0;4;4;1
2019-05-10 01:00:00;SUR;0;3;3;1
2019-05-10 01:30:00;CONFLICTIVA;1;3;4;2
2019-05-10 02:00:00;NORTE;7;0;7;1
2019-05-10 02:30:00;NORTE;4;0;4;1
2019-05-10 03:00:00;NORTE;2;0;2;1
2019-05-10 03:30:00;NORTE;6;0;6;1
2019-05-10 04:00:00;NORTE;15;0;15;1
2019-05-10 04:30:00;NORTE;5;0;5;1
2019-05-10 05:00:00;NORTE;20;0;20;1
2019-05-10 05:30:00;NORTE;42;0;42;1
2019-05-10 06:00:00;NORTE;19;0;19;1
2019-05-10 06:30:00;SUR;0;29;29;1
2019-05-10 07:00:00;SUR;0;37;37;1
2019-05-10 07:30:00;SUR;0;29;29;1
2019-05-10 08:00:00;SUR;0;35;35;1
2019-05-10 08:30:00;SUR;0;43;43;1
2019-05-10 09:00:00;SUR;0;34;34;1
2019-05-10 09:30:00;SUR;0;32;32;1
2019-05-10 10:00:00;SUR;0;38;38;1
2019-05-10 10:30:00;SUR;0;34;34;1
2019-05-10 11:00:00;SUR;0;28;28;1
2019-05-10 11:30:00;SUR;0;31;31;1
2019-05-10 12:00:00;SUR;0;26;26;1
2019-05-10 12:30:00;SUR;0;32;32;1
2019-05-10 13:00:00;SUR;0;33;33;1
2019-05-10 13:30:00;SUR;0;39;39;1
2019-05-10 14:00:00;SUR;0;35;35;1
2019-05-10 14:30:00;SUR;0;39;39;1
2019-05-10 15:00:00;SUR;0;32;32;1
2019-05-10 15:30:00;SUR;0;28;28;1
2019-05-10 16:00:00;SUR;0;24;24;1
2019-05-10 16:30:00;SUR;0;23;23;1
2019-05-10 17:00:00;SUR;0;28;28;1
2019-05-10 17:30:00;SUR;0;27;27;1
2019-05-10 18:00:00;SUR;0;40;40;1
2019-05-10 18:30:00;SUR;0;33;33;1
2019-05-10 19:00:00;SUR;0;33;33;1
2019-05-10 19:30:00;SUR;0;29;29;1
2019-05-10 20:00:00;SUR;0;27;27;1
2019-05-10 20:30:00;SUR;0;26;26;1
2019-05-10 21:00:00;SUR;0;19;19;1
2019-05-10 21:30:00;SUR;0;18;18;1
2019-05-10 22:00:00;NORTE;17;0;17;1
2019-05-10 22:30:00;NORTE;6;0;6;1
2019-05-10 23:00:00;NORTE;4;0;4;1
2019-05-10 23:30:00;NORTE;2;0;2;1
2019-05-11 00:00:00;NORTE;1;0;1;1
2019-05-11 00:30:00;NORTE;3;0;3;1
2019-05-11 01:30:00;NORTE;1;0;1;1
2019-05-11 02:00:00;NORTE;2;0;2;1
2019-05-11 02:30:00;NORTE;4;0;4;1
2019-05-11 03:00:00;NORTE;4;0;4;1
2019-05-11 03:30:00;NORTE;6;0;6;1
2019-05-11 04:00:00;NORTE;10;0;10;1
2019-05-11 04:30:00;NORTE;11;0;11;1
2019-05-11 05:00:00;NORTE;22;0;22;1
2019-05-11 05:30:00;NORTE;31;0;31;1
2019-05-11 06:00:00;NORTE;21;0;21;1
2019-05-11 06:30:00;NORTE;31;0;31;1
2019-05-11 07:00:00;NORTE;40;0;40;1
2019-05-11 07:30:00;NORTE;30;0;30;1
2019-05-11 08:00:00;NORTE;34;0;34;1
2019-05-11 08:30:00;NORTE;29;0;29;1
2019-05-11 09:00:00;NORTE;25;0;25;1
2019-05-11 09:30:00;NORTE;40;0;40;1
2019-05-11 10:00:00;NORTE;36;0;36;1
2019-05-11 10:30:00;NORTE;33;0;33;1
2019-05-11 11:00:00;NORTE;29;0;29;1
2019-05-11 11:30:00;NORTE;30;0;30;1
2019-05-11 12:00:00;NORTE;29;0;29;1
2019-05-11 12:30:00;NORTE;28;0;28;1
2019-05-11 13:00:00;NORTE;29;0;29;1
2019-05-11 13:30:00;NORTE;34;0;34;1
2019-05-11 14:00:00;NORTE;37;0;37;1
2019-05-11 14:30:00;NORTE;28;0;28;1
2019-05-11 15:00:00;NORTE;23;0;23;1
2019-05-11 15:30:00;NORTE;25;0;25;1
2019-05-11 16:00:00;NORTE;21;0;21;1
2019-05-11 16:30:00;NORTE;31;0;31;1
2019-05-11 17:00:00;NORTE;23;0;23;1
2019-05-11 17:30:00;NORTE;16;0;16;1
2019-05-11 18:00:00;NORTE;39;0;39;1
2019-05-11 18:30:00;NORTE;30;0;30;1
2019-05-11 19:00:00;NORTE;24;0;24;1
2019-05-11 19:30:00;NORTE;25;0;25;1
2019-05-11 20:00:00;NORTE;22;0;22;1
2019-05-11 20:30:00;NORTE;14;0;14;1
2019-05-11 21:00:00;NORTE;15;0;15;1
2019-05-11 21:30:00;NORTE;10;0;10;1
2019-05-11 22:00:00;NORTE;17;0;17;1
2019-05-11 22:30:00;NORTE;2;0;2;1
2019-05-11 23:00:00;NORTE;4;0;4;1
2019-05-11 23:30:00;NORTE;2;0;2;1
2019-05-12 00:00:00;NORTE;1;0;1;1
2019-05-12 00:30:00;NORTE;3;0;3;1
2019-05-12 01:00:00;NORTE;3;0;3;1
2019-05-12 01:30:00;NORTE;1;0;1;1
2019-05-12 02:00:00;NORTE;2;0;2;1
2019-05-12 02:30:00;NORTE;3;0;3;1
2019-05-12 03:00:00;NORTE;3;0;3;1
2019-05-12 03:30:00;NORTE;3;0;3;1
2019-05-12 04:00:00;NORTE;11;0;11;1
2019-05-12 04:30:00;NORTE;11;0;11;1
2019-05-12 05:00:00;NORTE;15;0;15;1
2019-05-12 05:30:00;NORTE;29;0;29;1
2019-05-12 06:00:00;NORTE;23;0;23;1
2019-05-12 06:30:00;NORTE;31;0;31;1
2019-05-12 07:00:00;NORTE;34;0;34;1
2019-05-12 07:30:00;NORTE;28;0;28;1
2019-05-12 08:00:00;NORTE;36;0;36;1
2019-05-12 08:30:00;NORTE;37;0;37;1
2019-05-12 09:00:00;NORTE;25;0;25;1
2019-05-12 09:30:00;NORTE;30;0;30;1
2019-05-12 10:00:00;NORTE;31;0;31;1
2019-05-12 10:30:00;NORTE;31;0;31;1
2019-05-12 11:00:00;NORTE;37;0;37;1
2019-05-12 11:30:00;NORTE;35;0;35;1
2019-05-12 12:00:00;NORTE;34;0;34;1
2019-05-12 12:30:00;NORTE;30;0;30;1
2019-05-12 13:00:00;NORTE;40;0;40;1
2019-05-12 13:30:00;NORTE;35;0;35;1
2019-05-12 14:00:00;NORTE;37;0;37;1
2019-05-12 14:30:00;NORTE;37;0;37;1
2019-05-12 15:00:00;NORTE;25;0;25;1
2019-05-12 15:30:00;NORTE;25;0;25;1
2019-05-12 16:00:00;NORTE;23;1;24;1
2019-05-12 16:30:00;NORTE;31;0;31;1
2019-05-12 17:00:00;NORTE;21;0;21;1
2019-05-12 17:30:00;NORTE;26;0;26;1
2019-05-12 18:00:00;NORTE;41;0;41;1
2019-05-12 18:30:00;NORTE;37;0;37;1
2019-05-12 19:00:00;NORTE;29;0;29;1
2019-05-12 19:30:00;NORTE;33;0;33;1
2019-05-12 20:00:00;NORTE;35;0;35;1
2019-05-12 20:30:00;NORTE;29;0;29;1
2019-05-12 21:00:00;NORTE;16;0;16;1
2019-05-12 21:30:00;NORTE;15;0;15;1
2019-05-12 22:00:00;NORTE;14;0;14;1
2019-05-12 22:30:00;NORTE;4;0;4;1
2019-05-12 23:00:00;NORTE;4;0;4;1
2019-05-13 00:00:00;NORTE;1;0;1;1
2019-05-13 00:30:00;NORTE;3;0;3;1
2019-05-13 01:30:00;NORTE;2;0;2;1
2019-05-13 02:00:00;NORTE;3;0;3;1
2019-05-13 02:30:00;NORTE;4;0;4;1
2019-05-13 03:00:00;NORTE;1;0;1;1
2019-05-13 03:30:00;NORTE;3;0;3;1
2019-05-13 04:00:00;NORTE;9;0;9;1
2019-05-13 04:30:00;NORTE;12;0;12;1
2019-05-13 05:00:00;NORTE;19;0;19;1
2019-05-13 05:30:00;NORTE;47;0;47;1
2019-05-13 06:00:00;NORTE;18;0;18;1
2019-05-13 06:30:00;NORTE;32;0;32;1
2019-05-13 07:00:00;NORTE;36;0;36;1
2019-05-13 07:30:00;NORTE;36;0;36;1
2019-05-13 08:00:00;NORTE;40;0;40;1
2019-05-13 08:30:00;NORTE;37;0;37;1
2019-05-13 09:00:00;NORTE;31;0;31;1
2019-05-13 09:30:00;NORTE;32;0;32;1
2019-05-13 10:00:00;NORTE;34;0;34;1
2019-05-13 10:30:00;NORTE;31;0;31;1
2019-05-13 11:00:00;NORTE;31;0;31;1
2019-05-13 11:30:00;NORTE;26;0;26;1
2019-05-13 12:00:00;NORTE;21;0;21;1
2019-05-13 12:30:00;NORTE;35;0;35;1
2019-05-13 13:00:00;NORTE;44;0;44;1
2019-05-13 13:30:00;NORTE;34;0;34;1
2019-05-13 14:00:00;NORTE;36;0;36;1
2019-05-13 14:30:00;NORTE;31;0;31;1
2019-05-13 15:00:00;NORTE;28;0;28;1
2019-05-13 15:30:00;NORTE;24;0;24;1
2019-05-13 16:00:00;NORTE;24;0;24;1
2019-05-13 16:30:00;NORTE;33;0;33;1
2019-05-13 17:00:00;NORTE;23;0;23;1
2019-05-13 17:30:00;NORTE;36;0;36;1
2019-05-13 18:00:00;NORTE;36;0;36;1
2019-05-13 18:30:00;NORTE;37;0;37;1
2019-05-13 19:00:00;NORTE;32;0;32;1
2019-05-13 19:30:00;NORTE;29;0;29;1
2019-05-13 20:00:00;NORTE;29;0;29;1
2019-05-13 20:30:00;NORTE;24;0;24;1
2019-05-13 21:00:00;NORTE;16;0;16;1
2019-05-13 21:30:00;NORTE;11;0;11;1
2019-05-13 22:00:00;NORTE;15;0;15;1
2019-05-13 22:30:00;NORTE;2;0;2;1
2019-05-13 23:00:00;NORTE;1;0;1;1
2019-05-14 00:00:00;NORTE;1;0;1;1
2019-05-14 00:30:00;NORTE;2;0;2;1
2019-05-14 01:00:00;NORTE;1;0;1;1
2019-05-14 02:00:00;NORTE;4;0;4;1
2019-05-14 02:30:00;NORTE;3;0;3;1
2019-05-14 03:00:00;NORTE;4;0;4;1
2019-05-14 03:30:00;NORTE;8;0;8;1
2019-05-14 04:00:00;NORTE;10;0;10;1
2019-05-14 04:30:00;NORTE;14;0;14;1
2019-05-14 05:00:00;NORTE;20;0;20;1
2019-05-14 05:30:00;NORTE;43;0;43;1
2019-05-14 06:00:00;NORTE;20;0;20;1
2019-05-14 06:30:00;NORTE;27;0;27;1
2019-05-14 07:00:00;NORTE;38;0;38;1
2019-05-14 07:30:00;NORTE;33;0;33;1
2019-05-14 08:00:00;NORTE;26;0;26;1
2019-05-14 08:30:00;NORTE;38;0;38;1
2019-05-14 09:00:00;NORTE;26;0;26;1
2019-05-14 09:30:00;NORTE;29;0;29;1
2019-05-14 10:00:00;NORTE;38;0;38;1
2019-05-14 10:30:00;NORTE;28;0;28;1
2019-05-14 11:00:00;NORTE;27;0;27;1
2019-05-14 11:30:00;NORTE;31;0;31;1
2019-05-14 12:00:00;NORTE;23;0;23;1
2019-05-14 12:30:00;NORTE;29;0;29;1
2019-05-14 13:00:00;NORTE;41;0;41;1
2019-05-14 13:30:00;NORTE;23;0;23;1
2019-05-14 14:00:00;NORTE;39;0;39;1
2019-05-14 14:30:00;NORTE;32;0;32;1
2019-05-14 15:00:00;NORTE;31;0;31;1
2019-05-14 15:30:00;NORTE;26;0;26;1
2019-05-14 16:00:00;NORTE;24;0;24;1
2019-05-14 16:30:00;NORTE;33;0;33;1
2019-05-14 17:00:00;NORTE;31;0;31;1
2019-05-14 17:30:00;NORTE;32;0;32;1
2019-05-14 18:00:00;NORTE;40;0;40;1
2019-05-14 18:30:00;NORTE;34;0;34;1
2019-05-14 19:00:00;NORTE;25;0;25;1
2019-05-14 19:30:00;NORTE;30;0;30;1
2019-05-14 20:00:00;NORTE;34;0;34;1
2019-05-14 20:30:00;NORTE;27;0;27;1
2019-05-14 21:00:00;NORTE;18;0;18;1
2019-05-14 21:30:00;NORTE;15;0;15;1
2019-05-14 22:00:00;NORTE;12;0;12;1
2019-05-14 22:30:00;NORTE;4;0;4;1
2019-05-14 23:00:00;NORTE;2;0;2;1
2019-05-14 23:30:00;NORTE;1;0;1;1
2019-05-15 00:30:00;NORTE;2;0;2;1
2019-05-15 01:00:00;NORTE;1;0;1;1
2019-05-15 01:30:00;NORTE;1;0;1;1
2019-05-15 02:00:00;NORTE;3;0;3;1
2019-05-15 02:30:00;NORTE;5;0;5;1
2019-05-15 03:00:00;NORTE;1;0;1;1
2019-05-15 03:30:00;NORTE;12;0;12;1
2019-05-15 04:00:00;NORTE;9;0;9;1
2019-05-15 04:30:00;NORTE;6;0;6;1
2019-05-15 05:00:00;NORTE;26;0;26;1
2019-05-15 05:30:00;NORTE;33;0;33;1
2019-05-15 06:00:00;NORTE;24;0;24;1
2019-05-15 06:30:00;NORTE;24;0;24;1
2019-05-15 07:00:00;NORTE;36;0;36;1
2019-05-15 07:30:00;NORTE;28;0;28;1
2019-05-15 08:00:00;NORTE;25;0;25;1
2019-05-15 08:30:00;NORTE;37;0;37;1
2019-05-15 09:00:00;NORTE;25;0;25;1
2019-05-15 09:30:00;NORTE;38;0;38;1
2019-05-15 10:00:00;NORTE;23;0;23;1
2019-05-15 10:30:00;NORTE;28;0;28;1
2019-05-15 11:00:00;NORTE;30;0;30;1
2019-05-15 11:30:00;NORTE;30;0;30;1
2019-05-15 12:00:00;NORTE;26;0;26;1
2019-05-15 12:30:00;NORTE;31;0;31;1
2019-05-15 13:00:00;NORTE;32;0;32;1
2019-05-15 13:30:00;NORTE;24;0;24;1
2019-05-15 14:00:00;NORTE;35;0;35;1
2019-05-15 14:30:00;NORTE;34;0;34;1
2019-05-15 15:00:00;NORTE;29;0;29;1
2019-05-15 15:30:00;NORTE;26;0;26;1
2019-05-15 16:00:00;NORTE;19;0;19;1
2019-05-15 16:30:00;NORTE;26;0;26;1
2019-05-15 17:00:00;NORTE;23;0;23;1
2019-05-15 17:30:00;NORTE;31;0;31;1
2019-05-15 18:00:00;NORTE;38;0;38;1
2019-05-15 18:30:00;NORTE;37;0;37;1
2019-05-15 19:00:00;NORTE;34;0;34;1
2019-05-15 19:30:00;NORTE;28;0;28;1
2019-05-15 20:00:00;NORTE;26;0;26;1
2019-05-15 20:30:00;NORTE;22;0;22;1
2019-05-15 21:00:00;NORTE;11;0;11;1
2019-05-15 21:30:00;NORTE;13;0;13;1
2019-05-15 22:00:00;NORTE;12;0;12;1
2019-05-15 22:30:00;NORTE;2;0;2;1
2019-05-15 23:00:00;NORTE;1;0;1;1
2019-05-15 23:30:00;NORTE;1;0;1;1
2019-05-16 00:30:00;NORTE;3;0;3;1
2019-05-16 01:30:00;NORTE;1;0;1;1
2019-05-16 02:00:00;NORTE;3;0;3;1
2019-05-16 02:30:00;NORTE;3;0;3;1
2019-05-16 03:00:00;NORTE;3;0;3;1
2019-05-16 03:30:00;NORTE;7;0;7;1
2019-05-16 04:00:00;NORTE;12;0;12;1
2019-05-16 04:30:00;NORTE;10;0;10;1
2019-05-16 05:00:00;NORTE;25;0;25;1
2019-05-16 05:30:00;NORTE;37;0;37;1
2019-05-16 06:00:00;NORTE;20;0;20;1
2019-05-16 06:30:00;NORTE;28;0;28;1
2019-05-16 07:00:00;NORTE;30;0;30;1
2019-05-16 07:30:00;NORTE;34;0;34;1
2019-05-16 08:00:00;NORTE;38;0;38;1
2019-05-16 08:30:00;NORTE;32;0;32;1
2019-05-16 09:00:00;NORTE;28;0;28;1
2019-05-16 09:30:00;NORTE;36;0;36;1
2019-05-16 10:00:00;NORTE;35;0;35;1
2019-05-16 10:30:00;NORTE;28;0;28;1
2019-05-16 11:00:00;CONFLICTIVA;8;16;24;2
2019-05-16 11:30:00;SUR;0;27;27;1
2019-05-16 12:00:00;SUR;0;25;25;1
2019-05-16 12:30:00;SUR;0;31;31;1
2019-05-16 13:00:00;SUR;0;37;37;1
2019-05-16 13:30:00;SUR;0;37;37;1
2019-05-16 14:00:00;SUR;0;41;41;1
2019-05-16 14:30:00;SUR;0;31;31;1
2019-05-16 15:00:00;SUR;0;27;27;1
2019-05-16 15:30:00;SUR;0;26;26;1
2019-05-16 16:00:00;SUR;0;18;18;1
2019-05-16 16:30:00;SUR;0;31;31;1
2019-05-16 17:00:00;SUR;0;23;23;1
2019-05-16 17:30:00;CONFLICTIVA;11;12;23;2
2019-05-16 18:00:00;NORTE;40;0;40;1
2019-05-16 18:30:00;NORTE;40;0;40;1
2019-05-16 19:00:00;NORTE;31;0;31;1
2019-05-16 19:30:00;NORTE;29;0;29;1
2019-05-16 20:00:00;NORTE;36;0;36;1
2019-05-16 20:30:00;NORTE;23;0;23;1
2019-05-16 21:00:00;NORTE;14;0;14;1
2019-05-16 21:30:00;NORTE;20;0;20;1
2019-05-16 22:00:00;NORTE;12;0;12;1
2019-05-16 22:30:00;NORTE;2;0;2;1
2019-05-16 23:00:00;NORTE;2;0;2;1
2019-05-16 23:30:00;NORTE;2;0;2;1
2019-05-17 00:30:00;NORTE;3;0;3;1
2019-05-17 01:00:00;NORTE;1;0;1;1
2019-05-17 02:00:00;NORTE;3;0;3;1
2019-05-17 02:30:00;NORTE;7;0;7;1
2019-05-17 03:00:00;NORTE;2;0;2;1
2019-05-17 03:30:00;NORTE;10;0;10;1
2019-05-17 04:00:00;NORTE;10;0;10;1
2019-05-17 04:30:00;NORTE;10;0;10;1
2019-05-17 05:00:00;NORTE;19;0;19;1
2019-05-17 05:30:00;NORTE;33;0;33;1
2019-05-17 06:00:00;NORTE;23;0;23;1
2019-05-17 06:30:00;NORTE;26;0;26;1
2019-05-17 07:00:00;NORTE;36;0;36;1
2019-05-17 07:30:00;NORTE;32;0;32;1
2019-05-17 08:00:00;NORTE;31;0;31;1
2019-05-17 08:30:00;NORTE;47;0;47;1
2019-05-17 09:00:00;NORTE;29;0;29;1
2019-05-17 09:30:00;NORTE;33;0;33;1
2019-05-17 10:00:00;NORTE;35;0;35;1
2019-05-17 10:30:00;NORTE;33;0;33;1
2019-05-17 11:00:00;NORTE;29;0;29;1
2019-05-17 11:30:00;NORTE;33;0;33;1
2019-05-17 12:00:00;NORTE;26;0;26;1
2019-05-17 12:30:00;NORTE;35;0;35;1
2019-05-17 13:00:00;NORTE;34;0;34;1
2019-05-17 13:30:00;NORTE;31;0;31;1
2019-05-17 14:00:00;NORTE;40;0;40;1
2019-05-17 14:30:00;NORTE;39;0;39;1
2019-05-17 15:00:00;NORTE;29;0;29;1
2019-05-17 15:30:00;NORTE;25;0;25;1
2019-05-17 16:00:00;NORTE;21;0;21;1
2019-05-17 16:30:00;NORTE;26;0;26;1
2019-05-17 17:00:00;NORTE;24;0;24;1
2019-05-17 17:30:00;NORTE;31;0;31;1
2019-05-17 18:00:00;NORTE;39;0;39;1
2019-05-17 18:30:00;NORTE;37;0;37;1
2019-05-17 19:00:00;NORTE;32;0;32;1
2019-05-17 19:30:00;NORTE;32;0;32;1
2019-05-17 20:00:00;NORTE;28;0;28;1
2019-05-17 20:30:48;NORTE;1;0;1;1
2019-05-17 20:31:57;NORTE;1;0;1;1
2019-05-17 20:32:09;NORTE;1;0;1;1
2019-05-17 20:33:22;NORTE;1;0;1;1
2019-05-17 20:34:04;NORTE;1;0;1;1
2019-05-17 20:35:37;NORTE;1;0;1;1
2019-05-17 20:36:10;NORTE;1;0;1;1
2019-05-17 20:36:30;NORTE;1;0;1;1
2019-05-17 20:36:46;NORTE;1;0;1;1
2019-05-17 20:37:55;NORTE;1;0;1;1
2019-05-17 20:38:04;NORTE;1;0;1;1
2019-05-17 20:38:26;NORTE;1;0;1;1
2019-05-17 20:41:20;NORTE;1;0;1;1
2019-05-17 20:41:58;NORTE;1;0;1;1
2019-05-17 20:42:38;NORTE;1;0;1;1
2019-05-17 20:43:04;NORTE;1;0;1;1
2019-05-17 20:44:10;NORTE;1;0;1;1
2019-05-17 20:45:10;NORTE;1;0;1;1
2019-05-17 20:45:47;NORTE;1;0;1;1
2019-05-17 20:47:18;NORTE;1;0;1;1
2019-05-17 20:47:37;NORTE;1;0;1;1
2019-05-17 20:48:23;NORTE;1;0;1;1
2019-05-17 20:49:54;NORTE;1;0;1;1
2019-05-17 20:50:05;NORTE;1;0;1;1
2019-05-17 20:51:13;NORTE;1;0;1;1
2019-05-17 20:52:00;NORTE;1;0;1;1
2019-05-17 20:53:34;NORTE;1;0;1;1
2019-05-17 20:54:03;NORTE;1;0;1;1
2019-05-17 20:55:49;NORTE;1;0;1;1
2019-05-17 20:56:52;NORTE;1;0;1;1
2019-05-17 20:58:06;NORTE;1;0;1;1
2019-05-17 20:58:49;NORTE;1;0;1;1
2019-05-17 20:59:06;NORTE;1;0;1;1
2019-05-17 21:00:00;NORTE;17;0;17;1
2019-05-17 21:30:00;NORTE;13;0;13;1
2019-05-17 22:00:00;NORTE;14;0;14;1
2019-05-17 22:30:00;NORTE;9;0;9;1
2019-05-17 23:00:00;NORTE;3;0;3;1
2019-05-17 23:30:00;NORTE;1;0;1;1
2019-05-18 00:00:00;NORTE;3;0;3;1
2019-05-18 00:30:00;NORTE;2;0;2;1
2019-05-18 01:00:00;NORTE;1;0;1;1
2019-05-18 02:00:00;NORTE;2;0;2;1
2019-05-18 02:30:00;NORTE;5;0;5;1
2019-05-18 03:00:00;NORTE;2;0;2;1
2019-05-18 03:30:00;NORTE;4;0;4;1
2019-05-18 04:00:00;NORTE;10;0;10;1
2019-05-18 04:30:00;NORTE;12;0;12;1
2019-05-18 05:00:00;NORTE;25;0;25;1
2019-05-18 05:30:00;NORTE;31;0;31;1
2019-05-18 06:00:00;NORTE;22;0;22;1
2019-05-18 06:30:00;NORTE;24;0;24;1
2019-05-18 07:00:00;NORTE;30;0;30;1
2019-05-18 07:30:00;NORTE;32;0;32;1
2019-05-18 08:00:00;NORTE;29;0;29;1
2019-05-18 08:30:00;NORTE;33;0;33;1
2019-05-18 09:00:00;NORTE;26;0;26;1
2019-05-18 09:30:00;NORTE;37;0;37;1
2019-05-18 10:00:00;NORTE;33;0;33;1
2019-05-18 10:30:00;NORTE;32;0;32;1
2019-05-18 11:00:00;NORTE;33;0;33;1
2019-05-18 11:30:00;NORTE;24;0;24;1
2019-05-18 12:00:00;NORTE;20;0;20;1
2019-05-18 12:30:00;NORTE;32;0;32;1
2019-05-18 13:00:00;NORTE;33;0;33;1
2019-05-18 13:30:00;NORTE;32;0;32;1
2019-05-18 14:00:00;NORTE;32;0;32;1
2019-05-18 14:30:00;NORTE;26;0;26;1
2019-05-18 15:00:00;NORTE;36;0;36;1
2019-05-18 15:30:00;NORTE;20;0;20;1
2019-05-18 16:00:00;NORTE;14;0;14;1
2019-05-18 16:30:00;NORTE;33;0;33;1
2019-05-18 17:00:00;NORTE;23;0;23;1
2019-05-18 17:30:00;NORTE;18;0;18;1
2019-05-18 18:00:00;NORTE;31;0;31;1
2019-05-18 18:30:00;NORTE;22;0;22;1
2019-05-18 19:00:00;NORTE;27;0;27;1
2019-05-18 19:30:00;NORTE;29;0;29;1
2019-05-18 20:00:00;NORTE;21;0;21;1
2019-05-18 20:30:00;NORTE;17;0;17;1
2019-05-18 21:00:00;NORTE;10;0;10;1
2019-05-18 21:30:00;NORTE;12;0;12;1
2019-05-18 22:00:00;NORTE;11;0;11;1
2019-05-18 22:30:00;NORTE;9;0;9;1
2019-05-18 23:30:00;NORTE;3;0;3;1
2019-05-19 00:00:00;NORTE;1;0;1;1
2019-05-19 00:30:00;NORTE;3;0;3;1
2019-05-19 01:00:00;NORTE;1;0;1;1
2019-05-19 01:30:00;NORTE;1;0;1;1
2019-05-19 02:00:00;NORTE;1;0;1;1
2019-05-19 02:30:00;NORTE;2;0;2;1
2019-05-19 03:00:00;NORTE;4;0;4;1
2019-05-19 03:30:00;NORTE;5;0;5;1
2019-05-19 04:00:00;NORTE;10;0;10;1
2019-05-19 04:30:00;NORTE;12;0;12;1
2019-05-19 05:00:00;NORTE;19;0;19;1
2019-05-19 05:30:00;NORTE;27;0;27;1
2019-05-19 06:00:00;NORTE;21;0;21;1
2019-05-19 06:30:00;NORTE;27;0;27;1
2019-05-19 07:00:00;NORTE;34;0;34;1
2019-05-19 07:30:00;NORTE;27;0;27;1
2019-05-19 08:00:00;NORTE;34;0;34;1
2019-05-19 08:30:00;NORTE;40;0;40;1
2019-05-19 09:00:00;NORTE;22;0;22;1
2019-05-19 09:30:00;NORTE;34;0;34;1
2019-05-19 10:00:00;NORTE;36;0;36;1
2019-05-19 10:30:00;NORTE;31;0;31;1
2019-05-19 11:00:00;NORTE;36;0;36;1
2019-05-19 11:30:00;NORTE;33;0;33;1
2019-05-19 12:00:00;NORTE;24;0;24;1
2019-05-19 12:30:00;NORTE;30;0;30;1
2019-05-19 13:00:00;NORTE;40;0;40;1
2019-05-19 13:30:00;NORTE;39;0;39;1
2019-05-19 14:00:00;NORTE;43;0;43;1
2019-05-19 14:30:00;NORTE;36;0;36;1
2019-05-19 15:00:00;NORTE;27;0;27;1
2019-05-19 15:30:00;NORTE;29;0;29;1
2019-05-19 16:00:00;NORTE;28;0;28;1
2019-05-19 16:30:00;NORTE;32;0;32;1
2019-05-19 17:00:00;NORTE;24;0;24;1
2019-05-19 17:30:00;NORTE;22;0;22;1
2019-05-19 18:00:00;NORTE;36;0;36;1
2019-05-19 18:30:00;NORTE;35;0;35;1
2019-05-19 19:00:00;NORTE;36;0;36;1
2019-05-19 19:30:00;NORTE;26;0;26;1
2019-05-19 20:00:00;NORTE;35;0;35;1
2019-05-19 20:30:00;NORTE;30;0;30;1
2019-05-19 21:00:00;NORTE;16;0;16;1
2019-05-19 21:30:00;NORTE;14;0;14;1
2019-05-19 22:00:00;NORTE;18;0;18;1
2019-05-19 22:30:00;NORTE;4;0;4;1
2019-05-19 23:00:00;NORTE;5;0;5;1
2019-05-19 23:30:00;NORTE;2;0;2;1
2019-05-20 00:30:00;NORTE;2;0;2;1
2019-05-20 01:00:00;NORTE;1;0;1;1
2019-05-20 01:30:00;NORTE;1;0;1;1
2019-05-20 02:00:00;NORTE;2;0;2;1
2019-05-20 02:30:00;NORTE;5;0;5;1
2019-05-20 03:00:00;NORTE;2;0;2;1
2019-05-20 03:30:00;NORTE;6;0;6;1
2019-05-20 04:00:00;NORTE;10;0;10;1
2019-05-20 04:30:00;NORTE;9;0;9;1
2019-05-20 05:00:00;NORTE;24;0;24;1
2019-05-20 05:30:00;NORTE;40;0;40;1
2019-05-20 06:00:00;NORTE;23;0;23;1
2019-05-20 06:30:00;NORTE;28;0;28;1
2019-05-20 07:00:00;NORTE;39;0;39;1
2019-05-20 07:30:00;NORTE;35;0;35;1
2019-05-20 08:00:00;NORTE;39;0;39;1
2019-05-20 08:30:00;NORTE;40;0;40;1
2019-05-20 09:00:00;NORTE;27;0;27;1
2019-05-20 09:30:00;NORTE;30;0;30;1
2019-05-20 10:00:00;NORTE;36;0;36;1
2019-05-20 10:30:00;NORTE;28;0;28;1
2019-05-20 11:00:00;NORTE;29;0;29;1
2019-05-20 11:30:00;NORTE;31;0;31;1
2019-05-20 12:00:00;NORTE;26;0;26;1
2019-05-20 12:30:00;NORTE;34;0;34;1
2019-05-20 13:00:00;NORTE;44;0;44;1
2019-05-20 13:30:00;NORTE;33;0;33;1
2019-05-20 14:00:00;NORTE;44;0;44;1
2019-05-20 14:30:00;NORTE;32;0;32;1
2019-05-20 15:00:00;NORTE;37;0;37;1
2019-05-20 15:30:00;NORTE;25;0;25;1
2019-05-20 16:00:00;NORTE;24;0;24;1
2019-05-20 16:30:00;NORTE;33;0;33;1
2019-05-20 17:00:00;NORTE;28;0;28;1
2019-05-20 17:30:00;NORTE;28;0;28;1
2019-05-20 18:00:00;NORTE;43;0;43;1
2019-05-20 18:30:00;NORTE;33;0;33;1
2019-05-20 19:00:00;NORTE;25;0;25;1
2019-05-20 19:30:00;NORTE;31;0;31;1
2019-05-20 20:00:00;NORTE;30;0;30;1
2019-05-20 20:30:00;NORTE;25;0;25;1
2019-05-20 21:00:00;NORTE;16;0;16;1
2019-05-20 21:30:00;NORTE;9;0;9;1
2019-05-20 22:00:00;NORTE;15;0;15;1
2019-05-20 22:30:00;NORTE;7;0;7;1
2019-05-21 00:00:00;NORTE;2;0;2;1
2019-05-21 01:00:00;NORTE;2;0;2;1
2019-05-21 01:30:00;NORTE;2;0;2;1
2019-05-21 02:00:00;NORTE;2;0;2;1
2019-05-21 02:30:00;NORTE;4;0;4;1
2019-05-21 03:00:00;NORTE;4;0;4;1
2019-05-21 03:30:00;NORTE;11;0;11;1
2019-05-21 04:00:00;NORTE;13;0;13;1
2019-05-21 04:30:00;NORTE;12;0;12;1
2019-05-21 05:00:00;NORTE;20;0;20;1
2019-05-21 05:30:00;NORTE;43;0;43;1
2019-05-21 06:00:00;NORTE;23;0;23;1
2019-05-21 06:30:00;NORTE;23;0;23;1
2019-05-21 07:00:00;NORTE;36;0;36;1
2019-05-21 07:30:00;NORTE;27;0;27;1
2019-05-21 08:00:00;NORTE;37;0;37;1
2019-05-21 08:30:00;NORTE;34;0;34;1
2019-05-21 09:00:00;NORTE;30;0;30;1
2019-05-21 09:30:00;NORTE;29;0;29;1
2019-05-21 10:00:00;NORTE;35;0;35;1
2019-05-21 10:30:00;NORTE;40;0;40;1
2019-05-21 11:00:00;NORTE;28;0;28;1
2019-05-21 11:30:00;NORTE;29;0;29;1
2019-05-21 12:00:00;NORTE;26;0;26;1
2019-05-21 12:30:00;NORTE;32;0;32;1
2019-05-21 13:00:00;NORTE;35;0;35;1
2019-05-21 13:30:00;NORTE;28;0;28;1
2019-05-21 14:00:00;NORTE;35;0;35;1
2019-05-21 14:30:00;NORTE;32;0;32;1
2019-05-21 15:00:00;NORTE;35;0;35;1
2019-05-21 15:30:00;NORTE;25;0;25;1
2019-05-21 16:00:00;NORTE;20;0;20;1
2019-05-21 16:30:00;NORTE;33;0;33;1
2019-05-21 17:00:00;NORTE;22;0;22;1
2019-05-21 17:30:00;NORTE;31;0;31;1
2019-05-21 18:00:00;NORTE;38;0;38;1
2019-05-21 18:30:00;NORTE;35;0;35;1
2019-05-21 19:00:00;NORTE;26;0;26;1
2019-05-21 19:30:00;NORTE;31;0;31;1
2019-05-21 20:00:00;NORTE;31;0;31;1
2019-05-21 20:30:00;NORTE;34;0;34;1
2019-05-21 21:00:00;NORTE;17;0;17;1
2019-05-21 21:30:00;NORTE;11;0;11;1
2019-05-21 22:00:00;NORTE;12;0;12;1
2019-05-21 22:30:00;NORTE;1;0;1;1
2019-05-21 23:00:00;NORTE;1;0;1;1
2019-05-21 23:30:00;NORTE;1;0;1;1
2019-05-22 00:30:00;NORTE;2;0;2;1
2019-05-22 01:30:00;NORTE;1;0;1;1
2019-05-22 02:00:00;NORTE;3;0;3;1
2019-05-22 02:30:00;NORTE;3;0;3;1
2019-05-22 03:00:00;NORTE;4;0;4;1
2019-05-22 03:30:00;NORTE;7;0;7;1
2019-05-22 04:00:00;NORTE;16;0;16;1
2019-05-22 04:30:00;NORTE;10;0;10;1
2019-05-22 05:00:00;NORTE;21;0;21;1
2019-05-22 05:30:00;NORTE;38;0;38;1
2019-05-22 06:00:00;NORTE;20;0;20;1
2019-05-22 06:30:00;NORTE;27;0;27;1
2019-05-22 07:00:00;NORTE;37;0;37;1
2019-05-22 07:30:00;NORTE;27;0;27;1
2019-05-22 08:00:00;NORTE;38;0;38;1
2019-05-22 08:30:00;NORTE;30;0;30;1
2019-05-22 09:00:00;NORTE;25;0;25;1
2019-05-22 09:30:00;NORTE;33;0;33;1
2019-05-22 10:00:00;NORTE;35;0;35;1
2019-05-22 10:30:00;NORTE;31;0;31;1
2019-05-22 11:00:00;NORTE;30;0;30;1
2019-05-22 11:30:00;NORTE;32;0;32;1
2019-05-22 12:00:00;NORTE;28;0;28;1
2019-05-22 12:30:00;NORTE;31;0;31;1
2019-05-22 13:00:00;NORTE;37;0;37;1
2019-05-22 13:30:00;NORTE;25;0;25;1
2019-05-22 14:00:00;NORTE;31;0;31;1
2019-05-22 14:30:00;NORTE;30;0;30;1
2019-05-22 15:00:00;NORTE;21;0;21;1
2019-05-22 15:30:00;NORTE;26;0;26;1
2019-05-22 16:00:00;NORTE;22;0;22;1
2019-05-22 16:30:00;NORTE;35;0;35;1
2019-05-22 17:00:00;NORTE;21;0;21;1
2019-05-22 17:30:00;NORTE;29;0;29;1
2019-05-22 18:00:00;NORTE;35;0;35;1
2019-05-22 18:30:00;NORTE;33;0;33;1
2019-05-22 19:00:00;NORTE;33;0;33;1
2019-05-22 19:30:00;NORTE;31;0;31;1
2019-05-22 20:00:00;NORTE;41;0;41;1
2019-05-22 20:30:00;NORTE;29;0;29;1
2019-05-22 21:00:00;NORTE;10;0;10;1
2019-05-22 21:30:00;NORTE;9;0;9;1
2019-05-22 22:00:00;NORTE;9;0;9;1
2019-05-22 22:30:00;NORTE;8;0;8;1
2019-05-22 23:30:00;NORTE;1;0;1;1
2019-05-23 00:30:00;NORTE;1;0;1;1
2019-05-23 01:00:00;NORTE;1;0;1;1
2019-05-23 02:00:00;NORTE;2;0;2;1
2019-05-23 02:30:00;NORTE;4;0;4;1
2019-05-23 03:00:00;NORTE;4;0;4;1
2019-05-23 03:30:00;NORTE;6;0;6;1
2019-05-23 04:00:00;NORTE;13;0;13;1
2019-05-23 04:30:00;NORTE;13;0;13;1
2019-05-23 05:00:00;NORTE;27;0;27;1
2019-05-23 05:30:00;NORTE;36;0;36;1
2019-05-23 06:00:00;NORTE;28;0;28;1
2019-05-23 06:30:00;NORTE;30;0;30;1
2019-05-23 07:00:00;NORTE;36;0;36;1
2019-05-23 07:30:00;NORTE;35;0;35;1
2019-05-23 08:00:00;NORTE;37;0;37;1
2019-05-23 08:30:00;NORTE;32;0;32;1
2019-05-23 09:00:00;NORTE;25;0;25;1
2019-05-23 09:30:00;NORTE;40;0;40;1
2019-05-23 10:00:00;NORTE;39;0;39;1
2019-05-23 10:30:00;NORTE;29;0;29;1
2019-05-23 11:00:00;NORTE;32;0;32;1
2019-05-23 11:30:00;NORTE;25;0;25;1
2019-05-23 12:00:00;NORTE;28;0;28;1
2019-05-23 12:30:00;NORTE;33;0;33;1
2019-05-23 13:00:00;CONFLICTIVA;19;14;33;2
2019-05-23 13:30:00;SUR;0;33;33;1
2019-05-23 14:00:00;SUR;0;36;36;1
2019-05-23 14:30:00;SUR;0;34;34;1
2019-05-23 15:00:00;SUR;0;31;31;1
2019-05-23 15:30:00;SUR;0;28;28;1
2019-05-23 16:00:00;SUR;0;16;16;1
2019-05-23 16:30:00;SUR;0;31;31;1
2019-05-23 17:00:00;SUR;0;26;26;1
2019-05-23 17:30:00;SUR;0;24;24;1
2019-05-23 18:00:00;SUR;0;37;37;1
2019-05-23 18:30:00;SUR;0;31;31;1
2019-05-23 19:00:00;SUR;0;35;35;1
2019-05-23 19:30:00;SUR;0;28;28;1
2019-05-23 20:00:00;NORTE;37;0;37;1
2019-05-23 20:30:00;NORTE;26;0;26;1
2019-05-23 21:00:00;NORTE;18;0;18;1
2019-05-23 21:30:00;NORTE;18;0;18;1
2019-05-23 22:00:00;NORTE;5;0;5;1
2019-05-23 22:30:00;NORTE;4;0;4;1
2019-05-23 23:00:00;NORTE;2;0;2;1
2019-05-23 23:30:00;NORTE;2;0;2;1
2019-05-24 00:30:00;NORTE;3;0;3;1
2019-05-24 01:00:00;NORTE;2;0;2;1
2019-05-24 02:00:00;NORTE;2;0;2;1
2019-05-24 02:30:00;NORTE;4;0;4;1
2019-05-24 03:00:00;NORTE;5;0;5;1
2019-05-24 03:30:00;NORTE;5;0;5;1
2019-05-24 04:00:00;NORTE;12;0;12;1
2019-05-24 04:30:00;NORTE;13;0;13;1
2019-05-24 05:00:00;NORTE;22;0;22;1
2019-05-24 05:30:00;NORTE;30;0;30;1
2019-05-24 06:00:00;NORTE;26;0;26;1
2019-05-24 06:30:00;NORTE;26;0;26;1
2019-05-24 07:00:00;NORTE;38;0;38;1
2019-05-24 07:30:00;NORTE;33;0;33;1
2019-05-24 08:00:00;NORTE;36;0;36;1
2019-05-24 08:30:00;NORTE;42;0;42;1
2019-05-24 09:00:00;NORTE;27;0;27;1
2019-05-24 09:30:00;NORTE;37;0;37;1
2019-05-24 10:00:00;NORTE;39;0;39;1
2019-05-24 10:30:00;NORTE;32;0;32;1
2019-05-24 11:00:00;NORTE;33;1;34;1
2019-05-24 11:30:00;NORTE;27;0;27;1
2019-05-24 12:00:00;NORTE;28;0;28;1
2019-05-24 12:30:00;NORTE;35;0;35;1
2019-05-24 13:00:00;NORTE;34;0;34;1
2019-05-24 13:30:00;NORTE;41;0;41;1
2019-05-24 14:00:00;NORTE;37;0;37;1
2019-05-24 14:30:00;NORTE;33;0;33;1
2019-05-24 15:00:00;NORTE;30;0;30;1
2019-05-24 15:30:00;NORTE;20;0;20;1
2019-05-24 16:00:00;NORTE;27;0;27;1
2019-05-24 16:30:00;NORTE;32;0;32;1
2019-05-24 17:00:00;NORTE;26;0;26;1
2019-05-24 17:30:00;NORTE;31;0;31;1
2019-05-24 18:00:00;NORTE;39;0;39;1
2019-05-24 18:30:00;NORTE;37;0;37;1
2019-05-24 19:00:00;NORTE;29;0;29;1
2019-05-24 19:30:00;NORTE;19;0;19;1
2019-05-24 20:00:00;NORTE;35;0;35;1
2019-05-24 20:30:00;NORTE;27;0;27;1
2019-05-24 21:00:00;NORTE;16;0;16;1
2019-05-24 21:30:00;NORTE;16;0;16;1
2019-05-24 22:00:00;NORTE;12;0;12;1
2019-05-24 22:30:00;NORTE;6;0;6;1
2019-05-24 23:30:00;NORTE;1;0;1;1
2019-05-25 01:00:00;NORTE;1;0;1;1
2019-05-25 01:30:00;NORTE;1;0;1;1
2019-05-25 02:00:00;NORTE;2;0;2;1
2019-05-25 02:30:00;NORTE;4;0;4;1
2019-05-25 03:00:00;NORTE;3;0;3;1
2019-05-25 03:30:00;NORTE;1;0;1;1
2019-05-25 04:00:00;NORTE;14;0;14;1
2019-05-25 04:30:00;NORTE;14;0;14;1
2019-05-25 05:00:00;NORTE;21;0;21;1
2019-05-25 05:30:00;NORTE;37;0;37;1
2019-05-25 06:00:00;NORTE;25;0;25;1
2019-05-25 06:30:00;NORTE;25;0;25;1
2019-05-25 07:00:00;NORTE;34;0;34;1
2019-05-25 07:30:00;NORTE;37;0;37;1
2019-05-25 08:00:00;NORTE;34;0;34;1
2019-05-25 08:30:00;NORTE;39;0;39;1
2019-05-25 09:00:00;NORTE;22;0;22;1
2019-05-25 09:30:00;NORTE;38;0;38;1
2019-05-25 10:00:00;NORTE;27;0;27;1
2019-05-25 10:30:00;NORTE;32;0;32;1
2019-05-25 11:00:00;NORTE;26;0;26;1
2019-05-25 11:30:00;NORTE;27;0;27;1
2019-05-25 12:00:00;NORTE;29;0;29;1
2019-05-25 12:30:00;NORTE;34;0;34;1
2019-05-25 13:00:00;NORTE;32;0;32;1
2019-05-25 13:30:00;NORTE;27;0;27;1
2019-05-25 14:00:00;NORTE;40;0;40;1
2019-05-25 14:30:00;NORTE;21;0;21;1
2019-05-25 15:00:00;NORTE;25;0;25;1
2019-05-25 15:30:00;NORTE;25;0;25;1
2019-05-25 16:00:00;NORTE;22;0;22;1
2019-05-25 16:30:00;NORTE;27;0;27;1
2019-05-25 17:00:00;NORTE;20;0;20;1
2019-05-25 17:30:00;NORTE;23;0;23;1
2019-05-25 18:00:00;NORTE;34;0;34;1
2019-05-25 18:30:00;NORTE;19;0;19;1
2019-05-25 19:00:00;NORTE;28;0;28;1
2019-05-25 19:30:00;NORTE;28;0;28;1
2019-05-25 20:00:00;NORTE;23;0;23;1
2019-05-25 20:30:00;NORTE;19;0;19;1
2019-05-25 21:00:00;NORTE;18;0;18;1
2019-05-25 21:30:00;NORTE;11;0;11;1
2019-05-25 22:00:00;NORTE;16;0;16;1
2019-05-25 22:30:00;NORTE;7;0;7;1
2019-05-25 23:30:00;NORTE;2;0;2;1
2019-05-26 00:30:00;NORTE;2;0;2;1
2019-05-26 01:00:00;NORTE;1;0;1;1
2019-05-26 02:00:00;NORTE;2;0;2;1
2019-05-26 02:30:00;NORTE;3;0;3;1
2019-05-26 03:00:00;NORTE;2;0;2;1
2019-05-26 03:30:00;NORTE;3;0;3;1
2019-05-26 04:00:00;NORTE;13;0;13;1
2019-05-26 04:30:00;NORTE;9;0;9;1
2019-05-26 05:00:00;NORTE;17;0;17;1
2019-05-26 05:30:00;NORTE;29;0;29;1
2019-05-26 06:00:00;NORTE;14;0;14;1
2019-05-26 06:30:00;NORTE;32;0;32;1
2019-05-26 07:00:00;NORTE;31;0;31;1
2019-05-26 07:30:00;NORTE;33;0;33;1
2019-05-26 08:00:00;NORTE;30;0;30;1
2019-05-26 08:30:00;NORTE;37;0;37;1
2019-05-26 09:00:00;NORTE;26;0;26;1
2019-05-26 09:30:00;NORTE;34;0;34;1
2019-05-26 10:00:00;NORTE;38;0;38;1
2019-05-26 10:30:00;NORTE;34;0;34;1
2019-05-26 11:00:00;NORTE;32;0;32;1
2019-05-26 11:30:00;NORTE;32;0;32;1
2019-05-26 12:00:00;NORTE;22;0;22;1
2019-05-26 12:30:00;NORTE;30;0;30;1
2019-05-26 13:00:00;NORTE;41;0;41;1
2019-05-26 13:30:00;NORTE;34;0;34;1
2019-05-26 14:00:00;NORTE;43;0;43;1
2019-05-26 14:30:00;NORTE;29;0;29;1
2019-05-26 15:00:00;NORTE;30;0;30;1
2019-05-26 15:30:00;NORTE;23;0;23;1
2019-05-26 16:00:00;NORTE;21;0;21;1
2019-05-26 16:30:47;NORTE;1;0;1;1
2019-05-26 16:31:15;NORTE;1;0;1;1
2019-05-26 16:31:25;NORTE;1;0;1;1
2019-05-26 16:33:07;NORTE;1;0;1;1
2019-05-26 16:34:49;NORTE;1;0;1;1
2019-05-26 16:35:34;NORTE;1;0;1;1
2019-05-26 16:36:14;NORTE;1;0;1;1
2019-05-26 16:36:49;NORTE;1;0;1;1
2019-05-26 16:38:08;NORTE;1;0;1;1
2019-05-26 16:39:13;NORTE;1;0;1;1
2019-05-26 16:40:00;NORTE;1;0;1;1
2019-05-26 16:40:57;NORTE;1;0;1;1
2019-05-26 16:42:25;NORTE;1;0;1;1
2019-05-26 16:42:45;NORTE;1;0;1;1
2019-05-26 16:44:26;NORTE;1;0;1;1
2019-05-26 16:45:33;NORTE;1;0;1;1
2019-05-26 16:46:27;NORTE;1;0;1;1
2019-05-26 16:46:30;NORTE;1;0;1;1
2019-05-26 16:47:12;NORTE;1;0;1;1
2019-05-26 16:48:22;NORTE;1;0;1;1
2019-05-26 16:48:27;NORTE;1;0;1;1
2019-05-26 16:48:32;NORTE;1;0;1;1
2019-05-26 16:49:18;NORTE;1;0;1;1
2019-05-26 16:49:42;NORTE;1;0;1;1
2019-05-26 16:51:02;NORTE;1;0;1;1
2019-05-26 16:51:50;NORTE;1;0;1;1
2019-05-26 16:52:04;NORTE;1;0;1;1
2019-05-26 16:53:10;NORTE;1;0;1;1
2019-05-26 16:54:51;NORTE;1;0;1;1
2019-05-26 16:55:52;NORTE;1;0;1;1
2019-05-26 16:57:01;NORTE;1;0;1;1
2019-05-26 16:57:47;NORTE;1;0;1;1
2019-05-26 16:58:29;NORTE;1;0;1;1
2019-05-26 16:59:01;NORTE;1;0;1;1
2019-05-26 16:59:32;NORTE;1;0;1;1
2019-05-26 17:00:00;NORTE;19;0;19;1
2019-05-26 17:30:00;NORTE;31;0;31;1
2019-05-26 18:00:00;NORTE;38;0;38;1
2019-05-26 18:30:00;NORTE;41;0;41;1
2019-05-26 19:00:00;NORTE;28;0;28;1
2019-05-26 19:30:00;NORTE;30;0;30;1
2019-05-26 20:00:00;NORTE;34;0;34;1
2019-05-26 20:30:00;NORTE;28;0;28;1
2019-05-26 21:00:00;NORTE;16;0;16;1
2019-05-26 21:30:00;NORTE;17;0;17;1
2019-05-26 22:00:00;NORTE;13;0;13;1
2019-05-26 22:30:00;NORTE;9;0;9;1
2019-05-26 23:30:00;NORTE;2;0;2;1
2019-05-27 00:30:00;NORTE;1;0;1;1
2019-05-27 01:00:00;NORTE;1;0;1;1
2019-05-27 02:00:00;NORTE;5;0;5;1
2019-05-27 02:30:00;NORTE;3;0;3;1
2019-05-27 03:00:00;NORTE;3;0;3;1
2019-05-27 03:30:00;NORTE;3;0;3;1
2019-05-27 04:00:00;NORTE;11;0;11;1
2019-05-27 04:30:00;NORTE;12;0;12;1
2019-05-27 05:00:00;NORTE;22;0;22;1
2019-05-27 05:30:00;NORTE;41;0;41;1
2019-05-27 06:00:00;NORTE;29;0;29;1
2019-05-27 06:30:00;NORTE;29;0;29;1
2019-05-27 07:00:00;NORTE;34;0;34;1
2019-05-27 07:30:00;NORTE;32;0;32;1
2019-05-27 08:00:00;NORTE;39;0;39;1
2019-05-27 08:30:00;NORTE;38;0;38;1
2019-05-27 09:00:00;NORTE;21;0;21;1
2019-05-27 09:30:00;NORTE;36;0;36;1
2019-05-27 10:00:00;NORTE;35;0;35;1
2019-05-27 10:30:00;NORTE;38;0;38;1
2019-05-27 11:00:00;NORTE;37;0;37;1
2019-05-27 11:30:00;NORTE;32;0;32;1
2019-05-27 12:00:00;NORTE;25;0;25;1
2019-05-27 12:30:00;NORTE;30;0;30;1
2019-05-27 13:00:00;NORTE;44;0;44;1
2019-05-27 13:30:00;NORTE;31;0;31;1
2019-05-27 14:00:00;NORTE;40;0;40;1
2019-05-27 14:30:00;NORTE;35;0;35;1
2019-05-27 15:00:00;NORTE;26;0;26;1
2019-05-27 15:30:00;NORTE;32;0;32;1
2019-05-27 16:00:00;NORTE;22;0;22;1
2019-05-27 16:30:00;NORTE;37;0;37;1
2019-05-27 17:00:00;NORTE;24;0;24;1
2019-05-27 17:30:00;NORTE;32;0;32;1
2019-05-27 18:00:00;NORTE;34;0;34;1
2019-05-27 18:30:00;NORTE;33;0;33;1
2019-05-27 19:00:00;NORTE;26;0;26;1
2019-05-27 19:30:00;NORTE;32;0;32;1
2019-05-27 20:00:00;NORTE;33;0;33;1
2019-05-27 20:30:00;NORTE;24;0;24;1
2019-05-27 21:00:00;NORTE;17;0;17;1
2019-05-27 21:30:00;NORTE;10;0;10;1
2019-05-27 22:00:00;NORTE;11;0;11;1
2019-05-27 22:30:00;NORTE;8;0;8;1
2019-05-27 23:00:00;NORTE;1;0;1;1
2019-05-28 00:30:00;NORTE;1;0;1;1
2019-05-28 01:30:00;NORTE;1;0;1;1
2019-05-28 02:00:00;NORTE;4;0;4;1
2019-05-28 02:30:00;NORTE;3;0;3;1
2019-05-28 03:00:00;NORTE;5;0;5;1
2019-05-28 03:30:00;NORTE;6;0;6;1
2019-05-28 04:00:00;NORTE;13;0;13;1
2019-05-28 04:30:00;NORTE;13;0;13;1
2019-05-28 05:00:00;NORTE;21;0;21;1
2019-05-28 05:30:00;NORTE;42;0;42;1
2019-05-28 06:00:00;NORTE;24;0;24;1
2019-05-28 06:30:00;NORTE;24;0;24;1
2019-05-28 07:00:00;NORTE;40;0;40;1
2019-05-28 07:30:00;NORTE;31;0;31;1
2019-05-28 08:00:00;NORTE;37;0;37;1
2019-05-28 08:30:00;NORTE;35;0;35;1
2019-05-28 09:00:00;NORTE;27;0;27;1
2019-05-28 09:30:00;NORTE;36;0;36;1
2019-05-28 10:00:00;NORTE;48;0;48;1
2019-05-28 10:30:00;NORTE;27;0;27;1
2019-05-28 11:00:00;NORTE;26;0;26;1
2019-05-28 11:30:00;NORTE;34;0;34;1
2019-05-28 12:00:00;NORTE;27;0;27;1
2019-05-28 12:30:00;NORTE;33;0;33;1
2019-05-28 13:00:00;NORTE;37;0;37;1
2019-05-28 13:30:00;NORTE;31;0;31;1
2019-05-28 14:00:00;NORTE;30;0;30;1
2019-05-28 14:30:00;NORTE;36;0;36;1
2019-05-28 15:00:00;NORTE;29;0;29;1
2019-05-28 15:30:00;NORTE;25;0;25;1
2019-05-28 16:00:00;NORTE;24;0;24;1
2019-05-28 16:30:00;NORTE;32;0;32;1
2019-05-28 17:00:00;NORTE;23;0;23;1
2019-05-28 17:30:00;NORTE;30;0;30;1
2019-05-28 18:00:00;NORTE;37;0;37;1
2019-05-28 18:30:00;NORTE;40;0;40;1
2019-05-28 19:00:00;NORTE;28;0;28;1
2019-05-28 19:30:00;NORTE;35;1;36;1
2019-05-28 20:00:00;NORTE;35;0;35;1
2019-05-28 20:30:00;NORTE;33;0;33;1
2019-05-28 21:00:00;NORTE;15;0;15;1
2019-05-28 21:30:00;NORTE;22;0;22;1
2019-05-28 22:00:00;NORTE;10;0;10;1
2019-05-28 22:30:00;NORTE;4;0;4;1
2019-05-28 23:30:00;NORTE;1;0;1;1
2019-05-29 00:00:00;NORTE;1;0;1;1
2019-05-29 00:30:00;NORTE;1;0;1;1
2019-05-29 01:30:00;NORTE;1;0;1;1
2019-05-29 02:30:00;NORTE;4;0;4;1
2019-05-29 03:00:00;NORTE;5;0;5;1
2019-05-29 03:30:00;NORTE;10;0;10;1
2019-05-29 04:00:00;NORTE;15;0;15;1
2019-05-29 04:30:00;NORTE;13;0;13;1
2019-05-29 05:00:00;NORTE;22;0;22;1
2019-05-29 05:30:00;NORTE;39;0;39;1
2019-05-29 06:00:00;NORTE;21;0;21;1
2019-05-29 06:30:00;NORTE;27;0;27;1
2019-05-29 07:00:00;NORTE;44;0;44;1
2019-05-29 07:30:00;NORTE;28;0;28;1
2019-05-29 08:00:00;NORTE;37;0;37;1
2019-05-29 08:30:00;NORTE;39;0;39;1
2019-05-29 09:00:00;NORTE;24;0;24;1
2019-05-29 09:30:00;NORTE;33;0;33;1
2019-05-29 10:00:00;NORTE;35;0;35;1
2019-05-29 10:30:00;NORTE;34;0;34;1
2019-05-29 11:00:00;NORTE;33;0;33;1
2019-05-29 11:30:00;NORTE;32;0;32;1
2019-05-29 12:00:00;NORTE;31;0;31;1
2019-05-29 12:30:00;NORTE;32;0;32;1
2019-05-29 13:00:00;NORTE;30;0;30;1
2019-05-29 13:30:00;NORTE;26;0;26;1
2019-05-29 14:00:00;NORTE;31;0;31;1
2019-05-29 14:30:00;NORTE;30;0;30;1
2019-05-29 15:00:00;NORTE;25;0;25;1
2019-05-29 15:30:00;NORTE;33;0;33;1
2019-05-29 16:00:00;NORTE;25;0;25;1
2019-05-29 16:30:00;NORTE;26;0;26;1
2019-05-29 17:00:00;NORTE;32;0;32;1
2019-05-29 17:30:00;NORTE;27;0;27;1
2019-05-29 18:00:00;NORTE;40;0;40;1
2019-05-29 18:30:00;NORTE;39;0;39;1
2019-05-29 19:00:00;NORTE;30;0;30;1
2019-05-29 19:30:00;NORTE;31;0;31;1
2019-05-29 20:00:00;NORTE;38;0;38;1
2019-05-29 20:30:00;NORTE;30;0;30;1
2019-05-29 21:00:00;NORTE;21;0;21;1
2019-05-29 21:30:00;NORTE;14;0;14;1
2019-05-29 22:00:00;NORTE;9;0;9;1
2019-05-29 22:30:00;NORTE;4;0;4;1
2019-05-29 23:30:00;NORTE;1;0;1;1
2019-05-30 01:00:00;NORTE;3;0;3;1
2019-05-30 01:30:00;NORTE;1;0;1;1
2019-05-30 02:00:00;NORTE;2;0;2;1
2019-05-30 02:30:00;NORTE;5;0;5;1
2019-05-30 03:00:00;NORTE;2;0;2;1
2019-05-30 03:30:00;NORTE;8;0;8;1
2019-05-30 04:00:00;NORTE;13;0;13;1
2019-05-30 04:30:00;NORTE;12;0;12;1
2019-05-30 05:00:00;NORTE;21;0;21;1
2019-05-30 05:30:00;NORTE;36;0;36;1
2019-05-30 06:00:00;NORTE;28;0;28;1
2019-05-30 06:30:00;NORTE;31;0;31;1
2019-05-30 07:00:00;NORTE;32;0;32;1
2019-05-30 07:30:00;NORTE;29;0;29;1
2019-05-30 08:00:00;NORTE;40;0;40;1
2019-05-30 08:30:00;NORTE;42;0;42;1
2019-05-30 09:00:00;NORTE;20;0;20;1
2019-05-30 09:30:00;NORTE;40;0;40;1
2019-05-30 10:00:00;NORTE;37;0;37;1
2019-05-30 10:30:00;NORTE;33;0;33;1
2019-05-30 11:00:00;NORTE;35;0;35;1
2019-05-30 11:30:00;NORTE;30;0;30;1
2019-05-30 12:00:00;NORTE;32;0;32;1
2019-05-30 12:30:00;NORTE;35;0;35;1
2019-05-30 13:00:00;NORTE;31;0;31;1
2019-05-30 13:30:00;NORTE;36;0;36;1
2019-05-30 14:00:00;NORTE;37;0;37;1
2019-05-30 14:30:00;NORTE;32;0;32;1
2019-05-30 15:00:00;NORTE;30;0;30;1
2019-05-30 15:30:00;NORTE;29;0;29;1
2019-05-30 16:00:00;NORTE;22;0;22;1
2019-05-30 16:30:00;NORTE;36;0;36;1
2019-05-30 17:00:00;NORTE;28;0;28;1
2019-05-30 17:30:00;NORTE;31;0;31;1
2019-05-30 18:00:00;NORTE;43;0;43;1
2019-05-30 18:30:00;NORTE;34;0;34;1
2019-05-30 19:00:00;NORTE;31;0;31;1
2019-05-30 19:30:00;NORTE;41;0;41;1
2019-05-30 20:00:00;NORTE;29;0;29;1
2019-05-30 20:30:00;NORTE;32;0;32;1
2019-05-30 21:00:00;NORTE;19;0;19;1
2019-05-30 21:30:00;NORTE;14;0;14;1
2019-05-30 22:00:00;NORTE;12;0;12;1
2019-05-30 22:30:00;CONFLICTIVA;5;1;6;2
2019-05-30 23:00:00;NORTE;2;0;2;1
2019-05-31 00:30:00;NORTE;3;0;3;1
2019-05-31 01:00:00;NORTE;1;0;1;1
2019-05-31 02:00:00;NORTE;3;0;3;1
2019-05-31 02:30:00;NORTE;4;0;4;1
2019-05-31 03:00:00;NORTE;5;0;5;1
2019-05-31 03:30:00;NORTE;9;0;9;1
2019-05-31 04:00:00;NORTE;7;0;7;1
2019-05-31 04:30:00;NORTE;16;0;16;1
2019-05-31 05:00:00;NORTE;24;0;24;1
2019-05-31 05:30:00;NORTE;40;0;40;1
2019-05-31 06:00:00;NORTE;27;0;27;1
2019-05-31 06:30:00;NORTE;35;0;35;1
2019-05-31 07:00:00;NORTE;41;0;41;1
2019-05-31 07:30:00;NORTE;33;0;33;1
2019-05-31 08:00:00;NORTE;35;0;35;1
2019-05-31 08:30:00;NORTE;48;0;48;1
2019-05-31 09:00:00;NORTE;40;0;40;1
2019-05-31 09:30:00;NORTE;44;0;44;1
2019-05-31 10:00:00;NORTE;42;1;43;1
2019-05-31 10:30:00;NORTE;45;0;45;1
2019-05-31 11:00:00;NORTE;36;0;36;1
2019-05-31 11:30:00;NORTE;35;0;35;1
2019-05-31 12:00:00;NORTE;41;0;41;1
2019-05-31 12:30:00;NORTE;38;0;38;1
2019-05-31 13:00:00;NORTE;39;0;39;1
2019-05-31 13:30:00;NORTE;44;0;44;1
2019-05-31 14:00:00;NORTE;39;0;39;1
2019-05-31 14:30:00;NORTE;41;0;41;1
2019-05-31 15:00:00;NORTE;46;0;46;1
2019-05-31 15:30:00;NORTE;38;0;38;1
2019-05-31 16:00:00;NORTE;37;0;37;1
2019-05-31 16:30:00;NORTE;40;0;40;1
2019-05-31 17:00:00;NORTE;42;0;42;1
2019-05-31 17:30:00;NORTE;37;0;37;1
2019-05-31 18:00:00;NORTE;44;0;44;1
2019-05-31 18:30:00;NORTE;36;0;36;1
2019-05-31 19:00:00;NORTE;40;0;40;1
2019-05-31 19:30:00;NORTE;31;0;31;1
2019-05-31 20:00:00;NORTE;34;0;34;1
2019-05-31 20:30:00;NORTE;38;0;38;1
2019-05-31 21:00:00;NORTE;25;0;25;1
2019-05-31 21:30:00;NORTE;20;0;20;1
2019-05-31 22:00:00;NORTE;15;0;15;1
2019-05-31 22:30:00;NORTE;9;0;9;1
2019-05-31 23:00:00;NORTE;4;0;4;1
2019-05-31 23:30:00;NORTE;4;0;4;1
2019-06-01 00:00:00;NORTE;4;0;4;1
2019-06-01 00:30:00;NORTE;4;0;4;1
2019-06-01 01:00:00;NORTE;5;0;5;1
2019-06-01 01:30:00;NORTE;4;0;4;1
2019-06-01 02:00:00;NORTE;3;0;3;1
2019-06-01 02:30:00;NORTE;3;0;3;1
2019-06-01 03:00:00;NORTE;6;0;6;1
2019-06-01 03:30:00;NORTE;9;0;9;1
2019-06-01 04:00:00;NORTE;13;0;13;1
2019-06-01 04:30:00;NORTE;16;0;16;1
2019-06-01 05:00:00;NORTE;29;0;29;1
2019-06-01 05:30:00;NORTE;39;0;39;1
2019-06-01 06:00:00;NORTE;33;0;33;1
2019-06-01 06:30:00;NORTE;30;0;30;1
2019-06-01 07:00:00;NORTE;44;0;44;1
2019-06-01 07:30:00;NORTE;39;0;39;1
2019-06-01 08:00:00;NORTE;39;0;39;1
2019-06-01 08:30:00;NORTE;36;0;36;1
2019-06-01 09:00:00;NORTE;30;0;30;1
2019-06-01 09:30:00;NORTE;43;0;43;1
2019-06-01 10:00:00;NORTE;43;0;43;1
2019-06-01 10:30:00;NORTE;45;0;45;1
2019-06-01 11:00:00;NORTE;35;0;35;1
2019-06-01 11:30:00;NORTE;29;0;29;1
2019-06-01 12:00:00;NORTE;41;0;41;1
2019-06-01 12:30:00;NORTE;32;0;32;1
2019-06-01 13:00:00;NORTE;42;0;42;1
2019-06-01 13:30:00;NORTE;34;0;34;1
2019-06-01 14:00:00;NORTE;41;0;41;1
2019-06-01 14:30:00;NORTE;37;0;37;1
2019-06-01 15:00:00;NORTE;38;0;38;1
2019-06-01 15:30:00;NORTE;33;0;33;1
2019-06-01 16:00:00;NORTE;14;0;14;1
2019-06-01 16:30:00;NORTE;26;0;26;1
2019-06-01 17:00:00;NORTE;25;0;25;1
2019-06-01 17:30:00;NORTE;27;0;27;1
2019-06-01 18:00:00;NORTE;35;0;35;1
2019-06-01 18:30:00;NORTE;29;0;29;1
2019-06-01 19:00:00;NORTE;29;0;29;1
2019-06-01 19:30:00;NORTE;22;0;22;1
2019-06-01 20:00:00;NORTE;23;0;23;1
2019-06-01 20:30:00;NORTE;21;0;21;1
2019-06-01 21:00:00;NORTE;10;0;10;1
2019-06-01 21:30:00;NORTE;21;0;21;1
2019-06-01 22:00:00;NORTE;23;0;23;1
2019-06-01 22:30:00;NORTE;16;0;16;1
2019-06-01 23:00:00;NORTE;12;0;12;1
2019-06-01 23:30:00;NORTE;15;0;15;1
2019-06-02 00:00:00;NORTE;13;0;13;1
2019-06-02 00:30:00;NORTE;10;0;10;1
2019-06-02 01:00:00;CONFLICTIVA;2;9;11;2
2019-06-02 01:30:00;SUR;0;16;16;1
2019-06-02 02:00:00;SUR;0;8;8;1
2019-06-02 02:30:00;CONFLICTIVA;7;4;11;2
2019-06-02 03:00:00;NORTE;9;0;9;1
2019-06-02 03:30:00;NORTE;8;0;8;1
2019-06-02 04:00:00;NORTE;14;0;14;1
2019-06-02 04:30:00;NORTE;16;0;16;1
2019-06-02 05:00:00;NORTE;29;0;29;1
2019-06-02 05:30:00;NORTE;40;0;40;1
2019-06-02 06:00:00;NORTE;36;0;36;1
2019-06-02 06:30:00;NORTE;35;0;35;1
2019-06-02 07:00:00;NORTE;48;0;48;1
2019-06-02 07:30:00;NORTE;33;0;33;1
2019-06-02 08:00:00;NORTE;42;0;42;1
2019-06-02 08:30:00;NORTE;48;0;48;1
2019-06-02 09:00:00;NORTE;40;0;40;1
2019-06-02 09:30:00;NORTE;40;0;40;1
2019-06-02 10:00:00;NORTE;55;0;55;1
2019-06-02 10:30:00;NORTE;39;0;39;1
2019-06-02 11:00:00;NORTE;40;0;40;1
2019-06-02 11:30:00;NORTE;39;0;39;1
2019-06-02 12:00:00;NORTE;33;0;33;1
2019-06-02 12:30:00;NORTE;40;0;40;1
2019-06-02 13:00:00;NORTE;42;0;42;1
2019-06-02 13:30:00;NORTE;44;0;44;1
2019-06-02 14:00:00;NORTE;47;0;47;1
2019-06-02 14:30:00;NORTE;48;0;48;1
2019-06-02 15:00:00;NORTE;46;0;46;1
2019-06-02 15:30:00;NORTE;35;0;35;1
2019-06-02 16:00:00;NORTE;27;0;27;1
2019-06-02 16:30:00;NORTE;42;0;42;1
2019-06-02 17:00:00;NORTE;37;0;37;1
2019-06-02 17:30:00;NORTE;28;0;28;1
2019-06-02 18:00:00;NORTE;41;0;41;1
2019-06-02 18:30:00;NORTE;32;0;32;1
2019-06-02 19:00:00;NORTE;38;0;38;1
2019-06-02 19:30:00;NORTE;26;0;26;1
2019-06-02 20:00:00;NORTE;34;0;34;1
2019-06-02 20:30:00;NORTE;38;0;38;1
2019-06-02 21:00:00;NORTE;19;0;19;1
2019-06-02 21:30:00;NORTE;22;0;22;1
2019-06-02 22:00:00;NORTE;21;0;21;1
2019-06-02 22:30:00;NORTE;7;0;7;1
2019-06-02 23:00:00;NORTE;3;0;3;1
2019-06-02 23:30:00;NORTE;3;0;3;1
2019-06-03 00:00:00;NORTE;2;0;2;1
2019-06-03 00:30:00;NORTE;4;0;4;1
2019-06-03 01:00:00;NORTE;3;0;3;1
2019-06-03 01:30:00;NORTE;1;0;1;1
2019-06-03 02:00:00;NORTE;8;0;8;1
2019-06-03 02:30:00;NORTE;4;0;4;1
2019-06-03 03:00:00;NORTE;2;0;2;1
2019-06-03 03:30:00;NORTE;6;0;6;1
2019-06-03 04:00:00;NORTE;9;0;9;1
2019-06-03 04:30:00;NORTE;14;0;14;1
2019-06-03 05:00:00;NORTE;22;0;22;1
2019-06-03 05:30:00;NORTE;43;0;43;1
2019-06-03 06:00:00;NORTE;26;0;26;1
2019-06-03 06:30:00;NORTE;30;0;30;1
2019-06-03 07:00:00;NORTE;33;0;33;1
2019-06-03 07:30:00;NORTE;31;0;31;1
2019-06-03 08:00:00;NORTE;41;0;41;1
2019-06-03 08:30:00;NORTE;38;0;38;1
2019-06-03 09:00:00;NORTE;39;0;39;1
2019-06-03 09:30:00;NORTE;32;0;32;1
2019-06-03 10:00:00;NORTE;34;0;34;1
2019-06-03 10:30:00;NORTE;35;0;35;1
2019-06-03 11:00:00;NORTE;37;0;37;1
2019-06-03 11:30:00;NORTE;29;0;29;1
2019-06-03 12:00:00;SUR;1;21;22;1
2019-06-03 12:30:00;SUR;0;38;38;1
2019-06-03 13:00:00;SUR;0;43;43;1
2019-06-03 13:30:00;SUR;0;34;34;1
2019-06-03 14:00:00;SUR;0;36;36;1
2019-06-03 14:30:00;SUR;0;41;41;1
2019-06-03 15:00:00;SUR;0;35;35;1
2019-06-03 15:30:00;SUR;0;24;24;1
2019-06-03 16:00:00;SUR;0;20;20;1
2019-06-03 16:30:00;SUR;0;36;36;1
2019-06-03 17:00:00;SUR;0;31;31;1
2019-06-03 17:30:00;SUR;0;30;30;1
2019-06-03 18:00:00;SUR;0;32;32;1
2019-06-03 18:30:00;SUR;0;39;39;1
2019-06-03 19:00:00;SUR;0;38;38;1
2019-06-03 19:30:00;SUR;0;32;32;1
2019-06-03 20:00:00;SUR;0;20;20;1
2019-06-03 20:30:00;NORTE;27;1;28;1
2019-06-03 21:00:00;NORTE;26;0;26;1
2019-06-03 21:30:00;NORTE;18;0;18;1
2019-06-03 22:00:00;NORTE;15;0;15;1
2019-06-03 22:30:00;NORTE;6;0;6;1
2019-06-03 23:00:00;NORTE;3;0;3;1
2019-06-03 23:30:00;NORTE;1;0;1;1
2019-06-04 00:00:00;NORTE;1;0;1;1
2019-06-04 01:00:00;NORTE;2;0;2;1
2019-06-04 01:30:00;NORTE;1;0;1;1
2019-06-04 02:00:00;NORTE;6;0;6;1
2019-06-04 02:30:00;NORTE;4;0;4;1
2019-06-04 03:00:00;NORTE;1;0;1;1
2019-06-04 03:30:00;NORTE;11;0;11;1
2019-06-04 04:00:00;NORTE;6;0;6;1
2019-06-04 04:30:00;SUR;0;17;17;1
2019-06-04 05:00:00;SUR;0;27;27;1
2019-06-04 05:30:00;SUR;0;39;39;1
2019-06-04 06:00:00;SUR;0;21;21;1
2019-06-04 06:30:00;SUR;0;32;32;1
2019-06-04 07:00:00;SUR;0;34;34;1
2019-06-04 07:30:00;SUR;0;26;26;1
2019-06-04 08:00:00;SUR;0;27;27;1
2019-06-04 08:30:00;SUR;0;39;39;1
2019-06-04 09:00:00;SUR;0;30;30;1
2019-06-04 09:30:00;SUR;0;33;33;1
2019-06-04 10:00:00;SUR;0;33;33;1
2019-06-04 10:30:00;SUR;0;35;35;1
2019-06-04 11:00:00;SUR;0;20;20;1
2019-06-04 11:30:00;SUR;0;35;35;1
2019-06-04 12:00:00;SUR;0;29;29;1
2019-06-04 12:30:00;SUR;0;31;31;1
2019-06-04 13:00:00;SUR;0;39;39;1
2019-06-04 13:30:00;SUR;0;37;37;1
2019-06-04 14:00:00;SUR;0;36;36;1
2019-06-04 14:30:00;SUR;0;35;35;1
2019-06-04 15:00:00;SUR;0;25;25;1
2019-06-04 15:30:00;SUR;0;24;24;1
2019-06-04 16:00:00;SUR;0;18;18;1
2019-06-04 16:30:00;SUR;0;32;32;1
2019-06-04 17:00:00;SUR;0;24;24;1
2019-06-04 17:30:00;SUR;0;33;33;1
2019-06-04 18:00:00;SUR;0;38;38;1
2019-06-04 18:30:00;SUR;0;35;35;1
2019-06-04 19:00:00;SUR;0;30;30;1
2019-06-04 19:30:00;SUR;0;36;36;1
2019-06-04 20:00:00;CONFLICTIVA;9;16;25;2
2019-06-04 20:30:00;NORTE;32;0;32;1
2019-06-04 21:00:00;NORTE;22;0;22;1
2019-06-04 21:30:00;NORTE;16;0;16;1
2019-06-04 22:00:00;NORTE;14;0;14;1
2019-06-04 22:30:00;NORTE;8;0;8;1
2019-06-05 00:00:00;NORTE;1;0;1;1
2019-06-05 00:30:00;NORTE;1;0;1;1
2019-06-05 01:00:00;NORTE;1;0;1;1
2019-06-05 02:00:00;NORTE;4;0;4;1
2019-06-05 02:30:00;NORTE;4;0;4;1
2019-06-05 03:00:00;NORTE;1;0;1;1
2019-06-05 03:30:00;NORTE;7;0;7;1
2019-06-05 04:00:00;NORTE;17;0;17;1
2019-06-05 04:30:00;NORTE;10;0;10;1
2019-06-05 05:00:00;NORTE;16;0;16;1
2019-06-05 05:30:00;NORTE;46;0;46;1
2019-06-05 06:00:00;NORTE;28;0;28;1
2019-06-05 06:30:00;NORTE;20;0;20;1
2019-06-05 07:00:00;NORTE;38;0;38;1
2019-06-05 07:30:00;NORTE;28;0;28;1
2019-06-05 08:00:00;NORTE;30;0;30;1
2019-06-05 08:30:00;NORTE;39;0;39;1
2019-06-05 09:00:00;NORTE;36;0;36;1
2019-06-05 09:30:00;NORTE;34;0;34;1
2019-06-05 10:00:00;NORTE;38;0;38;1
2019-06-05 10:30:00;NORTE;41;0;41;1
2019-06-05 11:00:00;NORTE;36;0;36;1
2019-06-05 11:30:00;NORTE;28;0;28;1
2019-06-05 12:00:00;NORTE;27;0;27;1
2019-06-05 12:30:00;NORTE;34;0;34;1
2019-06-05 13:00:00;NORTE;35;0;35;1
2019-06-05 13:30:00;NORTE;32;0;32;1
2019-06-05 14:00:00;NORTE;43;0;43;1
2019-06-05 14:30:00;NORTE;37;0;37;1
2019-06-05 15:00:00;NORTE;29;0;29;1
2019-06-05 15:30:00;NORTE;22;0;22;1
2019-06-05 16:00:00;NORTE;24;0;24;1
2019-06-05 16:30:00;NORTE;26;0;26;1
2019-06-05 17:00:00;NORTE;28;0;28;1
2019-06-05 17:30:00;NORTE;30;0;30;1
2019-06-05 18:00:00;NORTE;34;0;34;1
2019-06-05 18:30:00;NORTE;35;0;35;1
2019-06-05 19:00:00;NORTE;40;0;40;1
2019-06-05 19:30:00;NORTE;29;0;29;1
2019-06-05 20:00:00;NORTE;40;0;40;1
2019-06-05 20:30:00;NORTE;29;0;29;1
2019-06-05 21:00:00;NORTE;16;0;16;1
2019-06-05 21:30:00;NORTE;14;0;14;1
2019-06-05 22:00:00;NORTE;14;0;14;1
2019-06-05 22:30:00;NORTE;2;0;2;1
2019-06-05 23:00:00;NORTE;3;0;3;1
2019-06-05 23:30:00;NORTE;2;0;2;1
2019-06-06 00:30:00;NORTE;3;0;3;1
2019-06-06 01:00:00;NORTE;1;0;1;1
2019-06-06 02:00:00;NORTE;3;0;3;1
2019-06-06 02:30:00;NORTE;4;0;4;1
2019-06-06 03:00:00;NORTE;2;0;2;1
2019-06-06 03:30:00;NORTE;7;0;7;1
2019-06-06 04:00:00;NORTE;11;0;11;1
2019-06-06 04:30:00;NORTE;18;0;18;1
2019-06-06 05:00:00;NORTE;20;0;20;1
2019-06-06 05:30:00;NORTE;44;0;44;1
2019-06-06 06:00:00;NORTE;24;0;24;1
2019-06-06 06:30:00;NORTE;26;0;26;1
2019-06-06 07:00:00;NORTE;37;0;37;1
2019-06-06 07:30:00;NORTE;32;0;32;1
2019-06-06 08:00:00;NORTE;42;0;42;1
2019-06-06 08:30:00;CONFLICTIVA;22;7;29;2
2019-06-06 09:00:00;SUR;0;36;36;1
2019-06-06 09:30:00;SUR;0;25;25;1
2019-06-06 10:00:00;SUR;0;35;35;1
2019-06-06 10:30:00;SUR;0;31;31;1
2019-06-06 11:00:00;SUR;0;35;35;1
2019-06-06 11:30:00;SUR;0;32;32;1
2019-06-06 12:00:00;SUR;0;30;30;1
2019-06-06 12:30:00;SUR;0;36;36;1
2019-06-06 13:00:00;SUR;0;38;38;1
2019-06-06 13:30:00;SUR;0;36;36;1
2019-06-06 14:00:00;SUR;0;35;35;1
2019-06-06 14:30:00;SUR;0;31;31;1
2019-06-06 15:00:00;SUR;0;39;39;1
2019-06-06 15:30:00;SUR;0;28;28;1
2019-06-06 16:00:00;SUR;0;16;16;1
2019-06-06 16:30:00;SUR;0;31;31;1
2019-06-06 17:00:00;SUR;0;24;24;1
2019-06-06 17:30:00;SUR;0;25;25;1
2019-06-06 18:00:00;SUR;0;43;43;1
2019-06-06 18:30:00;SUR;0;38;38;1
2019-06-06 19:00:00;SUR;0;31;31;1
2019-06-06 19:30:00;SUR;0;27;27;1
2019-06-06 20:00:00;SUR;0;40;40;1
2019-06-06 20:30:00;SUR;0;28;28;1
2019-06-06 21:00:00;SUR;0;19;19;1
2019-06-06 21:30:00;SUR;0;21;21;1
2019-06-06 22:00:00;SUR;0;20;20;1
2019-06-06 22:30:00;SUR;0;8;8;1
2019-06-06 23:00:00;SUR;0;3;3;1
2019-06-06 23:30:00;SUR;0;1;1;1
2019-06-07 00:00:00;SUR;0;2;2;1
2019-06-07 00:30:00;SUR;0;1;1;1
2019-06-07 01:00:00;SUR;0;1;1;1
2019-06-07 01:30:00;SUR;0;1;1;1
2019-06-07 02:00:00;SUR;0;4;4;1
2019-06-07 02:30:00;SUR;0;3;3;1
2019-06-07 03:00:00;SUR;0;2;2;1
2019-06-07 03:22:00;SUR;0;1;1;1
2019-06-07 03:30:00;SUR;0;11;11;1
2019-06-07 04:00:00;SUR;0;10;10;1
2019-06-07 04:30:00;SUR;0;10;10;1
2019-06-07 05:00:00;SUR;0;20;20;1
2019-06-07 05:30:00;SUR;0;39;39;1
2019-06-07 06:00:00;CONFLICTIVA;17;6;23;2
2019-06-07 06:30:00;NORTE;27;0;27;1
2019-06-07 07:00:00;NORTE;35;0;35;1
2019-06-07 07:30:00;NORTE;33;0;33;1
2019-06-07 08:00:00;NORTE;33;0;33;1
2019-06-07 08:30:00;NORTE;43;0;43;1
2019-06-07 09:00:00;NORTE;38;0;38;1
2019-06-07 09:30:00;NORTE;37;0;37;1
2019-06-07 10:00:00;NORTE;34;0;34;1
2019-06-07 10:30:00;NORTE;32;0;32;1
2019-06-07 11:00:00;NORTE;32;0;32;1
2019-06-07 11:30:00;NORTE;32;0;32;1
2019-06-07 12:00:00;NORTE;28;0;28;1
2019-06-07 12:30:00;NORTE;34;0;34;1
2019-06-07 13:00:00;NORTE;28;0;28;1
2019-06-07 13:30:00;NORTE;40;0;40;1
2019-06-07 14:00:00;NORTE;43;0;43;1
2019-06-07 14:30:00;NORTE;41;0;41;1
2019-06-07 15:00:00;NORTE;35;0;35;1
2019-06-07 15:30:00;NORTE;34;0;34;1
2019-06-07 16:00:00;NORTE;21;0;21;1
2019-06-07 16:30:00;NORTE;27;0;27;1
2019-06-07 17:00:00;NORTE;30;0;30;1
2019-06-07 17:30:00;NORTE;30;0;30;1
2019-06-07 18:00:00;NORTE;36;0;36;1
2019-06-07 18:30:00;NORTE;31;1;32;1
2019-06-07 19:00:00;NORTE;32;0;32;1
2019-06-07 19:30:00;NORTE;27;0;27;1
2019-06-07 20:00:00;NORTE;36;0;36;1
2019-06-07 20:30:00;NORTE;29;0;29;1
2019-06-07 21:00:00;NORTE;21;0;21;1
2019-06-07 21:30:00;NORTE;21;0;21;1
2019-06-07 22:00:00;NORTE;16;0;16;1
2019-06-07 22:30:00;NORTE;10;0;10;1
2019-06-07 23:00:00;NORTE;2;0;2;1
2019-06-07 23:30:00;NORTE;1;0;1;1
2019-06-08 00:30:00;NORTE;2;0;2;1
2019-06-08 01:00:00;NORTE;1;0;1;1
2019-06-08 01:30:00;NORTE;1;0;1;1
2019-06-08 02:00:00;NORTE;8;0;8;1
2019-06-08 02:30:00;NORTE;4;0;4;1
2019-06-08 03:00:00;NORTE;5;0;5;1
2019-06-08 03:30:00;NORTE;3;0;3;1
2019-06-08 04:00:00;NORTE;10;0;10;1
2019-06-08 04:30:00;NORTE;13;0;13;1
2019-06-08 05:00:00;NORTE;22;0;22;1
2019-06-08 05:30:00;NORTE;41;1;42;1
2019-06-08 06:00:00;NORTE;21;0;21;1
2019-06-08 06:30:00;NORTE;24;0;24;1
2019-06-08 07:00:00;NORTE;33;0;33;1
2019-06-08 07:30:00;NORTE;32;0;32;1
2019-06-08 08:00:00;NORTE;38;0;38;1
2019-06-08 08:30:00;NORTE;26;0;26;1
2019-06-08 09:00:00;SUR;0;32;32;1
2019-06-08 09:30:00;SUR;0;34;34;1
2019-06-08 10:00:00;SUR;0;35;35;1
2019-06-08 10:30:00;SUR;0;28;28;1
2019-06-08 11:00:00;SUR;0;37;37;1
2019-06-08 11:30:00;SUR;0;29;29;1
2019-06-08 12:00:00;SUR;0;27;27;1
2019-06-08 12:30:00;SUR;0;26;26;1
2019-06-08 13:00:00;SUR;0;32;32;1
2019-06-08 13:30:00;SUR;0;37;37;1
2019-06-08 14:00:00;SUR;0;30;30;1
2019-06-08 14:30:00;SUR;0;33;33;1
2019-06-08 15:00:00;SUR;0;35;35;1
2019-06-08 15:30:00;SUR;0;19;19;1
2019-06-08 16:00:00;SUR;0;23;23;1
2019-06-08 16:30:00;SUR;0;26;26;1
2019-06-08 17:00:00;SUR;0;20;20;1
2019-06-08 17:30:00;SUR;0;15;15;1
2019-06-08 18:00:00;SUR;0;31;31;1
2019-06-08 18:30:00;SUR;0;24;24;1
2019-06-08 19:00:00;SUR;0;28;28;1
2019-06-08 19:30:00;SUR;0;29;29;1
2019-06-08 20:00:00;SUR;0;25;25;1
2019-06-08 20:30:00;SUR;0;18;18;1
2019-06-08 21:00:00;SUR;0;18;18;1
2019-06-08 21:30:00;SUR;0;14;14;1
2019-06-08 22:00:00;SUR;0;18;18;1
2019-06-08 22:30:00;SUR;0;10;10;1
2019-06-08 23:00:00;SUR;0;3;3;1
2019-06-08 23:30:00;SUR;0;2;2;1
2019-06-09 00:00:00;SUR;0;2;2;1
2019-06-09 00:30:00;SUR;0;1;1;1
2019-06-09 01:00:00;SUR;0;3;3;1
2019-06-09 01:30:00;NORTE;1;0;1;1
2019-06-09 02:00:00;NORTE;2;0;2;1
2019-06-09 02:30:00;NORTE;2;0;2;1
2019-06-09 03:00:00;NORTE;4;0;4;1
2019-06-09 03:30:00;NORTE;6;0;6;1
2019-06-09 04:00:00;NORTE;11;0;11;1
2019-06-09 04:30:00;NORTE;11;0;11;1
2019-06-09 05:00:00;NORTE;18;0;18;1
2019-06-09 05:30:00;NORTE;23;0;23;1
2019-06-09 06:00:00;NORTE;15;0;15;1
2019-06-09 06:30:00;NORTE;27;0;27;1
2019-06-09 07:00:00;NORTE;38;0;38;1
2019-06-09 07:30:00;NORTE;28;0;28;1
2019-06-09 08:00:00;NORTE;37;0;37;1
2019-06-09 08:30:00;NORTE;39;0;39;1
2019-06-09 09:00:00;NORTE;18;0;18;1
2019-06-09 09:30:00;SUR;0;32;32;1
2019-06-09 10:00:00;SUR;0;40;40;1
2019-06-09 10:30:00;SUR;0;24;24;1
2019-06-09 11:00:00;SUR;0;32;32;1
2019-06-09 11:30:00;SUR;0;23;23;1
2019-06-09 12:00:00;SUR;0;27;27;1
2019-06-09 12:30:00;SUR;0;29;29;1
2019-06-09 13:00:00;SUR;0;46;46;1
2019-06-09 13:30:00;SUR;0;31;31;1
2019-06-09 14:00:00;SUR;0;42;42;1
2019-06-09 14:30:00;SUR;0;32;32;1
2019-06-09 15:00:00;SUR;0;28;28;1
2019-06-09 15:30:00;SUR;0;27;27;1
2019-06-09 16:00:00;SUR;0;16;16;1
2019-06-09 16:30:00;SUR;0;27;27;1
2019-06-09 17:00:00;SUR;0;21;21;1
2019-06-09 17:30:00;SUR;0;32;32;1
2019-06-09 18:00:00;SUR;0;34;34;1
2019-06-09 18:30:00;SUR;0;27;27;1
2019-06-09 19:00:00;SUR;0;34;34;1
2019-06-09 19:30:00;SUR;0;27;27;1
2019-06-09 20:00:00;CONFLICTIVA;21;5;26;2
2019-06-09 20:30:00;NORTE;34;0;34;1
2019-06-09 21:00:00;NORTE;21;0;21;1
2019-06-09 21:30:00;NORTE;23;0;23;1
2019-06-09 22:00:00;NORTE;19;0;19;1
2019-06-09 22:30:00;NORTE;15;0;15;1
2019-06-09 23:30:00;NORTE;1;0;1;1
2019-06-10 00:00:00;NORTE;2;0;2;1
2019-06-10 01:00:00;NORTE;3;0;3;1
2019-06-10 01:30:00;NORTE;1;0;1;1
2019-06-10 02:00:00;NORTE;4;0;4;1
2019-06-10 02:30:00;NORTE;7;0;7;1
2019-06-10 03:00:00;NORTE;4;0;4;1
2019-06-10 03:30:00;NORTE;3;0;3;1
2019-06-10 04:00:00;NORTE;10;0;10;1
2019-06-10 04:30:00;NORTE;12;0;12;1
2019-06-10 05:00:00;NORTE;26;0;26;1
2019-06-10 05:30:00;NORTE;43;0;43;1
2019-06-10 06:00:00;NORTE;29;0;29;1
2019-06-10 06:30:00;NORTE;29;0;29;1
2019-06-10 07:00:00;NORTE;34;0;34;1
2019-06-10 07:30:00;NORTE;36;0;36;1
2019-06-10 08:00:00;NORTE;38;0;38;1
2019-06-10 08:30:00;NORTE;35;0;35;1
2019-06-10 09:00:00;NORTE;33;0;33;1
2019-06-10 09:30:00;NORTE;36;0;36;1
2019-06-10 10:00:00;NORTE;35;0;35;1
2019-06-10 10:30:00;NORTE;35;0;35;1
2019-06-10 11:00:00;NORTE;31;0;31;1
2019-06-10 11:30:00;NORTE;38;0;38;1
2019-06-10 12:00:00;NORTE;29;0;29;1
2019-06-10 12:30:00;NORTE;35;0;35;1
2019-06-10 13:00:00;NORTE;42;0;42;1
2019-06-10 13:30:00;NORTE;42;0;42;1
2019-06-10 14:00:00;NORTE;35;0;35;1
2019-06-10 14:30:00;NORTE;29;0;29;1
2019-06-10 15:00:00;NORTE;31;0;31;1
2019-06-10 15:30:00;NORTE;21;0;21;1
2019-06-10 16:00:00;NORTE;24;0;24;1
2019-06-10 16:30:00;NORTE;39;0;39;1
2019-06-10 17:00:00;NORTE;29;0;29;1
2019-06-10 17:30:00;NORTE;23;0;23;1
2019-06-10 18:00:00;NORTE;40;0;40;1
2019-06-10 18:30:00;NORTE;35;0;35;1
2019-06-10 19:00:00;NORTE;34;0;34;1
2019-06-10 19:30:00;NORTE;33;0;33;1
2019-06-10 20:00:00;NORTE;31;0;31;1
2019-06-10 20:30:00;NORTE;32;0;32;1
2019-06-10 21:00:00;NORTE;15;0;15;1
2019-06-10 21:30:00;NORTE;18;0;18;1
2019-06-10 22:00:00;NORTE;11;0;11;1
2019-06-10 22:31:04;NORTE;1;0;1;1
2019-06-10 22:33:32;NORTE;1;0;1;1
2019-06-10 22:36:08;NORTE;1;0;1;1
2019-06-10 22:39:15;NORTE;1;0;1;1
2019-06-10 22:41:12;NORTE;1;0;1;1
2019-06-10 22:43:57;NORTE;1;0;1;1
2019-06-10 22:43:59;NORTE;1;0;1;1
2019-06-10 22:47:04;NORTE;1;0;1;1
2019-06-10 22:51:22;NORTE;1;0;1;1
2019-06-10 22:59:27;NORTE;1;0;1;1
2019-06-10 23:00:00;NORTE;6;0;6;1
2019-06-10 23:30:00;NORTE;2;0;2;1
2019-06-11 00:00:00;NORTE;1;0;1;1
2019-06-11 00:30:00;NORTE;2;0;2;1
2019-06-11 01:00:00;NORTE;1;0;1;1
2019-06-11 01:30:00;NORTE;1;0;1;1
2019-06-11 02:00:00;NORTE;4;0;4;1
2019-06-11 02:30:00;NORTE;6;0;6;1
2019-06-11 03:00:00;NORTE;3;0;3;1
2019-06-11 03:30:00;NORTE;4;0;4;1
2019-06-11 04:00:00;NORTE;14;0;14;1
2019-06-11 04:30:00;NORTE;15;0;15;1
2019-06-11 05:00:00;NORTE;25;0;25;1
2019-06-11 05:30:00;NORTE;51;0;51;1
2019-06-11 06:00:00;NORTE;18;0;18;1
2019-06-11 06:30:00;NORTE;29;0;29;1
2019-06-11 07:00:00;NORTE;36;0;36;1
2019-06-11 07:30:00;NORTE;32;0;32;1
2019-06-11 08:00:00;NORTE;40;0;40;1
2019-06-11 08:30:00;NORTE;38;0;38;1
2019-06-11 09:00:00;NORTE;30;0;30;1
2019-06-11 09:30:00;NORTE;40;0;40;1
2019-06-11 10:00:00;NORTE;37;0;37;1
2019-06-11 10:30:00;NORTE;33;0;33;1
2019-06-11 11:00:00;NORTE;29;0;29;1
2019-06-11 11:30:00;NORTE;32;0;32;1
2019-06-11 12:00:00;NORTE;26;0;26;1
2019-06-11 12:30:00;NORTE;31;0;31;1
2019-06-11 13:00:00;NORTE;37;0;37;1
2019-06-11 13:30:00;NORTE;38;0;38;1
2019-06-11 14:00:00;NORTE;29;0;29;1
2019-06-11 14:30:00;NORTE;37;0;37;1
2019-06-11 15:00:00;NORTE;32;0;32;1
2019-06-11 15:30:00;NORTE;26;0;26;1
2019-06-11 16:00:00;NORTE;23;0;23;1
2019-06-11 16:30:00;NORTE;28;0;28;1
2019-06-11 17:00:00;NORTE;32;0;32;1
2019-06-11 17:30:00;NORTE;31;0;31;1
2019-06-11 18:00:00;NORTE;42;0;42;1
2019-06-11 18:30:00;NORTE;39;0;39;1
2019-06-11 19:00:00;NORTE;28;0;28;1
2019-06-11 19:30:00;NORTE;34;0;34;1
2019-06-11 20:00:00;NORTE;33;0;33;1
2019-06-11 20:30:00;NORTE;29;0;29;1
2019-06-11 21:00:00;NORTE;22;0;22;1
2019-06-11 21:30:00;NORTE;16;1;17;1
2019-06-11 22:00:00;NORTE;15;0;15;1
2019-06-11 22:30:00;NORTE;6;0;6;1
2019-06-11 23:00:00;NORTE;4;0;4;1
2019-06-11 23:30:00;NORTE;1;0;1;1
2019-06-12 00:30:00;NORTE;2;0;2;1
2019-06-12 01:30:00;NORTE;2;0;2;1
2019-06-12 02:00:00;NORTE;3;0;3;1
2019-06-12 02:30:00;NORTE;5;0;5;1
2019-06-12 03:00:00;NORTE;3;0;3;1
2019-06-12 03:30:00;NORTE;10;0;10;1
2019-06-12 04:00:00;NORTE;13;0;13;1
2019-06-12 04:30:00;NORTE;14;0;14;1
2019-06-12 05:00:00;NORTE;25;0;25;1
2019-06-12 05:30:00;NORTE;37;0;37;1
2019-06-12 06:00:00;NORTE;26;0;26;1
2019-06-12 06:30:00;NORTE;27;0;27;1
2019-06-12 07:00:00;NORTE;39;0;39;1
2019-06-12 07:30:00;NORTE;29;0;29;1
2019-06-12 08:00:00;NORTE;37;0;37;1
2019-06-12 08:30:00;NORTE;39;0;39;1
2019-06-12 09:00:00;NORTE;30;0;30;1
2019-06-12 09:30:00;NORTE;41;0;41;1
2019-06-12 10:00:00;NORTE;35;0;35;1
2019-06-12 10:30:00;NORTE;35;0;35;1
2019-06-12 11:00:00;CONFLICTIVA;17;11;28;2
2019-06-12 11:30:00;SUR;0;41;41;1
2019-06-12 12:00:00;SUR;0;27;27;1
2019-06-12 12:30:00;SUR;0;31;31;1
2019-06-12 13:00:00;SUR;0;38;38;1
2019-06-12 13:30:00;SUR;0;38;38;1
2019-06-12 14:00:00;SUR;0;37;37;1
2019-06-12 14:30:00;SUR;0;37;37;1
2019-06-12 15:00:00;SUR;0;31;31;1
2019-06-12 15:30:00;SUR;0;27;27;1
2019-06-12 16:00:00;SUR;0;26;26;1
2019-06-12 16:30:00;SUR;0;31;31;1
2019-06-12 17:00:00;SUR;0;21;21;1
2019-06-12 17:30:00;SUR;0;36;36;1
2019-06-12 18:00:00;SUR;0;47;47;1
2019-06-12 18:30:00;SUR;0;30;30;1
2019-06-12 19:00:00;SUR;0;38;38;1
2019-06-12 19:30:00;SUR;0;33;33;1
2019-06-12 20:00:00;SUR;0;40;40;1
2019-06-12 20:30:00;SUR;0;32;32;1
2019-06-12 21:00:00;SUR;0;20;20;1
2019-06-12 21:30:00;SUR;0;20;20;1
2019-06-12 22:00:00;NORTE;11;0;11;1
2019-06-12 22:30:00;NORTE;11;0;11;1
2019-06-12 23:00:00;NORTE;2;0;2;1
2019-06-12 23:30:00;NORTE;1;0;1;1
2019-06-13 00:00:00;NORTE;1;0;1;1
2019-06-13 00:30:00;NORTE;2;0;2;1
2019-06-13 01:00:00;NORTE;1;0;1;1
2019-06-13 01:30:00;NORTE;1;0;1;1
2019-06-13 02:00:00;NORTE;3;0;3;1
2019-06-13 02:30:00;NORTE;3;0;3;1
2019-06-13 03:00:00;NORTE;1;0;1;1
2019-06-13 03:30:00;NORTE;5;0;5;1
2019-06-13 04:00:00;NORTE;13;0;13;1
2019-06-13 04:30:00;NORTE;17;0;17;1
2019-06-13 05:00:00;NORTE;25;0;25;1
2019-06-13 05:30:00;NORTE;43;0;43;1
2019-06-13 06:00:00;NORTE;26;0;26;1
2019-06-13 06:30:00;NORTE;26;0;26;1
2019-06-13 07:00:00;NORTE;35;1;36;1
2019-06-13 07:30:00;NORTE;32;0;32;1
2019-06-13 08:00:00;NORTE;34;0;34;1
2019-06-13 08:30:00;NORTE;39;0;39;1
2019-06-13 09:00:00;NORTE;32;0;32;1
2019-06-13 09:30:00;CONFLICTIVA;10;16;26;2
2019-06-13 10:00:00;SUR;0;34;34;1
2019-06-13 10:30:00;SUR;0;40;40;1
2019-06-13 11:00:00;SUR;0;36;36;1
2019-06-13 11:30:00;SUR;0;31;31;1
2019-06-13 12:00:00;SUR;0;30;30;1
2019-06-13 12:30:00;SUR;0;32;32;1
2019-06-13 13:00:00;SUR;0;38;38;1
2019-06-13 13:30:00;SUR;0;38;38;1
2019-06-13 14:00:00;SUR;0;36;36;1
2019-06-13 14:30:00;SUR;0;41;41;1
2019-06-13 15:00:00;SUR;0;29;29;1
2019-06-13 15:30:00;SUR;0;18;18;1
2019-06-13 16:00:00;SUR;0;23;23;1
2019-06-13 16:30:00;SUR;0;28;28;1
2019-06-13 17:00:00;SUR;0;28;28;1
2019-06-13 17:30:00;SUR;0;27;27;1
2019-06-13 18:00:00;SUR;0;35;35;1
2019-06-13 18:30:00;SUR;0;35;35;1
2019-06-13 19:00:00;SUR;0;37;37;1
2019-06-13 19:30:00;CONFLICTIVA;15;14;29;2
2019-06-13 20:00:00;NORTE;39;0;39;1
2019-06-13 20:30:00;NORTE;33;0;33;1
2019-06-13 21:00:00;NORTE;22;0;22;1
2019-06-13 21:30:00;NORTE;17;0;17;1
2019-06-13 22:00:00;NORTE;15;0;15;1
2019-06-13 22:30:00;NORTE;10;0;10;1
2019-06-13 23:00:00;NORTE;4;0;4;1
2019-06-13 23:30:00;NORTE;1;0;1;1
2019-06-14 00:00:00;NORTE;3;0;3;1
2019-06-14 01:00:00;NORTE;1;0;1;1
2019-06-14 01:30:00;NORTE;2;0;2;1
2019-06-14 02:00:00;NORTE;6;0;6;1
2019-06-14 02:30:00;NORTE;7;0;7;1
2019-06-14 03:00:00;NORTE;5;0;5;1
2019-06-14 03:30:00;NORTE;7;0;7;1
2019-06-14 04:00:00;NORTE;16;0;16;1
2019-06-14 04:30:00;NORTE;11;0;11;1
2019-06-14 05:00:00;NORTE;20;0;20;1
2019-06-14 05:30:00;NORTE;43;0;43;1
2019-06-14 06:00:00;NORTE;25;0;25;1
2019-06-14 06:30:00;NORTE;24;0;24;1
2019-06-14 07:00:00;NORTE;37;0;37;1
2019-06-14 07:30:00;NORTE;33;0;33;1
2019-06-14 08:00:00;CONFLICTIVA;6;22;28;2
2019-06-14 08:30:00;SUR;0;47;47;1
2019-06-14 09:00:00;SUR;0;38;38;1
2019-06-14 09:30:00;SUR;0;30;30;1
2019-06-14 10:00:00;SUR;0;34;34;1
2019-06-14 10:30:00;SUR;0;36;36;1
2019-06-14 11:00:00;SUR;0;36;36;1
2019-06-14 11:30:00;SUR;0;32;32;1
2019-06-14 12:00:00;SUR;0;27;27;1
2019-06-14 12:30:00;SUR;0;23;23;1
2019-06-14 13:00:00;SUR;0;40;40;1
2019-06-14 13:30:00;SUR;0;36;36;1
2019-06-14 14:00:00;SUR;0;40;40;1
2019-06-14 14:30:00;SUR;0;37;37;1
2019-06-14 15:00:00;SUR;0;36;36;1
2019-06-14 15:30:00;SUR;0;31;31;1
2019-06-14 16:00:00;SUR;0;27;27;1
2019-06-14 16:30:00;SUR;0;30;30;1
2019-06-14 17:00:00;SUR;0;27;27;1
2019-06-14 17:30:00;SUR;0;22;22;1
2019-06-14 18:00:00;SUR;0;41;41;1
2019-06-14 18:30:00;SUR;0;34;34;1
2019-06-14 19:00:00;SUR;0;34;34;1
2019-06-14 19:30:00;SUR;0;30;30;1
2019-06-14 20:00:00;SUR;0;30;30;1
2019-06-14 20:30:00;SUR;0;32;32;1
2019-06-14 21:00:00;SUR;0;25;25;1
2019-06-14 21:30:00;SUR;0;16;16;1
2019-06-14 22:00:00;SUR;0;17;17;1
2019-06-14 22:30:00;SUR;0;4;4;1
2019-06-14 23:00:00;NORTE;3;0;3;1
2019-06-14 23:30:00;NORTE;1;0;1;1
2019-06-15 00:30:00;NORTE;1;0;1;1
2019-06-15 01:00:00;NORTE;1;0;1;1
2019-06-15 01:30:00;NORTE;1;0;1;1
2019-06-15 02:00:00;NORTE;5;0;5;1
2019-06-15 02:30:00;NORTE;6;0;6;1
2019-06-15 03:00:00;NORTE;1;0;1;1
2019-06-15 03:30:00;NORTE;6;0;6;1
2019-06-15 04:00:00;NORTE;14;0;14;1
2019-06-15 04:30:00;NORTE;10;0;10;1
2019-06-15 05:00:00;NORTE;23;0;23;1
2019-06-15 05:30:00;NORTE;38;0;38;1
2019-06-15 06:00:00;NORTE;24;0;24;1
2019-06-15 06:30:00;NORTE;26;0;26;1
2019-06-15 07:00:00;NORTE;42;0;42;1
2019-06-15 07:30:00;NORTE;32;0;32;1
2019-06-15 08:00:00;NORTE;34;0;34;1
2019-06-15 08:30:00;NORTE;38;0;38;1
2019-06-15 09:00:00;NORTE;29;0;29;1
2019-06-15 09:30:00;NORTE;35;0;35;1
2019-06-15 10:00:00;NORTE;35;0;35;1
2019-06-15 10:30:00;NORTE;34;0;34;1
2019-06-15 11:00:00;NORTE;34;0;34;1
2019-06-15 11:30:00;NORTE;28;0;28;1
2019-06-15 12:00:00;NORTE;29;0;29;1
2019-06-15 12:30:00;NORTE;31;0;31;1
2019-06-15 13:00:00;NORTE;34;0;34;1
2019-06-15 13:30:00;NORTE;38;0;38;1
2019-06-15 14:00:00;NORTE;35;0;35;1
2019-06-15 14:30:00;NORTE;34;0;34;1
2019-06-15 15:00:00;NORTE;30;0;30;1
2019-06-15 15:30:00;NORTE;26;0;26;1
2019-06-15 16:00:00;NORTE;20;0;20;1
2019-06-15 16:30:00;NORTE;31;0;31;1
2019-06-15 17:00:00;NORTE;15;0;15;1
2019-06-15 17:30:00;NORTE;22;0;22;1
2019-06-15 18:00:00;NORTE;29;0;29;1
2019-06-15 18:30:00;NORTE;25;0;25;1
2019-06-15 19:00:00;NORTE;24;0;24;1
2019-06-15 19:30:00;NORTE;32;0;32;1
2019-06-15 20:00:00;NORTE;26;0;26;1
2019-06-15 20:30:00;NORTE;21;0;21;1
2019-06-15 21:00:00;NORTE;12;0;12;1
2019-06-15 21:30:00;NORTE;16;0;16;1
2019-06-15 22:00:00;NORTE;19;0;19;1
2019-06-15 22:30:00;NORTE;10;0;10;1
2019-06-15 23:00:00;NORTE;2;0;2;1
2019-06-16 00:00:00;NORTE;2;0;2;1
2019-06-16 00:30:00;NORTE;3;0;3;1
2019-06-16 01:00:00;NORTE;2;0;2;1
2019-06-16 01:30:00;NORTE;2;0;2;1
2019-06-16 02:00:00;NORTE;2;0;2;1
2019-06-16 02:30:00;NORTE;3;0;3;1
2019-06-16 03:00:00;NORTE;5;0;5;1
2019-06-16 03:30:00;NORTE;4;0;4;1
2019-06-16 04:00:00;NORTE;12;0;12;1
2019-06-16 04:30:00;NORTE;12;0;12;1
2019-06-16 05:00:00;NORTE;19;0;19;1
2019-06-16 05:30:00;NORTE;30;0;30;1
2019-06-16 06:00:00;NORTE;19;0;19;1
2019-06-16 06:30:00;NORTE;25;0;25;1
2019-06-16 07:00:00;NORTE;39;0;39;1
2019-06-16 07:30:00;NORTE;28;0;28;1
2019-06-16 08:00:00;NORTE;37;0;37;1
2019-06-16 08:30:00;NORTE;45;0;45;1
2019-06-16 09:00:00;NORTE;23;0;23;1
2019-06-16 09:30:00;NORTE;36;0;36;1
2019-06-16 10:00:00;NORTE;33;0;33;1
2019-06-16 10:30:00;NORTE;29;0;29;1
2019-06-16 11:00:00;NORTE;36;0;36;1
2019-06-16 11:30:00;NORTE;31;0;31;1
2019-06-16 12:00:00;NORTE;25;0;25;1
2019-06-16 12:30:00;NORTE;34;0;34;1
2019-06-16 13:00:00;NORTE;42;0;42;1
2019-06-16 13:30:00;NORTE;38;0;38;1
2019-06-16 14:00:00;NORTE;42;0;42;1
2019-06-16 14:30:00;NORTE;28;0;28;1
2019-06-16 15:00:00;NORTE;31;0;31;1
2019-06-16 15:30:00;NORTE;29;0;29;1
2019-06-16 16:00:00;NORTE;25;0;25;1
2019-06-16 16:30:00;NORTE;27;0;27;1
2019-06-16 17:00:00;NORTE;28;0;28;1
2019-06-16 17:30:00;NORTE;30;0;30;1
2019-06-16 18:00:00;NORTE;40;0;40;1
2019-06-16 18:30:00;NORTE;30;0;30;1
2019-06-16 19:00:00;NORTE;32;0;32;1
2019-06-16 19:30:00;NORTE;32;0;32;1
2019-06-16 20:00:00;NORTE;31;0;31;1
2019-06-16 20:30:00;NORTE;36;0;36;1
2019-06-16 21:00:00;NORTE;17;0;17;1
2019-06-16 21:30:00;NORTE;20;0;20;1
2019-06-16 22:00:00;NORTE;18;0;18;1
2019-06-16 22:30:00;NORTE;14;0;14;1
2019-06-16 23:30:00;NORTE;1;0;1;1
2019-06-17 00:00:00;NORTE;3;0;3;1
2019-06-17 00:30:00;NORTE;1;0;1;1
2019-06-17 01:00:00;NORTE;2;0;2;1
2019-06-17 01:30:00;NORTE;1;0;1;1
2019-06-17 02:00:00;NORTE;3;0;3;1
2019-06-17 02:30:00;NORTE;7;0;7;1
2019-06-17 03:00:00;NORTE;2;0;2;1
2019-06-17 03:30:00;NORTE;5;0;5;1
2019-06-17 04:00:00;NORTE;13;0;13;1
2019-06-17 04:30:00;NORTE;11;0;11;1
2019-06-17 05:00:00;NORTE;28;0;28;1
2019-06-17 05:30:00;NORTE;40;0;40;1
2019-06-17 06:00:00;NORTE;27;0;27;1
2019-06-17 06:30:00;NORTE;33;0;33;1
2019-06-17 07:00:00;NORTE;37;0;37;1
2019-06-17 07:30:00;NORTE;33;0;33;1
2019-06-17 08:00:00;NORTE;38;0;38;1
2019-06-17 08:30:00;NORTE;37;0;37;1
2019-06-17 09:00:00;NORTE;26;0;26;1
2019-06-17 09:30:00;NORTE;35;0;35;1
2019-06-17 10:00:00;NORTE;38;0;38;1
2019-06-17 10:30:00;NORTE;28;0;28;1
2019-06-17 11:00:00;NORTE;43;0;43;1
2019-06-17 11:30:00;NORTE;29;0;29;1
2019-06-17 12:00:00;NORTE;23;0;23;1
2019-06-17 12:30:00;NORTE;37;0;37;1
2019-06-17 13:00:00;CONFLICTIVA;9;19;28;2
2019-06-17 13:30:00;SUR;0;47;47;1
2019-06-17 14:00:00;SUR;0;42;42;1
2019-06-17 14:30:00;SUR;0;30;30;1
2019-06-17 15:00:00;SUR;0;27;27;1
2019-06-17 15:30:00;SUR;0;32;32;1
2019-06-17 16:00:00;SUR;0;24;24;1
2019-06-17 16:30:00;SUR;0;38;38;1
2019-06-17 17:00:00;SUR;0;25;25;1
2019-06-17 17:30:00;SUR;0;33;33;1
2019-06-17 18:00:00;SUR;0;44;44;1
2019-06-17 18:30:00;SUR;0;35;35;1
2019-06-17 19:00:00;SUR;0;30;30;1
2019-06-17 19:30:00;SUR;0;33;33;1
2019-06-17 20:00:00;SUR;0;28;28;1
2019-06-17 20:30:00;CONFLICTIVA;7;12;19;2
2019-06-17 21:00:00;NORTE;16;0;16;1
2019-06-17 21:30:00;NORTE;14;0;14;1
2019-06-17 22:00:00;NORTE;18;0;18;1
2019-06-17 22:30:00;NORTE;13;0;13;1
2019-06-17 23:00:00;NORTE;2;0;2;1
2019-06-17 23:30:00;CONFLICTIVA;2;1;3;2
2019-06-18 00:00:00;NORTE;3;0;3;1
2019-06-18 00:30:00;NORTE;1;0;1;1
2019-06-18 01:00:00;NORTE;1;0;1;1
2019-06-18 01:30:00;NORTE;2;0;2;1
2019-06-18 02:00:00;NORTE;6;0;6;1
2019-06-18 02:30:00;NORTE;4;0;4;1
2019-06-18 03:00:00;NORTE;1;0;1;1
2019-06-18 03:30:00;NORTE;9;0;9;1
2019-06-18 04:00:00;NORTE;15;0;15;1
2019-06-18 04:30:00;NORTE;10;0;10;1
2019-06-18 05:00:00;NORTE;28;0;28;1
2019-06-18 05:30:00;NORTE;41;0;41;1
2019-06-18 06:00:00;NORTE;24;1;25;1
2019-06-18 06:30:00;CONFLICTIVA;8;16;24;2
2019-06-18 07:00:00;SUR;0;39;39;1
2019-06-18 07:30:00;SUR;0;32;32;1
2019-06-18 08:00:00;SUR;0;36;36;1
2019-06-18 08:30:00;SUR;0;44;44;1
2019-06-18 09:00:00;SUR;0;30;30;1
2019-06-18 09:30:00;SUR;0;33;33;1
2019-06-18 10:00:00;SUR;0;35;35;1
2019-06-18 10:30:00;SUR;0;38;38;1
2019-06-18 11:00:00;SUR;0;27;27;1
2019-06-18 11:30:00;SUR;0;33;33;1
2019-06-18 12:00:00;SUR;0;24;24;1
2019-06-18 12:30:00;SUR;0;31;31;1
2019-06-18 13:00:00;SUR;0;40;40;1
2019-06-18 13:30:00;SUR;0;31;31;1
2019-06-18 14:00:00;SUR;0;42;42;1
2019-06-18 14:30:00;SUR;0;42;42;1
2019-06-18 15:00:00;SUR;0;30;30;1
2019-06-18 15:30:00;SUR;0;33;33;1
2019-06-18 16:00:00;SUR;0;23;23;1
2019-06-18 16:30:00;SUR;0;33;33;1
2019-06-18 17:00:00;SUR;0;31;31;1
2019-06-18 17:30:00;SUR;0;32;32;1
2019-06-18 18:00:00;SUR;0;42;42;1
2019-06-18 18:30:00;SUR;0;31;31;1
2019-06-18 19:00:00;SUR;0;28;28;1
2019-06-18 19:30:00;NORTE;34;0;34;1
2019-06-18 20:00:00;NORTE;36;0;36;1
2019-06-18 20:30:00;NORTE;30;0;30;1
2019-06-18 21:00:00;NORTE;21;0;21;1
2019-06-18 21:30:00;NORTE;17;0;17;1
2019-06-18 22:00:00;NORTE;17;0;17;1
2019-06-18 22:30:00;NORTE;6;0;6;1
2019-06-18 23:00:00;NORTE;4;0;4;1
2019-06-18 23:30:00;NORTE;2;0;2;1
2019-06-19 00:00:00;NORTE;1;0;1;1
2019-06-19 00:30:00;NORTE;2;0;2;1
2019-06-19 01:00:00;NORTE;2;0;2;1
2019-06-19 02:00:00;NORTE;7;0;7;1
2019-06-19 02:30:00;NORTE;2;0;2;1
2019-06-19 03:00:00;NORTE;3;0;3;1
2019-06-19 03:30:00;NORTE;8;0;8;1
2019-06-19 04:00:00;NORTE;17;0;17;1
2019-06-19 04:30:00;NORTE;10;0;10;1
2019-06-19 05:00:00;CONFLICTIVA;12;6;18;2
2019-06-19 05:30:00;SUR;0;43;43;1
2019-06-19 06:00:00;SUR;0;29;29;1
2019-06-19 06:30:00;SUR;0;23;23;1
2019-06-19 07:00:00;SUR;0;42;42;1
2019-06-19 07:30:00;SUR;0;34;34;1
2019-06-19 08:00:00;SUR;0;34;34;1
2019-06-19 08:30:00;SUR;0;39;39;1
2019-06-19 09:00:00;SUR;0;39;39;1
2019-06-19 09:30:00;SUR;0;30;30;1
2019-06-19 10:00:00;SUR;0;39;39;1
2019-06-19 10:30:00;SUR;0;40;40;1
2019-06-19 11:00:00;SUR;0;35;35;1
2019-06-19 11:30:00;SUR;0;35;35;1
2019-06-19 12:00:00;SUR;0;26;26;1
2019-06-19 12:30:00;SUR;0;31;31;1
2019-06-19 13:00:00;SUR;0;34;34;1
2019-06-19 13:30:00;SUR;0;39;39;1
2019-06-19 14:00:00;SUR;0;39;39;1
2019-06-19 14:30:00;SUR;0;30;30;1
2019-06-19 15:00:00;SUR;0;33;33;1
2019-06-19 15:30:00;SUR;0;28;28;1
2019-06-19 16:00:00;SUR;0;22;22;1
2019-06-19 16:30:00;SUR;0;32;32;1
2019-06-19 17:00:00;SUR;0;28;28;1
2019-06-19 17:30:00;SUR;0;29;29;1
2019-06-19 18:00:00;SUR;0;44;44;1
2019-06-19 18:30:00;SUR;0;31;31;1
2019-06-19 19:00:00;SUR;0;36;36;1
2019-06-19 19:30:00;SUR;0;31;31;1
2019-06-19 20:00:00;SUR;0;34;34;1
2019-06-19 20:30:00;SUR;0;29;29;1
2019-06-19 21:00:00;SUR;0;25;25;1
2019-06-19 21:30:00;SUR;0;20;20;1
2019-06-19 22:00:00;SUR;0;13;13;1
2019-06-19 22:30:00;SUR;0;14;14;1
2019-06-19 23:00:00;CONFLICTIVA;2;3;5;2
2019-06-19 23:30:00;NORTE;2;0;2;1
2019-06-20 00:00:00;NORTE;2;0;2;1
2019-06-20 00:30:00;NORTE;1;0;1;1
2019-06-20 01:00:00;NORTE;1;0;1;1
2019-06-20 02:00:00;NORTE;4;0;4;1
2019-06-20 02:30:00;NORTE;5;0;5;1
2019-06-20 03:00:00;NORTE;1;0;1;1
2019-06-20 03:30:00;NORTE;10;0;10;1
2019-06-20 04:00:00;NORTE;13;0;13;1
2019-06-20 04:30:00;NORTE;15;0;15;1
2019-06-20 05:00:00;NORTE;24;0;24;1
2019-06-20 05:30:00;NORTE;46;0;46;1
2019-06-20 06:00:00;NORTE;23;0;23;1
2019-06-20 06:30:00;NORTE;29;0;29;1
2019-06-20 07:00:00;NORTE;37;0;37;1
2019-06-20 07:30:00;NORTE;36;0;36;1
2019-06-20 08:00:00;NORTE;41;0;41;1
2019-06-20 08:30:00;NORTE;46;0;46;1
2019-06-20 09:00:00;SUR;0;22;22;1
2019-06-20 09:30:00;SUR;0;37;37;1
2019-06-20 10:00:00;SUR;0;36;36;1
2019-06-20 10:30:00;SUR;0;36;36;1
2019-06-20 11:00:00;SUR;0;31;31;1
2019-06-20 11:30:00;SUR;0;27;27;1
2019-06-20 12:00:00;SUR;0;31;31;1
2019-06-20 12:30:00;SUR;0;35;35;1
2019-06-20 13:00:00;SUR;0;35;35;1
2019-06-20 13:30:00;SUR;0;32;32;1
2019-06-20 14:00:00;SUR;0;33;33;1
2019-06-20 14:30:00;SUR;0;47;47;1
2019-06-20 15:00:00;SUR;0;36;36;1
2019-06-20 15:30:00;SUR;0;35;35;1
2019-06-20 16:00:00;SUR;0;24;24;1
2019-06-20 16:30:00;SUR;0;30;30;1
2019-06-20 17:00:00;SUR;0;22;22;1
2019-06-20 17:30:00;SUR;0;31;31;1
2019-06-20 18:00:00;SUR;0;43;43;1
2019-06-20 18:30:00;SUR;0;29;29;1
2019-06-20 19:00:00;SUR;0;40;40;1
2019-06-20 19:30:00;SUR;0;24;24;1
2019-06-20 20:00:00;SUR;0;30;30;1
2019-06-20 20:30:00;SUR;0;30;30;1
2019-06-20 21:00:00;SUR;0;23;23;1
2019-06-20 21:30:00;CONFLICTIVA;5;12;17;2
2019-06-20 22:00:00;NORTE;27;0;27;1
2019-06-20 22:30:00;NORTE;18;0;18;1
2019-06-20 23:00:00;NORTE;8;0;8;1
2019-06-20 23:30:00;NORTE;5;0;5;1
2019-06-21 00:00:00;NORTE;2;0;2;1
2019-06-21 00:30:00;NORTE;3;0;3;1
2019-06-21 01:30:00;NORTE;1;0;1;1
2019-06-21 02:00:00;NORTE;5;0;5;1
2019-06-21 02:30:00;NORTE;2;0;2;1
2019-06-21 03:00:00;NORTE;7;0;7;1
2019-06-21 03:30:00;NORTE;11;0;11;1
2019-06-21 04:00:00;NORTE;12;0;12;1
2019-06-21 04:30:00;NORTE;11;0;11;1
2019-06-21 05:00:00;NORTE;24;0;24;1
2019-06-21 05:30:00;NORTE;36;0;36;1
2019-06-21 06:00:00;NORTE;30;0;30;1
2019-06-21 06:30:00;NORTE;25;0;25;1
2019-06-21 07:00:00;NORTE;39;0;39;1
2019-06-21 07:30:00;NORTE;36;0;36;1
2019-06-21 08:00:00;NORTE;34;0;34;1
2019-06-21 08:30:00;NORTE;46;0;46;1
2019-06-21 09:00:00;NORTE;33;0;33;1
2019-06-21 09:30:00;NORTE;33;0;33;1
2019-06-21 10:00:00;NORTE;33;0;33;1
2019-06-21 10:30:00;NORTE;39;0;39;1
2019-06-21 11:00:00;NORTE;31;0;31;1
2019-06-21 11:30:00;NORTE;36;0;36;1
2019-06-21 12:00:00;NORTE;27;0;27;1
2019-06-21 12:30:00;NORTE;36;0;36;1
2019-06-21 13:00:00;NORTE;42;0;42;1
2019-06-21 13:30:00;NORTE;46;0;46;1
2019-06-21 14:00:00;NORTE;38;0;38;1
2019-06-21 14:30:00;NORTE;36;0;36;1
2019-06-21 15:00:00;CONFLICTIVA;3;20;23;2
2019-06-21 15:30:00;SUR;0;31;31;1
2019-06-21 16:00:00;NORTE;19;0;19;1
2019-06-21 16:30:00;NORTE;38;0;38;1
2019-06-21 17:00:00;NORTE;29;0;29;1
2019-06-21 17:30:00;NORTE;33;0;33;1
2019-06-21 18:00:00;NORTE;41;0;41;1
2019-06-21 18:30:00;NORTE;29;0;29;1
2019-06-21 19:00:00;NORTE;32;0;32;1
2019-06-21 19:30:00;NORTE;37;0;37;1
2019-06-21 20:00:00;NORTE;25;0;25;1
2019-06-21 20:30:00;NORTE;38;0;38;1
2019-06-21 21:00:00;NORTE;22;0;22;1
2019-06-21 21:30:00;NORTE;16;0;16;1
2019-06-21 22:00:00;NORTE;18;0;18;1
2019-06-21 22:30:00;NORTE;8;0;8;1
2019-06-21 23:00:00;NORTE;4;0;4;1
2019-06-21 23:30:00;NORTE;2;0;2;1
2019-06-22 00:30:00;NORTE;4;0;4;1
2019-06-22 01:30:00;NORTE;1;0;1;1
2019-06-22 02:00:00;NORTE;5;0;5;1
2019-06-22 02:30:00;NORTE;7;0;7;1
2019-06-22 03:00:00;NORTE;3;0;3;1
2019-06-22 03:30:00;NORTE;7;0;7;1
2019-06-22 04:00:00;NORTE;13;0;13;1
2019-06-22 04:30:00;NORTE;15;0;15;1
2019-06-22 05:00:00;NORTE;24;0;24;1
2019-06-22 05:30:00;NORTE;35;0;35;1
2019-06-22 06:00:00;NORTE;22;0;22;1
2019-06-22 06:30:00;NORTE;25;0;25;1
2019-06-22 07:00:00;NORTE;43;0;43;1
2019-06-22 07:30:00;NORTE;31;0;31;1
2019-06-22 08:00:00;NORTE;40;0;40;1
2019-06-22 08:30:00;CONFLICTIVA;26;5;31;2
2019-06-22 09:00:00;SUR;0;30;30;1
2019-06-22 09:30:00;SUR;0;33;33;1
2019-06-22 10:00:00;SUR;0;37;37;1
2019-06-22 10:30:00;SUR;0;26;26;1
2019-06-22 11:00:00;SUR;0;34;34;1
2019-06-22 11:30:00;SUR;0;25;25;1
2019-06-22 12:00:00;SUR;0;25;25;1
2019-06-22 12:30:00;SUR;0;29;29;1
2019-06-22 13:00:00;SUR;0;27;27;1
2019-06-22 13:30:00;SUR;0;29;29;1
2019-06-22 14:00:00;SUR;0;37;37;1
2019-06-22 14:30:00;SUR;0;29;29;1
2019-06-22 15:00:00;SUR;0;20;20;1
2019-06-22 15:30:00;SUR;0;22;22;1
2019-06-22 16:00:00;SUR;0;20;20;1
2019-06-22 16:30:00;SUR;0;20;20;1
2019-06-22 17:00:00;SUR;0;21;21;1
2019-06-22 17:30:00;SUR;0;20;20;1
2019-06-22 18:00:00;SUR;0;24;24;1
2019-06-22 18:30:00;SUR;0;29;29;1
2019-06-22 19:00:00;SUR;0;28;28;1
2019-06-22 19:30:00;SUR;0;25;25;1
2019-06-22 20:00:00;SUR;0;28;28;1
2019-06-22 20:30:00;SUR;0;16;16;1
2019-06-22 21:00:00;CONFLICTIVA;16;3;19;2
2019-06-22 21:30:00;NORTE;17;0;17;1
2019-06-22 22:00:00;NORTE;22;0;22;1
2019-06-22 22:30:00;NORTE;10;0;10;1
2019-06-22 23:00:00;NORTE;3;0;3;1
2019-06-23 00:00:00;NORTE;2;0;2;1
2019-06-23 00:30:00;NORTE;5;0;5;1
2019-06-23 01:00:00;NORTE;2;0;2;1
2019-06-23 01:30:00;NORTE;2;0;2;1
2019-06-23 02:00:00;NORTE;4;0;4;1
2019-06-23 02:30:00;NORTE;3;0;3;1
2019-06-23 03:00:00;NORTE;3;0;3;1
2019-06-23 03:30:00;NORTE;8;0;8;1
2019-06-23 04:00:00;NORTE;8;0;8;1
2019-06-23 04:30:00;NORTE;13;0;13;1
2019-06-23 05:00:00;NORTE;17;0;17;1
2019-06-23 05:30:00;NORTE;33;0;33;1
2019-06-23 06:00:00;NORTE;11;0;11;1
2019-06-23 06:30:00;NORTE;26;0;26;1
2019-06-23 07:00:00;NORTE;39;0;39;1
2019-06-23 07:30:00;NORTE;21;0;21;1
2019-06-23 08:00:00;SUR;0;31;31;1
2019-06-23 08:30:00;SUR;0;39;39;1
2019-06-23 09:00:00;SUR;0;27;27;1
2019-06-23 09:30:00;SUR;0;34;34;1
2019-06-23 10:00:00;SUR;0;33;33;1
2019-06-23 10:30:00;SUR;0;31;31;1
2019-06-23 11:00:00;SUR;0;32;32;1
2019-06-23 11:30:00;SUR;0;34;34;1
2019-06-23 12:00:00;SUR;0;33;33;1
2019-06-23 12:30:00;SUR;0;30;30;1
2019-06-23 13:00:00;SUR;0;41;41;1
2019-06-23 13:30:00;SUR;0;41;41;1
2019-06-23 14:00:00;SUR;0;42;42;1
2019-06-23 14:30:00;SUR;0;36;36;1
2019-06-23 15:00:00;SUR;0;26;26;1
2019-06-23 15:30:00;SUR;0;28;28;1
2019-06-23 16:00:00;SUR;0;17;17;1
2019-06-23 16:30:00;SUR;0;31;31;1
2019-06-23 17:00:00;SUR;0;25;25;1
2019-06-23 17:30:00;SUR;0;31;31;1
2019-06-23 18:00:00;SUR;0;41;41;1
2019-06-23 18:30:00;SUR;0;35;35;1
2019-06-23 19:00:00;SUR;0;32;32;1
2019-06-23 19:30:00;SUR;0;30;30;1
2019-06-23 20:00:00;NORTE;30;1;31;1
2019-06-23 20:30:00;NORTE;29;0;29;1
2019-06-23 21:00:00;NORTE;21;0;21;1
2019-06-23 21:30:00;NORTE;23;0;23;1
2019-06-23 22:00:00;NORTE;16;0;16;1
2019-06-23 22:30:00;NORTE;13;0;13;1
2019-06-23 23:00:00;CONFLICTIVA;3;1;4;2
2019-06-23 23:30:00;SUR;0;2;2;1
2019-06-24 00:00:00;SUR;0;3;3;1
2019-06-24 01:00:00;SUR;0;2;2;1
2019-06-24 01:30:00;SUR;0;1;1;1
2019-06-24 02:00:00;SUR;0;6;6;1
2019-06-24 02:30:00;SUR;0;6;6;1
2019-06-24 03:00:00;SUR;0;3;3;1
2019-06-24 03:30:00;SUR;0;5;5;1
2019-06-24 04:00:00;SUR;0;10;10;1
2019-06-24 04:30:00;NORTE;13;0;13;1
2019-06-24 05:00:00;NORTE;22;0;22;1
2019-06-24 05:30:00;NORTE;42;0;42;1
2019-06-24 06:00:00;NORTE;31;0;31;1
2019-06-24 06:30:00;NORTE;29;0;29;1
2019-06-24 07:00:00;NORTE;35;0;35;1
2019-06-24 07:30:00;NORTE;33;0;33;1
2019-06-24 08:00:00;NORTE;37;0;37;1
2019-06-24 08:30:00;NORTE;39;0;39;1
2019-06-24 09:00:00;NORTE;30;0;30;1
2019-06-24 09:30:00;NORTE;39;0;39;1
2019-06-24 10:00:00;NORTE;36;0;36;1
2019-06-24 10:30:00;NORTE;37;0;37;1
2019-06-24 11:00:00;NORTE;31;0;31;1
2019-06-24 11:30:00;SUR;0;32;32;1
2019-06-24 12:00:00;SUR;0;29;29;1
2019-06-24 12:30:00;SUR;0;35;35;1
2019-06-24 13:00:00;SUR;0;39;39;1
2019-06-24 13:30:00;SUR;0;42;42;1
2019-06-24 14:00:00;SUR;0;39;39;1
2019-06-24 14:30:00;SUR;0;32;32;1
2019-06-24 15:00:00;SUR;0;29;29;1
2019-06-24 15:30:00;SUR;0;23;23;1
2019-06-24 16:00:00;SUR;0;25;25;1
2019-06-24 16:30:00;SUR;0;29;29;1
2019-06-24 17:00:00;SUR;0;32;32;1
2019-06-24 17:30:00;SUR;0;29;29;1
2019-06-24 18:00:00;SUR;0;45;45;1
2019-06-24 18:30:00;SUR;0;35;35;1
2019-06-24 19:00:00;CONFLICTIVA;10;17;27;2
2019-06-24 19:30:00;NORTE;32;0;32;1
2019-06-24 20:00:00;NORTE;35;0;35;1
2019-06-24 20:30:00;NORTE;30;0;30;1
2019-06-24 21:00:00;NORTE;18;0;18;1
2019-06-24 21:30:00;NORTE;21;0;21;1
2019-06-24 22:00:00;NORTE;18;0;18;1
2019-06-24 22:30:00;NORTE;9;0;9;1
2019-06-24 23:30:00;NORTE;1;0;1;1
2019-06-25 01:00:00;NORTE;2;0;2;1
2019-06-25 01:30:00;NORTE;1;0;1;1
2019-06-25 02:00:00;NORTE;7;0;7;1
2019-06-25 02:30:00;NORTE;5;0;5;1
2019-06-25 03:00:00;NORTE;2;0;2;1
2019-06-25 03:30:00;NORTE;7;0;7;1
2019-06-25 04:00:00;NORTE;17;0;17;1
2019-06-25 04:30:00;NORTE;11;0;11;1
2019-06-25 05:00:00;NORTE;24;0;24;1
2019-06-25 05:30:00;NORTE;39;0;39;1
2019-06-25 06:00:00;NORTE;25;0;25;1
2019-06-25 06:30:00;NORTE;29;0;29;1
2019-06-25 07:00:00;NORTE;41;0;41;1
2019-06-25 07:30:00;NORTE;30;0;30;1
2019-06-25 08:00:00;NORTE;39;0;39;1
2019-06-25 08:30:00;NORTE;44;0;44;1
2019-06-25 09:00:00;CONFLICTIVA;17;4;21;2
2019-06-25 09:30:00;SUR;0;39;39;1
2019-06-25 10:00:00;SUR;0;39;39;1
2019-06-25 10:30:00;SUR;0;39;39;1
2019-06-25 11:00:00;SUR;0;30;30;1
2019-06-25 11:30:00;SUR;0;27;27;1
2019-06-25 12:00:00;SUR;0;26;26;1
2019-06-25 12:30:00;SUR;0;26;26;1
2019-06-25 13:00:00;SUR;0;35;35;1
2019-06-25 13:30:00;SUR;0;39;39;1
2019-06-25 14:00:00;SUR;0;36;36;1
2019-06-25 14:30:00;SUR;0;39;39;1
2019-06-25 15:00:00;SUR;0;31;31;1
2019-06-25 15:30:00;SUR;0;27;27;1
2019-06-25 16:00:00;SUR;0;27;27;1
2019-06-25 16:30:00;SUR;0;25;25;1
2019-06-25 17:00:00;SUR;0;29;29;1
2019-06-25 17:30:00;SUR;0;26;26;1
2019-06-25 18:00:00;SUR;1;36;37;1
2019-06-25 18:30:00;SUR;0;36;36;1
2019-06-25 19:00:00;SUR;0;33;33;1
2019-06-25 19:30:00;SUR;0;36;36;1
2019-06-25 20:00:00;SUR;0;28;28;1
2019-06-25 20:30:00;SUR;0;38;38;1
2019-06-25 21:00:00;SUR;0;22;22;1
2019-06-25 21:30:00;CONFLICTIVA;10;4;14;2
2019-06-25 22:00:00;NORTE;19;0;19;1
2019-06-25 22:30:00;NORTE;11;0;11;1
2019-06-25 23:00:00;NORTE;1;0;1;1
2019-06-25 23:30:00;SUR;0;1;1;1
2019-06-26 00:00:00;SUR;0;1;1;1
2019-06-26 00:30:00;SUR;0;1;1;1
2019-06-26 01:00:00;SUR;0;1;1;1
2019-06-26 01:30:00;SUR;0;1;1;1
2019-06-26 02:00:00;SUR;0;4;4;1
2019-06-26 02:30:00;SUR;0;3;3;1
2019-06-26 03:00:00;SUR;0;4;4;1
2019-06-26 03:30:00;SUR;0;6;6;1
2019-06-26 04:00:00;SUR;0;17;17;1
2019-06-26 04:30:00;SUR;0;10;10;1
2019-06-26 05:00:00;SUR;0;23;23;1
2019-06-26 05:30:00;SUR;0;44;44;1
2019-06-26 06:00:00;SUR;0;30;30;1
2019-06-26 06:30:00;SUR;0;25;25;1
2019-06-26 07:00:00;SUR;0;42;42;1
2019-06-26 07:30:00;SUR;0;30;30;1
2019-06-26 08:00:00;SUR;0;33;33;1
2019-06-26 08:30:00;SUR;0;41;41;1
2019-06-26 09:00:00;SUR;0;28;28;1
2019-06-26 09:30:00;SUR;0;35;35;1
2019-06-26 10:00:00;SUR;0;38;38;1
2019-06-26 10:30:00;SUR;0;36;36;1
2019-06-26 11:00:00;SUR;0;33;33;1
2019-06-26 11:30:00;SUR;0;31;31;1
2019-06-26 12:00:00;SUR;0;35;35;1
2019-06-26 12:30:00;SUR;0;31;31;1
2019-06-26 13:00:00;SUR;0;24;24;1
2019-06-26 13:30:00;SUR;0;27;27;1
2019-06-26 14:00:00;SUR;0;39;39;1
2019-06-26 14:30:00;SUR;0;34;34;1
2019-06-26 15:00:00;SUR;0;23;23;1
2019-06-26 15:30:00;SUR;0;33;33;1
2019-06-26 16:00:00;SUR;0;16;16;1
2019-06-26 16:30:00;SUR;0;22;22;1
2019-06-26 17:00:00;SUR;0;24;24;1
2019-06-26 17:30:00;SUR;0;31;31;1
2019-06-26 18:00:00;SUR;0;35;35;1
2019-06-26 18:30:00;SUR;0;29;29;1
2019-06-26 19:00:00;SUR;0;25;25;1
2019-06-26 19:30:00;SUR;0;25;25;1
2019-06-26 20:00:00;SUR;0;42;42;1
2019-06-26 20:30:00;SUR;0;28;28;1
2019-06-26 21:00:00;SUR;0;21;21;1
2019-06-26 21:30:00;SUR;0;18;18;1
2019-06-26 22:00:00;SUR;0;12;12;1
2019-06-26 22:30:00;SUR;0;11;11;1
2019-06-26 23:00:00;SUR;0;2;2;1
2019-06-26 23:38:19;SUR;0;1;1;1
2019-06-26 23:52:44;SUR;0;1;1;1
2019-06-26 23:59:45;SUR;0;1;1;1
2019-06-27 00:09:59;SUR;0;1;1;1
2019-06-27 00:14:24;SUR;0;1;1;1
2019-06-27 00:19:34;SUR;0;1;1;1
2019-06-27 00:21:39;SUR;0;1;1;1
2019-06-27 00:28:53;SUR;0;1;1;1
2019-06-27 01:10:42;SUR;0;1;1;1
2019-06-27 01:30:00;SUR;0;2;2;1
2019-06-27 02:00:00;SUR;0;3;3;1
2019-06-27 02:30:00;SUR;0;3;3;1
2019-06-27 03:00:00;SUR;0;3;3;1
2019-06-27 03:30:00;SUR;0;4;4;1
2019-06-27 04:00:00;SUR;0;14;14;1
2019-06-27 04:30:00;SUR;0;13;13;1
2019-06-27 05:00:00;SUR;0;22;22;1
2019-06-27 05:30:00;SUR;0;43;43;1
2019-06-27 06:00:00;SUR;0;30;30;1
2019-06-27 06:30:00;SUR;0;22;22;1
2019-06-27 07:00:00;SUR;0;38;38;1
2019-06-27 07:30:00;SUR;0;35;35;1
2019-06-27 08:00:00;SUR;0;33;33;1
2019-06-27 08:30:00;SUR;0;40;40;1
2019-06-27 09:00:00;SUR;0;30;30;1
2019-06-27 09:30:00;SUR;0;34;34;1
2019-06-27 10:00:00;SUR;0;34;34;1
2019-06-27 10:30:00;SUR;0;46;46;1
2019-06-27 11:00:00;SUR;0;31;31;1
2019-06-27 11:30:00;SUR;0;31;31;1
2019-06-27 12:00:00;SUR;0;31;31;1
2019-06-27 12:30:00;SUR;0;28;28;1
2019-06-27 13:00:00;SUR;0;33;33;1
2019-06-27 13:30:00;SUR;0;45;45;1
2019-06-27 14:00:00;SUR;0;33;33;1
2019-06-27 14:30:00;SUR;0;37;37;1
2019-06-27 15:00:00;SUR;0;31;31;1
2019-06-27 15:30:00;SUR;0;31;31;1
2019-06-27 16:00:00;SUR;0;17;17;1
2019-06-27 16:30:00;SUR;0;29;29;1
2019-06-27 17:00:00;SUR;0;34;34;1
2019-06-27 17:30:00;SUR;0;29;29;1
2019-06-27 18:00:00;SUR;0;41;41;1
2019-06-27 18:30:00;SUR;0;32;32;1
2019-06-27 19:00:00;SUR;0;34;34;1
2019-06-27 19:30:00;SUR;0;38;38;1
2019-06-27 20:00:00;SUR;0;30;30;1
2019-06-27 20:30:00;SUR;0;36;36;1
2019-06-27 21:00:00;SUR;0;23;23;1
2019-06-27 21:30:00;SUR;0;20;20;1
2019-06-27 22:00:00;SUR;0;17;17;1
2019-06-27 22:30:00;SUR;0;15;15;1
2019-06-27 23:00:00;SUR;0;4;4;1
2019-06-27 23:30:00;SUR;0;1;1;1
2019-06-28 00:00:00;SUR;0;1;1;1
2019-06-28 01:00:00;SUR;0;2;2;1
2019-06-28 01:30:00;SUR;0;1;1;1
2019-06-28 02:00:00;SUR;0;3;3;1
2019-06-28 02:30:00;SUR;0;6;6;1
2019-06-28 03:00:00;SUR;0;1;1;1
2019-06-28 03:30:00;SUR;0;7;7;1
2019-06-28 04:00:00;SUR;0;18;18;1
2019-06-28 04:30:00;SUR;0;11;11;1
2019-06-28 05:00:00;SUR;0;23;23;1
2019-06-28 05:30:00;SUR;0;35;35;1
2019-06-28 06:00:00;SUR;0;28;28;1
2019-06-28 06:30:00;SUR;0;30;30;1
2019-06-28 07:00:00;SUR;0;39;39;1
2019-06-28 07:30:00;SUR;0;31;31;1
2019-06-28 08:00:00;SUR;0;39;39;1
2019-06-28 08:30:00;SUR;0;31;31;1
2019-06-28 09:00:00;SUR;0;35;35;1
2019-06-28 09:30:00;SUR;0;37;37;1
2019-06-28 10:00:00;SUR;0;30;30;1
2019-06-28 10:30:00;SUR;0;33;33;1
2019-06-28 11:00:00;SUR;0;30;30;1
2019-06-28 11:30:00;SUR;0;24;24;1
2019-06-28 12:00:00;SUR;0;34;34;1
2019-06-28 12:30:00;SUR;0;24;24;1
2019-06-28 13:00:00;SUR;0;42;42;1
2019-06-28 13:30:00;SUR;0;31;31;1
2019-06-28 14:00:00;SUR;0;39;39;1
2019-06-28 14:30:00;SUR;0;38;38;1
2019-06-28 15:00:00;SUR;0;34;34;1
2019-06-28 15:30:00;SUR;0;22;22;1
2019-06-28 16:00:00;SUR;0;25;25;1
2019-06-28 16:30:00;SUR;0;34;34;1
2019-06-28 17:00:00;SUR;0;24;24;1
2019-06-28 17:30:00;SUR;0;27;27;1
2019-06-28 18:00:00;SUR;0;27;27;1
2019-06-28 18:30:00;SUR;0;33;33;1
2019-06-28 19:00:00;SUR;0;34;34;1
2019-06-28 19:30:00;SUR;0;27;27;1
2019-06-28 20:00:00;SUR;0;28;28;1
2019-06-28 20:30:00;SUR;0;23;23;1
2019-06-28 21:00:00;SUR;0;18;18;1
2019-06-28 21:30:00;SUR;0;21;21;1
2019-06-28 22:00:00;SUR;0;12;12;1
2019-06-28 22:30:00;SUR;0;12;12;1
2019-06-28 23:00:00;CONFLICTIVA;2;1;3;2
2019-06-28 23:30:00;NORTE;1;0;1;1
2019-06-29 00:00:00;NORTE;1;0;1;1
2019-06-29 00:30:00;NORTE;1;0;1;1
2019-06-29 01:30:00;NORTE;1;0;1;1
2019-06-29 02:00:00;NORTE;5;0;5;1
2019-06-29 02:30:00;NORTE;4;0;4;1
2019-06-29 03:00:00;NORTE;1;0;1;1
2019-06-29 03:30:00;NORTE;6;0;6;1
2019-06-29 04:00:00;NORTE;11;0;11;1
2019-06-29 04:30:00;NORTE;13;0;13;1
2019-06-29 05:00:00;NORTE;19;0;19;1
2019-06-29 05:30:00;NORTE;40;0;40;1
2019-06-29 06:00:00;NORTE;20;0;20;1
2019-06-29 06:30:00;NORTE;23;0;23;1
2019-06-29 07:00:00;NORTE;37;0;37;1
2019-06-29 07:30:00;NORTE;33;0;33;1
2019-06-29 08:00:00;NORTE;39;1;40;1
2019-06-29 08:30:00;NORTE;35;0;35;1
2019-06-29 09:00:00;CONFLICTIVA;11;9;20;2
2019-06-29 09:30:00;SUR;0;32;32;1
2019-06-29 10:00:00;SUR;0;35;35;1
2019-06-29 10:30:00;SUR;0;39;39;1
2019-06-29 11:00:00;SUR;0;33;33;1
2019-06-29 11:30:00;SUR;0;23;23;1
2019-06-29 12:00:00;SUR;0;29;29;1
2019-06-29 12:30:00;SUR;0;30;30;1
2019-06-29 13:00:00;SUR;0;35;35;1
2019-06-29 13:30:00;SUR;0;21;21;1
2019-06-29 14:00:00;SUR;0;13;13;1
2019-06-29 14:30:00;SUR;0;29;29;1
2019-06-29 15:00:00;SUR;0;15;15;1
2019-06-29 15:30:00;SUR;0;26;26;1
2019-06-29 16:00:00;SUR;0;13;13;1
2019-06-29 16:30:00;SUR;0;28;28;1
2019-06-29 17:00:00;SUR;0;23;23;1
2019-06-29 17:30:00;SUR;0;20;20;1
2019-06-29 18:00:00;SUR;0;30;30;1
2019-06-29 18:30:00;SUR;0;27;27;1
2019-06-29 19:00:00;SUR;0;25;25;1
2019-06-29 19:30:00;SUR;0;27;27;1
2019-06-29 20:00:00;SUR;0;28;28;1
2019-06-29 20:30:00;SUR;0;21;21;1
2019-06-29 21:00:00;SUR;0;15;15;1
2019-06-29 21:30:00;SUR;0;18;18;1
2019-06-29 22:00:00;SUR;0;11;11;1
2019-06-29 22:30:00;SUR;0;14;14;1
2019-06-29 23:00:00;SUR;0;3;3;1
2019-06-29 23:30:00;SUR;0;1;1;1
2019-06-30 00:00:00;SUR;0;3;3;1
2019-06-30 00:30:00;SUR;0;1;1;1
2019-06-30 01:00:00;SUR;0;2;2;1
2019-06-30 01:30:00;SUR;0;1;1;1
2019-06-30 02:00:00;SUR;0;4;4;1
2019-06-30 02:30:00;SUR;0;3;3;1
2019-06-30 03:00:00;CONFLICTIVA;2;1;3;2
2019-06-30 03:30:00;NORTE;3;0;3;1
2019-06-30 04:00:00;NORTE;9;0;9;1
2019-06-30 04:30:00;NORTE;14;0;14;1
2019-06-30 05:00:00;NORTE;14;0;14;1
2019-06-30 05:30:00;NORTE;32;0;32;1
2019-06-30 06:00:00;NORTE;23;0;23;1
2019-06-30 06:30:00;NORTE;23;0;23;1
2019-06-30 07:00:00;NORTE;41;0;41;1
2019-06-30 07:30:00;CONFLICTIVA;12;11;23;2
2019-06-30 08:00:00;SUR;0;33;33;1
2019-06-30 08:30:00;SUR;0;34;34;1
2019-06-30 09:00:00;SUR;0;21;21;1
2019-06-30 09:30:00;SUR;0;33;33;1
2019-06-30 10:00:00;SUR;0;30;30;1
2019-06-30 10:30:00;SUR;0;31;31;1
2019-06-30 11:00:00;SUR;0;31;31;1
2019-06-30 11:30:00;SUR;0;31;31;1
2019-06-30 12:00:00;SUR;0;28;28;1
2019-06-30 12:30:00;SUR;0;26;26;1
2019-06-30 13:00:00;SUR;0;35;35;1
2019-06-30 13:30:00;SUR;0;36;36;1
2019-06-30 14:00:00;SUR;0;33;33;1
2019-06-30 14:30:00;SUR;0;44;44;1
2019-06-30 15:00:00;SUR;0;24;24;1
2019-06-30 15:30:00;SUR;0;22;22;1
2019-06-30 16:00:00;SUR;0;18;18;1
2019-06-30 16:30:00;SUR;0;23;23;1
2019-06-30 17:00:00;SUR;0;28;28;1
2019-06-30 17:30:00;SUR;0;21;21;1
2019-06-30 18:00:00;SUR;0;26;26;1
2019-06-30 18:30:00;SUR;0;27;27;1
2019-06-30 19:00:00;SUR;0;24;24;1
2019-06-30 19:30:00;SUR;0;27;27;1
2019-06-30 20:00:00;SUR;0;34;34;1
2019-06-30 20:30:00;SUR;0;30;30;1
2019-06-30 21:00:00;SUR;0;28;28;1
2019-06-30 21:30:00;CONFLICTIVA;2;10;12;2
2019-06-30 22:00:00;NORTE;25;0;25;1
2019-06-30 22:30:00;NORTE;12;0;12;1
2019-06-30 23:00:00;SUR;0;11;11;1
2019-06-30 23:30:00;SUR;0;5;5;1
2019-07-01 00:00:00;SUR;0;4;4;1
2019-07-01 01:00:00;SUR;0;1;1;1
2019-07-01 01:30:00;SUR;0;1;1;1
2019-07-01 02:00:00;SUR;0;4;4;1
2019-07-01 02:30:00;SUR;0;7;7;1
2019-07-01 03:00:00;SUR;0;3;3;1
2019-07-01 03:30:00;SUR;0;6;6;1
2019-07-01 04:00:00;CONFLICTIVA;5;5;10;2
2019-07-01 04:30:00;NORTE;15;0;15;1
2019-07-01 05:00:00;NORTE;27;0;27;1
2019-07-01 05:30:00;NORTE;40;0;40;1
2019-07-01 06:00:00;NORTE;30;0;30;1
2019-07-01 06:30:00;NORTE;26;0;26;1
2019-07-01 07:00:00;NORTE;31;0;31;1
2019-07-01 07:30:00;NORTE;39;0;39;1
2019-07-01 08:00:00;NORTE;35;0;35;1
2019-07-01 08:30:00;NORTE;41;1;42;1
2019-07-01 09:00:00;NORTE;26;0;26;1
2019-07-01 09:30:00;SUR;1;34;35;1
2019-07-01 10:00:00;SUR;0;42;42;1
2019-07-01 10:30:00;SUR;0;31;31;1
2019-07-01 11:00:00;SUR;0;39;39;1
2019-07-01 11:30:00;SUR;0;28;28;1
2019-07-01 12:00:00;SUR;0;37;37;1
2019-07-01 12:30:00;SUR;0;29;29;1
2019-07-01 13:00:00;SUR;0;36;36;1
2019-07-01 13:30:00;SUR;0;37;37;1
2019-07-01 14:00:00;SUR;0;32;32;1
2019-07-01 14:30:00;SUR;0;44;44;1
2019-07-01 15:00:00;SUR;0;32;32;1
2019-07-01 15:30:00;SUR;0;28;28;1
2019-07-01 16:00:00;SUR;0;27;27;1
2019-07-01 16:30:00;SUR;0;31;31;1
2019-07-01 17:00:00;SUR;0;26;26;1
2019-07-01 17:30:00;SUR;0;18;18;1
2019-07-01 18:00:00;CONFLICTIVA;20;9;29;2
2019-07-01 18:30:00;NORTE;41;0;41;1
2019-07-01 19:00:00;NORTE;36;0;36;1
2019-07-01 19:30:00;NORTE;37;0;37;1
2019-07-01 20:00:00;NORTE;31;0;31;1
2019-07-01 20:30:00;NORTE;33;0;33;1
2019-07-01 21:00:00;NORTE;22;0;22;1
2019-07-01 21:30:00;NORTE;18;0;18;1
2019-07-01 22:00:00;NORTE;14;0;14;1
2019-07-01 22:30:00;NORTE;15;0;15;1
2019-07-01 23:00:00;NORTE;7;0;7;1
2019-07-01 23:30:00;NORTE;2;0;2;1
2019-07-02 00:00:00;NORTE;1;0;1;1
2019-07-02 01:00:00;NORTE;4;0;4;1
2019-07-02 01:30:00;NORTE;1;0;1;1
2019-07-02 02:00:00;NORTE;3;0;3;1
2019-07-02 02:30:00;NORTE;8;0;8;1
2019-07-02 03:00:00;NORTE;1;0;1;1
2019-07-02 03:30:00;NORTE;9;0;9;1
2019-07-02 04:00:00;NORTE;14;0;14;1
2019-07-02 04:30:00;NORTE;13;0;13;1
2019-07-02 05:00:00;NORTE;24;0;24;1
2019-07-02 05:30:00;NORTE;45;0;45;1
2019-07-02 06:00:00;NORTE;23;0;23;1
2019-07-02 06:30:00;NORTE;29;0;29;1
2019-07-02 07:00:00;NORTE;42;0;42;1
2019-07-02 07:30:00;NORTE;39;0;39;1
2019-07-02 08:00:00;NORTE;34;0;34;1
2019-07-02 08:30:00;NORTE;40;0;40;1
2019-07-02 09:00:00;NORTE;32;0;32;1
2019-07-02 09:30:00;NORTE;40;0;40;1
2019-07-02 10:00:00;NORTE;33;0;33;1
2019-07-02 10:30:00;NORTE;39;0;39;1
2019-07-02 11:00:00;NORTE;28;0;28;1
2019-07-02 11:30:00;NORTE;34;0;34;1
2019-07-02 12:00:00;NORTE;31;0;31;1
2019-07-02 12:30:00;NORTE;33;0;33;1
2019-07-02 13:00:00;NORTE;25;0;25;1
2019-07-02 13:30:08;NORTE;1;0;1;1
2019-07-02 13:32:13;NORTE;1;0;1;1
2019-07-02 13:32:18;NORTE;1;0;1;1
2019-07-02 13:34:35;NORTE;1;0;1;1
2019-07-02 13:36:32;NORTE;1;0;1;1
2019-07-02 13:37:05;NORTE;1;0;1;1
2019-07-02 13:37:54;NORTE;1;0;1;1
2019-07-02 13:38:09;NORTE;1;0;1;1
2019-07-02 13:40:53;NORTE;1;0;1;1
2019-07-02 13:41:51;NORTE;1;0;1;1
2019-07-02 13:41:57;NORTE;1;0;1;1
2019-07-02 13:42:33;NORTE;1;0;1;1
2019-07-02 13:43:45;NORTE;1;0;1;1
2019-07-02 13:44:22;NORTE;1;0;1;1
2019-07-02 13:44:42;NORTE;1;0;1;1
2019-07-02 13:45:30;NORTE;1;0;1;1
2019-07-02 13:46:04;NORTE;1;0;1;1
2019-07-02 13:46:45;NORTE;1;0;1;1
2019-07-02 13:47:31;NORTE;1;0;1;1
2019-07-02 13:48:01;NORTE;1;0;1;1
2019-07-02 13:48:02;NORTE;1;0;1;1
2019-07-02 13:49:26;NORTE;1;0;1;1
2019-07-02 13:49:44;NORTE;1;0;1;1
2019-07-02 13:50:05;NORTE;1;0;1;1
2019-07-02 13:51:39;NORTE;1;0;1;1
2019-07-02 13:52:12;NORTE;1;0;1;1
2019-07-02 13:52:52;NORTE;1;0;1;1
2019-07-02 13:54:14;NORTE;1;0;1;1
2019-07-02 13:55:26;NORTE;1;0;1;1
2019-07-02 13:56:57;NORTE;1;0;1;1
2019-07-02 13:57:03;NORTE;1;0;1;1
2019-07-02 13:57:48;NORTE;1;0;1;1
2019-07-02 13:57:49;NORTE;1;0;1;1
2019-07-02 13:58:24;NORTE;1;0;1;1
2019-07-02 13:58:46;NORTE;1;0;1;1
2019-07-02 13:59:33;NORTE;1;0;1;1
2019-07-02 14:00:00;NORTE;43;0;43;1
2019-07-02 14:30:00;NORTE;33;0;33;1
2019-07-02 15:00:00;NORTE;38;0;38;1
2019-07-02 15:30:00;NORTE;28;0;28;1
2019-07-02 16:00:00;NORTE;26;0;26;1
2019-07-02 16:30:00;NORTE;34;0;34;1
2019-07-02 17:00:00;NORTE;34;0;34;1
2019-07-02 17:30:00;NORTE;36;0;36;1
2019-07-02 18:00:00;NORTE;37;0;37;1
2019-07-02 18:30:00;NORTE;27;0;27;1
2019-07-02 19:00:00;NORTE;28;0;28;1
2019-07-02 19:30:00;NORTE;34;0;34;1
2019-07-02 20:00:00;NORTE;39;0;39;1
2019-07-02 20:30:25;NORTE;1;0;1;1
2019-07-02 20:30:52;NORTE;1;0;1;1
2019-07-02 20:32:02;NORTE;1;0;1;1
2019-07-02 20:32:03;NORTE;1;0;1;1
2019-07-02 20:32:51;NORTE;1;0;1;1
2019-07-02 20:33:08;NORTE;1;0;1;1
2019-07-02 20:33:52;NORTE;1;0;1;1
2019-07-02 20:34:32;NORTE;1;0;1;1
2019-07-02 20:35:12;NORTE;1;0;1;1
2019-07-02 20:35:40;NORTE;1;0;1;1
2019-07-02 20:36:16;NORTE;1;0;1;1
2019-07-02 20:36:51;NORTE;1;0;1;1
2019-07-02 20:40:02;NORTE;1;0;1;1
2019-07-02 20:42:37;NORTE;1;0;1;1
2019-07-02 20:43:06;SUR;0;1;1;1
2019-07-02 20:44:33;NORTE;1;0;1;1
2019-07-02 20:45:03;NORTE;1;0;1;1
2019-07-02 21:00:00;SUR;0;20;20;1
2019-07-02 21:30:00;SUR;0;12;12;1
2019-07-02 21:43:00;SUR;0;15;15;1
2019-07-02 22:00:00;SUR;0;3;3;1
2019-07-02 22:09:00;SUR;0;2;2;1
2019-07-02 22:19:00;CONFLICTIVA;5;1;6;2
2019-07-02 22:33:00;NORTE;15;0;15;1
2019-07-02 23:00:00;NORTE;12;0;12;1
2019-07-02 23:30:00;NORTE;4;0;4;1
2019-07-03 00:00:00;NORTE;2;0;2;1
2019-07-03 00:30:00;NORTE;1;0;1;1
2019-07-03 01:00:00;NORTE;2;0;2;1
2019-07-03 01:30:00;NORTE;4;0;4;1
2019-07-03 02:00:00;NORTE;2;0;2;1
2019-07-03 02:30:00;NORTE;4;0;4;1
2019-07-03 03:00:00;NORTE;5;0;5;1
2019-07-03 03:30:00;NORTE;7;0;7;1
2019-07-03 04:00:00;NORTE;15;0;15;1
2019-07-03 04:30:00;NORTE;17;0;17;1
2019-07-03 05:00:00;NORTE;22;0;22;1
2019-07-03 05:30:00;NORTE;43;0;43;1
2019-07-03 06:00:00;NORTE;30;0;30;1
2019-07-03 06:30:00;NORTE;28;0;28;1
2019-07-03 07:00:00;NORTE;41;0;41;1
2019-07-03 07:30:00;NORTE;36;0;36;1
2019-07-03 08:00:00;NORTE;37;0;37;1
2019-07-03 08:30:00;NORTE;38;0;38;1
2019-07-03 09:00:00;NORTE;34;0;34;1
2019-07-03 09:30:00;NORTE;36;0;36;1
2019-07-03 10:00:00;SUR;0;36;36;1
2019-07-03 10:30:00;SUR;0;34;34;1
2019-07-03 11:00:00;SUR;0;37;37;1
2019-07-03 11:30:00;SUR;0;33;33;1
2019-07-03 12:00:00;SUR;0;29;29;1
2019-07-03 12:30:00;SUR;0;33;33;1
2019-07-03 13:00:00;SUR;0;38;38;1
2019-07-03 13:30:00;SUR;0;35;35;1
2019-07-03 14:00:00;SUR;0;42;42;1
2019-07-03 14:30:00;SUR;0;43;43;1
2019-07-03 15:00:00;SUR;0;32;32;1
2019-07-03 15:30:00;SUR;0;29;29;1
2019-07-03 16:00:00;SUR;0;24;24;1
2019-07-03 16:30:00;SUR;0;32;32;1
2019-07-03 17:00:00;SUR;0;31;31;1
2019-07-03 17:30:00;SUR;0;33;33;1
2019-07-03 18:00:00;SUR;0;32;32;1
2019-07-03 18:30:00;SUR;0;33;33;1
2019-07-03 19:00:00;SUR;0;29;29;1
2019-07-03 19:30:00;SUR;0;29;29;1
2019-07-03 20:00:00;SUR;0;33;33;1
2019-07-03 20:30:00;SUR;0;26;26;1
2019-07-03 21:00:00;SUR;0;19;19;1
2019-07-03 21:30:00;SUR;0;23;23;1
2019-07-03 22:00:00;SUR;0;24;24;1
2019-07-03 22:30:00;SUR;0;15;15;1
2019-07-03 23:00:00;SUR;0;5;5;1
2019-07-03 23:30:00;SUR;0;1;1;1
2019-07-04 00:00:00;SUR;0;2;2;1
2019-07-04 01:00:00;SUR;0;1;1;1
2019-07-04 01:30:00;SUR;0;1;1;1
2019-07-04 02:00:00;SUR;0;2;2;1
2019-07-04 02:30:00;SUR;0;5;5;1
2019-07-04 03:00:00;CONFLICTIVA;1;4;5;2
2019-07-04 03:30:00;NORTE;9;0;9;1
2019-07-04 04:00:00;NORTE;10;0;10;1
2019-07-04 04:30:00;NORTE;21;0;21;1
2019-07-04 05:00:00;NORTE;22;0;22;1
2019-07-04 05:30:00;NORTE;41;0;41;1
2019-07-04 06:00:00;NORTE;26;0;26;1
2019-07-04 06:30:00;NORTE;31;0;31;1
2019-07-04 07:00:00;NORTE;37;0;37;1
2019-07-04 07:30:00;NORTE;36;0;36;1
2019-07-04 08:00:00;NORTE;39;0;39;1
2019-07-04 08:30:00;NORTE;33;0;33;1
2019-07-04 09:00:00;SUR;0;28;28;1
2019-07-04 09:30:00;SUR;0;34;34;1
2019-07-04 10:00:00;SUR;0;34;34;1
2019-07-04 10:30:00;SUR;0;40;40;1
2019-07-04 11:00:00;SUR;0;33;33;1
2019-07-04 11:30:00;SUR;0;25;25;1
2019-07-04 12:00:00;SUR;0;31;31;1
2019-07-04 12:30:00;SUR;0;36;36;1
2019-07-04 13:00:00;SUR;0;38;38;1
2019-07-04 13:30:00;SUR;0;43;43;1
2019-07-04 14:00:00;SUR;0;34;34;1
2019-07-04 14:30:00;SUR;0;42;42;1
2019-07-04 15:00:00;SUR;0;37;37;1
2019-07-04 15:30:00;SUR;0;31;31;1
2019-07-04 16:00:00;SUR;0;18;18;1
2019-07-04 16:30:00;SUR;0;29;29;1
2019-07-04 17:00:00;SUR;0;29;29;1
2019-07-04 17:30:00;SUR;0;32;32;1
2019-07-04 18:00:00;SUR;0;35;35;1
2019-07-04 18:30:00;SUR;0;36;36;1
2019-07-04 19:00:00;SUR;0;34;34;1
2019-07-04 19:30:00;SUR;0;24;24;1
2019-07-04 20:00:00;SUR;0;33;33;1
2019-07-04 20:30:00;SUR;0;33;33;1
2019-07-04 21:00:00;SUR;0;18;18;1
2019-07-04 21:30:00;SUR;0;25;25;1
2019-07-04 22:00:00;SUR;0;22;22;1
2019-07-04 22:30:00;SUR;0;15;15;1
2019-07-04 23:00:00;SUR;0;2;2;1
2019-07-05 00:00:00;SUR;0;2;2;1
2019-07-05 00:30:00;SUR;0;1;1;1
2019-07-05 01:00:00;SUR;0;1;1;1
2019-07-05 01:30:00;SUR;0;1;1;1
2019-07-05 02:00:00;SUR;0;5;5;1
2019-07-05 02:30:00;SUR;0;5;5;1
2019-07-05 03:00:00;SUR;0;5;5;1
2019-07-05 03:30:00;SUR;0;7;7;1
2019-07-05 04:00:00;SUR;0;14;14;1
2019-07-05 04:30:00;SUR;0;11;11;1
2019-07-05 05:00:00;SUR;0;20;20;1
2019-07-05 05:30:00;SUR;0;45;45;1
2019-07-05 06:00:00;SUR;0;25;25;1
2019-07-05 06:30:00;SUR;0;25;25;1
2019-07-05 07:00:00;SUR;0;35;35;1
2019-07-05 07:30:00;SUR;0;30;30;1
2019-07-05 08:00:00;SUR;0;37;37;1
2019-07-05 08:30:00;SUR;0;40;40;1
2019-07-05 09:00:00;SUR;0;29;29;1
2019-07-05 09:30:00;SUR;0;37;37;1
2019-07-05 10:00:00;SUR;0;33;33;1
2019-07-05 10:30:00;SUR;0;40;40;1
2019-07-05 11:00:00;SUR;0;27;27;1
2019-07-05 11:30:00;SUR;0;32;32;1
2019-07-05 12:00:00;SUR;0;28;28;1
2019-07-05 12:30:00;SUR;0;28;28;1
2019-07-05 13:00:00;SUR;0;42;42;1
2019-07-05 13:30:00;SUR;0;36;36;1
2019-07-05 14:00:00;SUR;0;45;45;1
2019-07-05 14:30:00;SUR;0;43;43;1
2019-07-05 15:00:00;SUR;0;36;36;1
2019-07-05 15:30:00;SUR;0;29;29;1
2019-07-05 16:00:00;SUR;0;22;22;1
2019-07-05 16:30:00;SUR;0;33;33;1
2019-07-05 17:00:00;SUR;0;27;27;1
2019-07-05 17:30:00;SUR;0;33;33;1
2019-07-05 18:00:00;SUR;0;40;40;1
2019-07-05 18:30:00;SUR;0;33;33;1
2019-07-05 19:00:00;SUR;0;36;36;1
2019-07-05 19:30:00;CONFLICTIVA;6;18;24;2
2019-07-05 20:00:00;NORTE;35;0;35;1
2019-07-05 20:30:00;NORTE;23;0;23;1
2019-07-05 21:00:00;NORTE;18;0;18;1
2019-07-05 21:30:00;NORTE;20;0;20;1
2019-07-05 22:00:00;NORTE;22;0;22;1
2019-07-05 22:30:00;NORTE;10;0;10;1
2019-07-05 23:00:00;NORTE;4;0;4;1
2019-07-05 23:30:00;NORTE;2;0;2;1
2019-07-06 00:30:00;NORTE;3;0;3;1
2019-07-06 01:00:00;NORTE;3;0;3;1
2019-07-06 01:30:00;NORTE;1;0;1;1
2019-07-06 02:00:00;NORTE;5;0;5;1
2019-07-06 02:30:00;NORTE;5;0;5;1
2019-07-06 03:00:00;NORTE;1;0;1;1
2019-07-06 03:30:00;NORTE;5;0;5;1
2019-07-06 04:00:00;NORTE;15;0;15;1
2019-07-06 04:30:00;NORTE;11;0;11;1
2019-07-06 05:00:00;NORTE;25;0;25;1
2019-07-06 05:30:00;NORTE;30;0;30;1
2019-07-06 06:00:00;NORTE;20;0;20;1
2019-07-06 06:30:00;NORTE;29;0;29;1
2019-07-06 07:00:00;NORTE;37;0;37;1
2019-07-06 07:30:00;NORTE;32;0;32;1
2019-07-06 08:00:00;SUR;1;33;34;1
2019-07-06 08:30:00;SUR;0;36;36;1
2019-07-06 09:00:00;SUR;0;33;33;1
2019-07-06 09:30:00;SUR;0;26;26;1
2019-07-06 10:00:00;SUR;0;32;32;1
2019-07-06 10:30:00;SUR;0;33;33;1
2019-07-06 11:00:00;SUR;0;30;30;1
2019-07-06 11:30:00;SUR;0;25;25;1
2019-07-06 12:00:00;SUR;0;30;30;1
2019-07-06 12:30:00;SUR;0;30;30;1
2019-07-06 13:00:00;SUR;0;32;32;1
2019-07-06 13:30:00;SUR;0;39;39;1
2019-07-06 14:00:00;SUR;0;36;36;1
2019-07-06 14:30:00;SUR;0;38;38;1
2019-07-06 15:00:00;SUR;0;28;28;1
2019-07-06 15:30:00;SUR;0;25;25;1
2019-07-06 16:00:00;SUR;0;17;17;1
2019-07-06 16:30:00;SUR;0;21;21;1
2019-07-06 17:00:00;SUR;0;27;27;1
2019-07-06 17:30:00;SUR;0;19;19;1
2019-07-06 18:00:00;SUR;0;25;25;1
2019-07-06 18:30:00;SUR;0;28;28;1
2019-07-06 19:00:00;SUR;0;23;23;1
2019-07-06 19:30:00;SUR;0;24;24;1
2019-07-06 20:00:00;SUR;0;23;23;1
2019-07-06 20:30:00;CONFLICTIVA;13;10;23;2
2019-07-06 21:00:00;NORTE;21;0;21;1
2019-07-06 21:30:00;NORTE;19;0;19;1
2019-07-06 22:00:00;NORTE;19;0;19;1
2019-07-06 22:30:00;NORTE;11;0;11;1
2019-07-06 23:00:00;NORTE;6;0;6;1
2019-07-06 23:30:00;NORTE;6;0;6;1
2019-07-07 00:00:00;NORTE;3;0;3;1
2019-07-07 00:30:00;NORTE;4;0;4;1
2019-07-07 01:00:00;NORTE;2;0;2;1
2019-07-07 01:30:00;NORTE;1;0;1;1
2019-07-07 02:00:00;NORTE;2;0;2;1
2019-07-07 02:30:00;NORTE;4;0;4;1
2019-07-07 03:00:00;NORTE;2;0;2;1
2019-07-07 03:30:00;NORTE;6;0;6;1
2019-07-07 04:00:00;NORTE;9;0;9;1
2019-07-07 04:30:00;NORTE;16;0;16;1
2019-07-07 05:00:00;NORTE;17;0;17;1
2019-07-07 05:30:00;NORTE;30;0;30;1
2019-07-07 06:00:00;NORTE;23;0;23;1
2019-07-07 06:30:00;NORTE;26;0;26;1
2019-07-07 07:00:00;NORTE;28;0;28;1
2019-07-07 07:30:00;CONFLICTIVA;18;3;21;2
2019-07-07 08:00:00;SUR;0;36;36;1
2019-07-07 08:30:00;SUR;0;38;38;1
2019-07-07 09:00:00;SUR;0;22;22;1
2019-07-07 09:30:00;SUR;0;29;29;1
2019-07-07 10:00:00;SUR;0;34;34;1
2019-07-07 10:30:00;SUR;0;33;33;1
2019-07-07 11:00:00;SUR;0;30;30;1
2019-07-07 11:30:00;SUR;0;32;32;1
2019-07-07 12:00:00;SUR;0;31;31;1
2019-07-07 12:30:00;SUR;0;33;33;1
2019-07-07 13:00:00;SUR;0;47;47;1
2019-07-07 13:30:00;SUR;0;27;27;1
2019-07-07 14:00:00;SUR;0;41;41;1
2019-07-07 14:30:00;SUR;0;47;47;1
2019-07-07 15:00:00;SUR;0;31;31;1
2019-07-07 15:30:00;SUR;0;41;41;1
2019-07-07 16:00:00;SUR;0;18;18;1
2019-07-07 16:30:00;SUR;0;32;32;1
2019-07-07 17:00:00;SUR;0;20;20;1
2019-07-07 17:30:00;SUR;0;27;27;1
2019-07-07 18:00:00;SUR;0;39;39;1
2019-07-07 18:30:00;SUR;0;32;32;1
2019-07-07 19:00:00;SUR;0;30;30;1
2019-07-07 19:30:00;NORTE;30;0;30;1
2019-07-07 20:00:00;NORTE;36;0;36;1
2019-07-07 20:30:00;NORTE;29;0;29;1
2019-07-07 21:00:00;NORTE;20;0;20;1
2019-07-07 21:30:00;NORTE;29;0;29;1
2019-07-07 22:00:00;NORTE;21;0;21;1
2019-07-07 22:30:00;NORTE;19;0;19;1
2019-07-07 23:00:00;NORTE;6;0;6;1
2019-07-07 23:30:00;NORTE;3;0;3;1
2019-07-08 00:00:00;NORTE;3;0;3;1
2019-07-08 00:30:00;NORTE;2;0;2;1
2019-07-08 01:00:00;NORTE;1;0;1;1
2019-07-08 01:30:00;NORTE;2;0;2;1
2019-07-08 02:00:00;NORTE;4;0;4;1
2019-07-08 02:30:00;CONFLICTIVA;4;2;6;2
2019-07-08 03:00:00;SUR;0;4;4;1
2019-07-08 03:30:00;SUR;0;2;2;1
2019-07-08 04:00:00;SUR;0;13;13;1
2019-07-08 04:30:00;SUR;0;15;15;1
2019-07-08 05:00:00;SUR;0;26;26;1
2019-07-08 05:30:00;SUR;0;35;35;1
2019-07-08 06:00:00;SUR;0;30;30;1
2019-07-08 06:30:00;SUR;0;26;26;1
2019-07-08 07:00:00;SUR;0;31;31;1
2019-07-08 07:30:00;SUR;0;38;38;1
2019-07-08 08:00:00;SUR;0;36;36;1
2019-07-08 08:30:00;SUR;0;40;40;1
2019-07-08 09:00:00;SUR;0;35;35;1
2019-07-08 09:30:00;SUR;0;38;38;1
2019-07-08 10:00:00;SUR;0;28;28;1
2019-07-08 10:30:00;SUR;0;40;40;1
2019-07-08 11:00:00;SUR;0;21;21;1
2019-07-08 12:00:00;SUR;0;24;24;1
2019-07-08 12:30:00;SUR;0;30;30;1
2019-07-08 13:00:00;SUR;0;38;38;1
2019-07-08 13:30:00;SUR;0;48;48;1
2019-07-08 14:00:00;SUR;0;43;43;1
2019-07-08 14:30:00;SUR;0;32;32;1
2019-07-08 15:00:00;SUR;0;31;31;1
2019-07-08 15:30:00;SUR;0;34;34;1
2019-07-08 16:00:00;SUR;0;21;21;1
2019-07-08 16:30:00;SUR;0;29;29;1
2019-07-08 17:00:00;SUR;0;27;27;1
2019-07-08 17:30:00;SUR;0;27;27;1
2019-07-08 18:00:00;SUR;0;35;35;1
2019-07-08 18:30:00;SUR;0;22;22;1
2019-07-08 19:00:00;CONFLICTIVA;7;12;19;2
2019-07-08 19:30:00;NORTE;34;0;34;1
2019-07-08 20:00:00;NORTE;29;0;29;1
2019-07-08 20:30:00;NORTE;25;0;25;1
2019-07-08 21:00:00;NORTE;27;0;27;1
2019-07-08 21:30:00;NORTE;27;0;27;1
2019-07-08 22:00:00;NORTE;28;0;28;1
2019-07-08 22:30:00;NORTE;23;0;23;1
2019-07-08 23:00:00;NORTE;9;0;9;1
2019-07-08 23:30:00;NORTE;4;0;4;1
2019-07-09 00:00:00;NORTE;1;0;1;1
2019-07-09 00:30:00;NORTE;3;0;3;1
2019-07-09 01:00:00;NORTE;3;0;3;1
2019-07-09 01:30:00;NORTE;2;0;2;1
2019-07-09 02:00:00;NORTE;4;0;4;1
2019-07-09 02:30:00;NORTE;7;0;7;1
2019-07-09 03:00:00;NORTE;5;0;5;1
2019-07-09 03:30:00;NORTE;9;0;9;1
2019-07-09 04:00:00;NORTE;11;0;11;1
2019-07-09 04:30:00;NORTE;20;0;20;1
2019-07-09 05:00:00;NORTE;21;0;21;1
2019-07-09 05:30:00;NORTE;45;0;45;1
2019-07-09 06:00:00;NORTE;23;0;23;1
2019-07-09 06:30:00;NORTE;26;0;26;1
2019-07-09 07:00:00;NORTE;37;0;37;1
2019-07-09 07:30:00;NORTE;36;0;36;1
2019-07-09 08:00:00;NORTE;40;0;40;1
2019-07-09 08:30:00;NORTE;38;0;38;1
2019-07-09 09:00:00;NORTE;26;0;26;1
2019-07-09 09:30:00;NORTE;37;0;37;1
2019-07-09 10:00:00;NORTE;38;0;38;1
2019-07-09 10:30:00;NORTE;40;0;40;1
2019-07-09 11:00:00;NORTE;33;0;33;1
2019-07-09 11:30:00;NORTE;34;0;34;1
2019-07-09 12:00:00;NORTE;26;0;26;1
2019-07-09 12:30:00;NORTE;38;0;38;1
2019-07-09 13:00:00;NORTE;40;0;40;1
2019-07-09 13:30:00;NORTE;36;0;36;1
2019-07-09 14:00:00;NORTE;33;0;33;1
2019-07-09 14:30:00;NORTE;37;0;37;1
2019-07-09 15:00:00;NORTE;32;0;32;1
2019-07-09 15:30:00;NORTE;35;0;35;1
2019-07-09 16:00:00;NORTE;22;0;22;1
2019-07-09 16:30:00;NORTE;31;0;31;1
2019-07-09 17:00:00;NORTE;33;0;33;1
2019-07-09 17:30:00;NORTE;32;0;32;1
2019-07-09 18:00:00;NORTE;32;0;32;1
2019-07-09 18:30:00;NORTE;34;0;34;1
2019-07-09 19:00:00;NORTE;34;0;34;1
2019-07-09 19:30:00;NORTE;33;0;33;1
2019-07-09 20:00:00;NORTE;38;0;38;1
2019-07-09 20:30:00;NORTE;29;0;29;1
2019-07-09 21:00:00;NORTE;16;0;16;1
2019-07-09 21:30:00;NORTE;21;0;21;1
2019-07-09 22:00:00;NORTE;14;0;14;1
2019-07-09 22:30:00;CONFLICTIVA;9;1;10;2
2019-07-09 23:00:00;NORTE;2;0;2;1
2019-07-09 23:30:00;NORTE;2;0;2;1
2019-07-10 00:00:00;NORTE;3;0;3;1
2019-07-10 01:00:00;NORTE;3;0;3;1
2019-07-10 01:30:00;NORTE;3;0;3;1
2019-07-10 02:30:00;NORTE;5;0;5;1
2019-07-10 03:00:00;NORTE;4;0;4;1
2019-07-10 03:30:00;NORTE;9;0;9;1
2019-07-10 04:00:00;NORTE;16;0;16;1
2019-07-10 04:30:00;NORTE;10;0;10;1
2019-07-10 05:00:00;NORTE;25;0;25;1
2019-07-10 05:30:00;NORTE;39;0;39;1
2019-07-10 06:00:00;NORTE;33;0;33;1
2019-07-10 06:30:00;NORTE;30;0;30;1
2019-07-10 07:00:00;NORTE;43;0;43;1
2019-07-10 07:30:00;NORTE;31;0;31;1
2019-07-10 08:00:00;NORTE;36;1;37;1
2019-07-10 08:30:00;NORTE;36;0;36;1
2019-07-10 09:00:00;NORTE;5;0;5;1
2019-07-10 09:30:00;NORTE;22;0;22;1
2019-07-10 10:00:00;NORTE;36;0;36;1
2019-07-10 10:30:00;NORTE;33;0;33;1
2019-07-10 11:00:00;NORTE;34;0;34;1
2019-07-10 11:30:00;NORTE;35;0;35;1
2019-07-10 12:00:00;NORTE;31;0;31;1
2019-07-10 12:30:00;NORTE;31;0;31;1
2019-07-10 13:00:00;NORTE;38;0;38;1
2019-07-10 13:30:00;NORTE;31;0;31;1
2019-07-10 14:00:00;NORTE;46;0;46;1
2019-07-10 14:30:00;NORTE;39;0;39;1
2019-07-10 15:00:00;NORTE;37;0;37;1
2019-07-10 15:30:00;NORTE;25;0;25;1
2019-07-10 16:00:00;NORTE;22;0;22;1
2019-07-10 16:30:00;NORTE;34;0;34;1
2019-07-10 17:00:00;NORTE;29;0;29;1
2019-07-10 17:30:00;NORTE;31;0;31;1
2019-07-10 18:00:00;NORTE;37;0;37;1
2019-07-10 18:30:00;NORTE;32;0;32;1
2019-07-10 19:00:00;NORTE;33;0;33;1
2019-07-10 19:30:00;NORTE;33;0;33;1
2019-07-10 20:00:00;NORTE;38;0;38;1
2019-07-10 20:30:00;NORTE;29;0;29;1
2019-07-10 21:00:00;NORTE;17;0;17;1
2019-07-10 21:30:00;NORTE;21;0;21;1
2019-07-10 22:00:00;NORTE;8;0;8;1
2019-07-10 22:30:00;NORTE;15;0;15;1
2019-07-11 00:00:00;NORTE;3;0;3;1
2019-07-11 00:30:00;NORTE;1;0;1;1
2019-07-11 01:00:00;NORTE;2;0;2;1
2019-07-11 01:30:00;NORTE;2;0;2;1
2019-07-11 02:00:00;NORTE;2;0;2;1
2019-07-11 02:30:00;NORTE;2;0;2;1
2019-07-11 03:00:00;NORTE;5;0;5;1
2019-07-11 03:30:00;NORTE;9;0;9;1
2019-07-11 04:00:00;NORTE;15;0;15;1
2019-07-11 04:30:00;NORTE;16;0;16;1
2019-07-11 05:00:00;NORTE;21;0;21;1
2019-07-11 05:30:00;NORTE;38;0;38;1
2019-07-11 06:00:00;NORTE;30;0;30;1
2019-07-11 06:30:00;NORTE;31;0;31;1
2019-07-11 07:00:00;NORTE;37;0;37;1
2019-07-11 07:30:00;NORTE;33;0;33;1
2019-07-11 08:00:00;NORTE;35;0;35;1
2019-07-11 08:30:00;NORTE;37;0;37;1
2019-07-11 09:00:00;NORTE;31;0;31;1
2019-07-11 09:30:00;NORTE;38;0;38;1
2019-07-11 10:00:00;NORTE;36;0;36;1
2019-07-11 10:30:00;NORTE;36;0;36;1
2019-07-11 11:00:00;NORTE;35;0;35;1
2019-07-11 11:30:00;NORTE;33;0;33;1
2019-07-11 12:00:00;NORTE;28;0;28;1
2019-07-11 12:30:00;NORTE;35;0;35;1
2019-07-11 13:00:00;NORTE;39;0;39;1
2019-07-11 13:30:00;NORTE;43;0;43;1
2019-07-11 14:00:00;NORTE;46;0;46;1
2019-07-11 14:30:00;NORTE;32;0;32;1
2019-07-11 15:00:00;NORTE;42;0;42;1
2019-07-11 15:30:00;NORTE;26;0;26;1
2019-07-11 16:00:00;NORTE;18;0;18;1
2019-07-11 16:30:00;NORTE;33;0;33;1
2019-07-11 17:00:00;NORTE;24;0;24;1
2019-07-11 17:30:00;NORTE;33;0;33;1
2019-07-11 18:00:00;NORTE;38;0;38;1
2019-07-11 18:30:00;NORTE;36;0;36;1
2019-07-11 19:00:00;NORTE;31;0;31;1
2019-07-11 19:30:00;NORTE;35;0;35;1
2019-07-11 20:00:00;NORTE;41;0;41;1
2019-07-11 20:30:00;NORTE;29;0;29;1
2019-07-11 21:00:00;NORTE;18;0;18;1
2019-07-11 21:30:00;NORTE;23;0;23;1
2019-07-11 22:00:00;NORTE;16;0;16;1
2019-07-11 22:30:00;NORTE;9;0;9;1
2019-07-11 23:00:00;NORTE;3;0;3;1
2019-07-11 23:30:00;NORTE;2;0;2;1
2019-07-12 00:00:00;NORTE;2;0;2;1
2019-07-12 01:00:00;NORTE;1;0;1;1
2019-07-12 01:30:00;NORTE;1;0;1;1
2019-07-12 02:00:00;NORTE;6;0;6;1
2019-07-12 02:30:00;NORTE;4;0;4;1
2019-07-12 03:00:00;NORTE;5;0;5;1
2019-07-12 03:30:00;NORTE;8;0;8;1
2019-07-12 04:00:00;NORTE;18;0;18;1
2019-07-12 04:30:00;NORTE;11;0;11;1
2019-07-12 05:00:00;NORTE;23;0;23;1
2019-07-12 05:30:00;NORTE;42;0;42;1
2019-07-12 06:00:00;NORTE;27;0;27;1
2019-07-12 06:30:00;NORTE;25;0;25;1
2019-07-12 07:00:00;NORTE;42;0;42;1
2019-07-12 07:30:00;NORTE;24;0;24;1
2019-07-12 08:00:00;NORTE;33;0;33;1
2019-07-12 08:30:00;NORTE;47;0;47;1
2019-07-12 09:00:00;NORTE;21;0;21;1
2019-07-12 09:30:00;NORTE;26;0;26;1
2019-07-12 10:00:00;NORTE;45;0;45;1
2019-07-12 10:30:00;NORTE;39;0;39;1
2019-07-12 11:00:00;NORTE;37;0;37;1
2019-07-12 11:30:00;NORTE;25;0;25;1
2019-07-12 12:00:00;NORTE;28;0;28;1
2019-07-12 12:30:00;NORTE;39;0;39;1
2019-07-12 13:00:00;NORTE;38;0;38;1
2019-07-12 13:30:00;CONFLICTIVA;22;10;32;2
2019-07-12 14:00:00;SUR;0;45;45;1
2019-07-12 14:30:00;SUR;0;39;39;1
2019-07-12 15:00:00;SUR;0;38;38;1
2019-07-12 15:30:00;SUR;0;25;25;1
2019-07-12 16:00:00;SUR;0;24;24;1
2019-07-12 16:30:00;SUR;0;30;30;1
2019-07-12 17:00:00;CONFLICTIVA;11;14;25;2
2019-07-12 17:30:00;NORTE;35;0;35;1
2019-07-12 18:00:00;NORTE;32;0;32;1
2019-07-12 18:30:00;NORTE;34;0;34;1
2019-07-12 19:00:00;NORTE;37;0;37;1
2019-07-12 19:30:00;NORTE;23;0;23;1
2019-07-12 20:00:00;NORTE;35;0;35;1
2019-07-12 20:30:00;NORTE;26;0;26;1
2019-07-12 21:00:00;NORTE;19;0;19;1
2019-07-12 21:30:00;NORTE;20;0;20;1
2019-07-12 22:00:00;NORTE;15;0;15;1
2019-07-12 22:30:00;NORTE;12;0;12;1
2019-07-12 23:00:00;NORTE;5;0;5;1
2019-07-12 23:30:00;NORTE;1;0;1;1
2019-07-13 00:00:00;NORTE;1;0;1;1
2019-07-13 00:30:00;NORTE;2;0;2;1
2019-07-13 01:30:00;NORTE;1;0;1;1
2019-07-13 02:00:00;NORTE;5;0;5;1
2019-07-13 02:30:00;NORTE;6;0;6;1
2019-07-13 03:00:00;NORTE;3;0;3;1
2019-07-13 03:30:00;NORTE;6;0;6;1
2019-07-13 04:00:00;NORTE;17;0;17;1
2019-07-13 04:30:00;NORTE;14;0;14;1
2019-07-13 05:00:00;NORTE;15;0;15;1
2019-07-13 05:20:00;NORTE;10;0;10;1
2019-07-13 05:30:00;NORTE;32;0;32;1
2019-07-13 06:00:00;NORTE;23;0;23;1
2019-07-13 06:30:00;NORTE;25;0;25;1
2019-07-13 07:00:00;NORTE;35;0;35;1
2019-07-13 07:30:00;NORTE;33;0;33;1
2019-07-13 08:00:00;NORTE;33;0;33;1
2019-07-13 08:30:00;NORTE;35;1;36;1
2019-07-13 09:00:00;NORTE;31;0;31;1
2019-07-13 09:30:00;NORTE;31;0;31;1
2019-07-13 10:00:00;NORTE;37;0;37;1
2019-07-13 10:30:00;NORTE;34;0;34;1
2019-07-13 11:00:00;NORTE;33;0;33;1
2019-07-13 11:30:00;NORTE;26;0;26;1
2019-07-13 12:00:00;NORTE;25;0;25;1
2019-07-13 12:30:00;SUR;1;23;24;1
2019-07-13 13:00:00;SUR;0;37;37;1
2019-07-13 13:30:00;SUR;0;36;36;1
2019-07-13 14:00:00;SUR;0;33;33;1
2019-07-13 14:30:00;SUR;0;37;37;1
2019-07-13 15:00:00;SUR;0;28;28;1
2019-07-13 15:30:00;SUR;0;30;30;1
2019-07-13 16:00:00;SUR;0;20;20;1
2019-07-13 16:30:00;SUR;0;25;25;1
2019-07-13 17:00:00;SUR;0;22;22;1
2019-07-13 17:30:00;SUR;0;25;25;1
2019-07-13 18:00:00;SUR;0;33;33;1
2019-07-13 18:30:00;SUR;0;29;29;1
2019-07-13 19:00:00;SUR;0;24;24;1
2019-07-13 19:30:00;CONFLICTIVA;14;9;23;2
2019-07-13 20:00:00;NORTE;25;0;25;1
2019-07-13 20:30:00;NORTE;25;0;25;1
2019-07-13 21:00:00;NORTE;19;0;19;1
2019-07-13 21:30:00;NORTE;21;0;21;1
2019-07-13 22:00:00;NORTE;15;0;15;1
2019-07-13 22:30:00;NORTE;13;0;13;1
2019-07-13 23:00:00;NORTE;3;0;3;1
2019-07-13 23:30:00;NORTE;2;0;2;1
2019-07-14 00:00:00;NORTE;4;0;4;1
2019-07-14 00:30:00;NORTE;2;0;2;1
2019-07-14 01:00:00;NORTE;2;0;2;1
2019-07-14 01:30:00;NORTE;1;0;1;1
2019-07-14 02:00:00;NORTE;3;0;3;1
2019-07-14 02:30:00;NORTE;2;0;2;1
2019-07-14 03:00:00;NORTE;2;0;2;1
2019-07-14 03:30:00;NORTE;8;0;8;1
2019-07-14 04:00:00;NORTE;14;0;14;1
2019-07-14 04:30:00;NORTE;11;0;11;1
2019-07-14 05:00:00;NORTE;17;0;17;1
2019-07-14 05:30:00;NORTE;30;0;30;1
2019-07-14 06:00:00;NORTE;24;0;24;1
2019-07-14 06:30:00;NORTE;26;0;26;1
2019-07-14 07:00:00;NORTE;39;0;39;1
2019-07-14 07:30:00;NORTE;27;0;27;1
2019-07-14 08:00:00;NORTE;34;0;34;1
2019-07-14 08:30:00;NORTE;38;0;38;1
2019-07-14 09:00:00;NORTE;29;1;30;1
2019-07-14 09:30:00;NORTE;29;0;29;1
2019-07-14 10:00:00;NORTE;41;0;41;1
2019-07-14 10:30:00;NORTE;29;0;29;1
2019-07-14 11:00:00;NORTE;29;0;29;1
2019-07-14 11:30:00;NORTE;25;0;25;1
2019-07-14 12:00:00;NORTE;30;0;30;1
2019-07-14 12:30:00;NORTE;36;0;36;1
2019-07-14 13:00:00;NORTE;43;0;43;1
2019-07-14 13:30:00;NORTE;38;0;38;1
2019-07-14 14:00:00;NORTE;40;0;40;1
2019-07-14 14:30:00;NORTE;43;0;43;1
2019-07-14 15:00:00;NORTE;32;0;32;1
2019-07-14 15:30:00;NORTE;29;0;29;1
2019-07-14 16:00:00;NORTE;27;0;27;1
2019-07-14 16:30:00;NORTE;27;0;27;1
2019-07-14 17:00:00;NORTE;31;0;31;1
2019-07-14 17:30:00;NORTE;30;0;30;1
2019-07-14 18:00:00;NORTE;36;0;36;1
2019-07-14 18:30:00;NORTE;34;0;34;1
2019-07-14 19:00:00;NORTE;32;0;32;1
2019-07-14 19:30:00;NORTE;31;0;31;1
2019-07-14 20:00:00;NORTE;37;0;37;1
2019-07-14 20:30:00;NORTE;30;0;30;1
2019-07-14 21:00:00;NORTE;21;0;21;1
2019-07-14 21:30:00;NORTE;16;0;16;1
2019-07-14 22:00:00;NORTE;19;0;19;1
2019-07-14 22:30:00;NORTE;14;0;14;1
2019-07-14 23:00:00;NORTE;3;0;3;1
2019-07-14 23:30:00;NORTE;2;0;2;1
2019-07-15 00:00:00;NORTE;2;0;2;1
2019-07-15 00:30:00;NORTE;1;0;1;1
2019-07-15 01:00:00;NORTE;1;0;1;1
2019-07-15 01:30:00;NORTE;2;0;2;1
2019-07-15 02:00:00;NORTE;7;0;7;1
2019-07-15 02:30:00;NORTE;6;0;6;1
2019-07-15 03:00:00;NORTE;3;0;3;1
2019-07-15 03:30:00;NORTE;5;0;5;1
2019-07-15 04:00:00;NORTE;14;0;14;1
2019-07-15 04:30:00;NORTE;9;0;9;1
2019-07-15 05:00:00;NORTE;27;0;27;1
2019-07-15 05:30:00;NORTE;43;0;43;1
2019-07-15 06:00:00;NORTE;25;0;25;1
2019-07-15 06:30:00;NORTE;34;0;34;1
2019-07-15 07:00:00;NORTE;35;0;35;1
2019-07-15 07:30:00;NORTE;24;0;24;1
2019-07-15 08:00:00;NORTE;40;0;40;1
2019-07-15 08:30:00;NORTE;33;0;33;1
2019-07-15 09:00:00;NORTE;34;0;34;1
2019-07-15 09:30:00;NORTE;39;0;39;1
2019-07-15 10:00:00;NORTE;42;0;42;1
2019-07-15 10:30:00;NORTE;34;0;34;1
2019-07-15 11:00:00;NORTE;35;0;35;1
2019-07-15 11:30:00;NORTE;35;0;35;1
2019-07-15 12:00:00;NORTE;31;0;31;1
2019-07-15 12:30:00;NORTE;31;0;31;1
2019-07-15 13:00:00;NORTE;39;0;39;1
2019-07-15 13:30:00;NORTE;41;0;41;1
2019-07-15 14:00:00;NORTE;38;0;38;1
2019-07-15 14:30:00;NORTE;38;0;38;1
2019-07-15 15:00:00;NORTE;33;0;33;1
2019-07-15 15:30:00;NORTE;31;0;31;1
2019-07-15 16:00:00;NORTE;18;0;18;1
2019-07-15 16:30:00;NORTE;35;0;35;1
2019-07-15 17:00:00;NORTE;33;0;33;1
2019-07-15 17:30:00;NORTE;29;0;29;1
2019-07-15 18:00:00;NORTE;32;0;32;1
2019-07-15 18:30:00;NORTE;38;0;38;1
2019-07-15 19:00:00;NORTE;21;0;21;1
2019-07-15 19:30:00;NORTE;35;0;35;1
2019-07-15 20:00:00;NORTE;37;0;37;1
2019-07-15 20:30:00;NORTE;28;0;28;1
2019-07-15 21:00:00;NORTE;19;0;19;1
2019-07-15 21:30:00;NORTE;14;0;14;1
2019-07-15 22:00:00;NORTE;17;0;17;1
2019-07-15 22:30:00;NORTE;9;0;9;1
2019-07-15 23:00:00;NORTE;4;0;4;1
2019-07-15 23:30:00;NORTE;2;0;2;1
2019-07-16 00:00:00;NORTE;2;0;2;1
2019-07-16 00:30:00;NORTE;1;0;1;1
2019-07-16 01:00:00;NORTE;1;0;1;1
2019-07-16 01:30:00;NORTE;1;0;1;1
2019-07-16 02:00:00;NORTE;5;0;5;1
2019-07-16 02:30:00;NORTE;7;0;7;1
2019-07-16 03:00:00;NORTE;4;0;4;1
2019-07-16 03:30:00;NORTE;13;0;13;1
2019-07-16 04:00:00;NORTE;10;0;10;1
2019-07-16 04:30:00;NORTE;15;0;15;1
2019-07-16 05:00:00;NORTE;28;0;28;1
2019-07-16 05:30:00;NORTE;44;0;44;1
2019-07-16 06:00:00;NORTE;25;0;25;1
2019-07-16 06:30:00;NORTE;29;1;30;1
2019-07-16 07:00:00;NORTE;40;0;40;1
2019-07-16 07:30:00;NORTE;35;0;35;1
2019-07-16 08:00:00;NORTE;37;0;37;1
2019-07-16 08:30:00;NORTE;39;0;39;1
2019-07-16 09:00:00;NORTE;29;0;29;1
2019-07-16 09:30:00;NORTE;35;0;35;1
2019-07-16 10:00:00;NORTE;34;0;34;1
2019-07-16 10:30:00;NORTE;28;0;28;1
2019-07-16 11:00:00;NORTE;34;0;34;1
2019-07-16 11:30:00;NORTE;33;0;33;1
2019-07-16 12:00:00;NORTE;21;0;21;1
2019-07-16 12:30:00;NORTE;39;0;39;1
2019-07-16 13:00:00;NORTE;37;0;37;1
2019-07-16 13:30:00;CONFLICTIVA;15;10;25;2
2019-07-16 14:00:00;SUR;0;39;39;1
2019-07-16 14:30:00;SUR;0;49;49;1
2019-07-16 15:00:00;SUR;0;31;31;1
2019-07-16 15:30:00;SUR;0;26;26;1
2019-07-16 16:00:00;SUR;0;19;19;1
2019-07-16 16:30:00;SUR;0;34;34;1
2019-07-16 17:00:00;SUR;0;30;30;1
2019-07-16 17:30:00;SUR;0;27;27;1
2019-07-16 18:00:00;SUR;0;42;42;1
2019-07-16 18:30:00;SUR;0;28;28;1
2019-07-16 19:00:00;SUR;0;28;28;1
2019-07-16 19:30:00;SUR;0;34;34;1
2019-07-16 20:00:00;SUR;0;35;35;1
2019-07-16 20:30:00;SUR;1;18;19;1
2019-07-16 21:00:00;NORTE;18;0;18;1
2019-07-16 21:30:00;NORTE;25;0;25;1
2019-07-16 22:00:00;NORTE;24;0;24;1
2019-07-16 22:30:00;NORTE;10;1;11;1
2019-07-16 23:00:00;CONFLICTIVA;1;2;3;2
2019-07-16 23:30:00;SUR;0;2;2;1
2019-07-17 00:00:00;SUR;0;1;1;1
2019-07-17 00:30:00;SUR;0;1;1;1
2019-07-17 01:00:00;SUR;0;1;1;1
2019-07-17 01:30:00;SUR;0;1;1;1
2019-07-17 02:00:00;SUR;0;2;2;1
2019-07-17 02:30:00;SUR;0;5;5;1
2019-07-17 03:00:00;SUR;0;4;4;1
2019-07-17 03:30:00;SUR;0;8;8;1
2019-07-17 04:00:00;SUR;0;18;18;1
2019-07-17 04:30:00;SUR;0;13;13;1
2019-07-17 05:00:00;SUR;0;19;19;1
2019-07-17 05:30:00;SUR;0;43;43;1
2019-07-17 06:00:00;NORTE;26;0;26;1
2019-07-17 06:30:00;NORTE;29;0;29;1
2019-07-17 07:00:00;NORTE;41;1;42;1
2019-07-17 07:30:00;NORTE;30;0;30;1
2019-07-17 08:00:00;NORTE;37;0;37;1
2019-07-17 08:30:00;NORTE;37;0;37;1
2019-07-17 09:00:00;NORTE;33;0;33;1
2019-07-17 09:30:00;NORTE;26;0;26;1
2019-07-17 10:00:00;NORTE;44;0;44;1
2019-07-17 10:30:00;NORTE;36;0;36;1
2019-07-17 11:00:00;NORTE;34;0;34;1
2019-07-17 11:30:00;NORTE;31;0;31;1
2019-07-17 12:00:00;NORTE;24;0;24;1
2019-07-17 12:30:00;NORTE;37;0;37;1
2019-07-17 13:00:00;CONFLICTIVA;20;11;31;2
2019-07-17 13:30:00;SUR;0;37;37;1
2019-07-17 14:00:00;SUR;0;39;39;1
2019-07-17 14:30:00;SUR;0;33;33;1
2019-07-17 15:00:00;SUR;0;38;38;1
2019-07-17 15:30:00;SUR;0;29;29;1
2019-07-17 16:00:00;SUR;0;20;20;1
2019-07-17 16:30:00;SUR;0;30;30;1
2019-07-17 17:00:00;SUR;0;26;26;1
2019-07-17 17:30:00;CONFLICTIVA;14;15;29;2
2019-07-17 18:00:00;NORTE;41;0;41;1
2019-07-17 18:30:00;NORTE;31;0;31;1
2019-07-17 19:00:00;NORTE;33;0;33;1
2019-07-17 19:30:00;NORTE;33;0;33;1
2019-07-17 20:00:00;NORTE;36;0;36;1
2019-07-17 20:30:00;NORTE;33;0;33;1
2019-07-17 21:00:00;NORTE;18;0;18;1
2019-07-17 21:30:00;NORTE;17;0;17;1
2019-07-17 22:00:00;NORTE;21;0;21;1
2019-07-17 22:30:00;NORTE;8;0;8;1
2019-07-17 23:00:00;NORTE;4;0;4;1
2019-07-17 23:30:00;NORTE;1;0;1;1
2019-07-18 00:00:00;NORTE;1;0;1;1
2019-07-18 01:00:00;NORTE;3;0;3;1
2019-07-18 02:00:00;NORTE;4;0;4;1
2019-07-18 02:30:00;NORTE;4;0;4;1
2019-07-18 03:00:00;NORTE;2;0;2;1
2019-07-18 03:30:00;NORTE;12;0;12;1
2019-07-18 04:00:00;NORTE;14;0;14;1
2019-07-18 04:30:00;NORTE;14;0;14;1
2019-07-18 05:00:00;NORTE;25;0;25;1
2019-07-18 05:30:00;NORTE;40;0;40;1
2019-07-18 06:00:00;NORTE;27;0;27;1
2019-07-18 06:30:00;NORTE;30;0;30;1
2019-07-18 07:00:00;NORTE;35;0;35;1
2019-07-18 07:30:00;NORTE;37;0;37;1
2019-07-18 08:00:00;NORTE;39;0;39;1
2019-07-18 08:30:00;NORTE;33;0;33;1
2019-07-18 09:00:00;NORTE;26;0;26;1
2019-07-18 09:30:00;NORTE;42;0;42;1
2019-07-18 10:00:00;NORTE;31;0;31;1
2019-07-18 10:30:00;NORTE;38;0;38;1
2019-07-18 11:00:00;NORTE;29;0;29;1
2019-07-18 11:30:00;NORTE;32;0;32;1
2019-07-18 12:00:00;NORTE;34;0;34;1
2019-07-18 12:30:00;NORTE;30;0;30;1
2019-07-18 13:00:00;NORTE;43;0;43;1
2019-07-18 13:30:00;NORTE;38;0;38;1
2019-07-18 14:00:00;NORTE;39;0;39;1
2019-07-18 14:30:00;NORTE;44;0;44;1
2019-07-18 15:00:00;NORTE;34;0;34;1
2019-07-18 15:30:00;NORTE;29;0;29;1
2019-07-18 16:00:00;NORTE;17;0;17;1
2019-07-18 16:30:00;NORTE;33;0;33;1
2019-07-18 17:00:00;NORTE;23;0;23;1
2019-07-18 17:30:00;NORTE;28;0;28;1
2019-07-18 18:00:00;NORTE;39;0;39;1
2019-07-18 18:30:00;NORTE;30;0;30;1
2019-07-18 19:00:00;NORTE;34;0;34;1
2019-07-18 19:30:00;NORTE;27;0;27;1
2019-07-18 20:00:00;NORTE;37;0;37;1
2019-07-18 20:30:00;NORTE;36;0;36;1
2019-07-18 21:00:00;NORTE;16;0;16;1
2019-07-18 21:30:00;NORTE;21;0;21;1
2019-07-18 22:00:00;NORTE;16;0;16;1
2019-07-18 22:30:00;NORTE;18;0;18;1
2019-07-18 23:00:00;NORTE;6;0;6;1
2019-07-18 23:30:00;NORTE;1;0;1;1
2019-07-19 00:00:00;NORTE;2;0;2;1
2019-07-19 00:30:00;NORTE;1;0;1;1
2019-07-19 01:00:00;NORTE;1;0;1;1
2019-07-19 01:30:00;NORTE;1;0;1;1
2019-07-19 02:00:00;NORTE;4;0;4;1
2019-07-19 02:30:00;NORTE;4;0;4;1
2019-07-19 03:00:00;NORTE;4;0;4;1
2019-07-19 03:30:00;NORTE;7;0;7;1
2019-07-19 04:00:00;NORTE;18;0;18;1
2019-07-19 04:30:00;NORTE;9;0;9;1
2019-07-19 05:00:00;NORTE;26;0;26;1
2019-07-19 05:30:00;NORTE;42;0;42;1
2019-07-19 06:00:00;NORTE;29;0;29;1
2019-07-19 06:30:00;NORTE;30;0;30;1
2019-07-19 07:00:00;NORTE;37;0;37;1
2019-07-19 07:30:00;NORTE;32;0;32;1
2019-07-19 08:00:00;NORTE;36;0;36;1
2019-07-19 08:30:00;NORTE;37;0;37;1
2019-07-19 09:00:00;NORTE;29;0;29;1
2019-07-19 09:30:00;NORTE;37;0;37;1
2019-07-19 10:00:00;NORTE;34;0;34;1
2019-07-19 10:30:00;NORTE;33;0;33;1
2019-07-19 11:00:00;NORTE;35;0;35;1
2019-07-19 11:30:00;NORTE;33;0;33;1
2019-07-19 12:00:00;NORTE;31;0;31;1
2019-07-19 12:30:00;CONFLICTIVA;9;19;28;2
2019-07-19 13:00:00;SUR;0;43;43;1
2019-07-19 13:30:00;SUR;0;39;39;1
2019-07-19 14:00:00;SUR;1;41;42;1
2019-07-19 14:30:00;SUR;0;35;35;1
2019-07-19 15:00:00;SUR;0;34;34;1
2019-07-19 15:30:00;SUR;0;30;30;1
2019-07-19 16:00:00;SUR;0;20;20;1
2019-07-19 16:30:00;SUR;0;35;35;1
2019-07-19 17:00:00;SUR;0;23;23;1
2019-07-19 17:30:00;SUR;0;34;34;1
2019-07-19 18:00:00;SUR;0;34;34;1
2019-07-19 18:30:00;SUR;0;30;30;1
2019-07-19 19:00:00;SUR;0;36;36;1
2019-07-19 19:30:00;SUR;0;28;28;1
2019-07-19 20:00:00;SUR;0;32;32;1
2019-07-19 20:30:00;SUR;0;30;30;1
2019-07-19 21:00:00;SUR;0;23;23;1
2019-07-19 21:30:00;SUR;0;20;20;1
2019-07-19 22:00:00;SUR;0;16;16;1
2019-07-19 22:30:00;SUR;0;11;11;1
2019-07-19 23:00:00;SUR;0;1;1;1
2019-07-19 23:30:00;SUR;0;1;1;1
2019-07-20 00:00:00;SUR;0;2;2;1
2019-07-20 00:30:00;SUR;0;3;3;1
2019-07-20 01:30:00;SUR;0;1;1;1
2019-07-20 02:00:00;NORTE;5;0;5;1
2019-07-20 02:30:00;NORTE;6;0;6;1
2019-07-20 03:00:00;NORTE;1;0;1;1
2019-07-20 03:30:00;NORTE;4;0;4;1
2019-07-20 04:00:00;NORTE;19;0;19;1
2019-07-20 04:30:00;NORTE;10;0;10;1
2019-07-20 05:00:00;NORTE;31;0;31;1
2019-07-20 05:30:00;NORTE;32;0;32;1
2019-07-20 06:00:00;NORTE;24;0;24;1
2019-07-20 06:30:00;NORTE;23;0;23;1
2019-07-20 07:00:00;NORTE;42;0;42;1
2019-07-20 07:30:00;NORTE;30;0;30;1
2019-07-20 08:00:00;NORTE;31;0;31;1
2019-07-20 08:30:00;NORTE;40;0;40;1
2019-07-20 09:00:00;NORTE;23;0;23;1
2019-07-20 09:30:00;NORTE;35;0;35;1
2019-07-20 10:00:00;NORTE;27;0;27;1
2019-07-20 10:30:00;NORTE;38;0;38;1
2019-07-20 11:00:00;NORTE;32;0;32;1
2019-07-20 11:30:00;NORTE;23;0;23;1
2019-07-20 12:00:00;NORTE;32;0;32;1
2019-07-20 12:30:00;NORTE;29;0;29;1
2019-07-20 13:00:00;NORTE;35;0;35;1
2019-07-20 13:30:00;SUR;0;36;36;1
2019-07-20 14:00:00;SUR;0;42;42;1
2019-07-20 14:30:00;SUR;0;39;39;1
2019-07-20 15:00:00;SUR;0;27;27;1
2019-07-20 15:30:00;SUR;0;23;23;1
2019-07-20 16:00:00;SUR;0;19;19;1
2019-07-20 16:30:00;SUR;0;29;29;1
2019-07-20 17:00:36;SUR;0;1;1;1
2019-07-20 17:02:30;SUR;0;1;1;1
2019-07-20 17:04:47;SUR;0;1;1;1
2019-07-20 17:05:19;SUR;0;1;1;1
2019-07-20 17:05:47;SUR;0;1;1;1
2019-07-20 17:06:36;SUR;0;1;1;1
2019-07-20 17:07:04;SUR;0;1;1;1
2019-07-20 17:07:40;SUR;0;1;1;1
2019-07-20 17:09:47;SUR;0;1;1;1
2019-07-20 17:09:49;SUR;0;1;1;1
2019-07-20 17:11:34;SUR;0;1;1;1
2019-07-20 17:13:51;SUR;0;1;1;1
2019-07-20 17:15:44;SUR;0;1;1;1
2019-07-20 17:16:34;SUR;0;1;1;1
2019-07-20 17:17:21;SUR;0;1;1;1
2019-07-20 17:18:46;SUR;0;1;1;1
2019-07-20 17:18:51;SUR;0;1;1;1
2019-07-20 17:20:49;SUR;0;1;1;1
2019-07-20 17:21:17;SUR;0;1;1;1
2019-07-20 17:23:29;SUR;0;1;1;1
2019-07-20 17:26:05;SUR;0;1;1;1
2019-07-20 17:27:38;SUR;0;1;1;1
2019-07-20 17:28:00;SUR;0;1;1;1
2019-07-20 17:30:31;SUR;0;1;1;1
2019-07-20 17:37:19;SUR;0;1;1;1
2019-07-20 17:38:03;SUR;0;1;1;1
2019-07-20 17:39:00;SUR;0;1;1;1
2019-07-20 17:40:06;SUR;0;1;1;1
2019-07-20 17:43:02;SUR;0;1;1;1
2019-07-20 17:46:26;SUR;0;1;1;1
2019-07-20 17:46:43;SUR;0;1;1;1
2019-07-20 17:47:12;SUR;0;1;1;1
2019-07-20 17:49:26;SUR;0;1;1;1
2019-07-20 17:50:22;SUR;0;1;1;1
2019-07-20 17:51:16;SUR;0;1;1;1
2019-07-20 17:51:20;SUR;0;1;1;1
2019-07-20 17:51:37;SUR;0;1;1;1
2019-07-20 17:52:53;SUR;0;1;1;1
2019-07-20 17:54:27;SUR;0;1;1;1
2019-07-20 17:55:39;SUR;0;1;1;1
2019-07-20 17:55:47;SUR;0;1;1;1
2019-07-20 17:55:53;SUR;0;1;1;1
2019-07-20 17:58:18;SUR;0;1;1;1
2019-07-20 17:58:27;SUR;0;1;1;1
2019-07-20 17:59:27;SUR;0;1;1;1
2019-07-20 18:00:00;SUR;0;35;35;1
2019-07-20 18:30:00;SUR;0;24;24;1
2019-07-20 19:00:00;SUR;0;19;19;1
2019-07-20 19:30:00;SUR;0;24;24;1
2019-07-20 20:00:00;CONFLICTIVA;14;11;25;2
2019-07-20 20:30:00;NORTE;21;0;21;1
2019-07-20 21:00:00;NORTE;19;0;19;1
2019-07-20 21:30:00;NORTE;14;0;14;1
2019-07-20 22:00:00;CONFLICTIVA;5;4;9;2
2019-07-20 22:30:00;SUR;0;20;20;1
2019-07-20 23:00:00;SUR;0;6;6;1
2019-07-20 23:30:00;SUR;0;6;6;1
2019-07-21 00:00:00;SUR;0;3;3;1
2019-07-21 00:30:00;SUR;0;3;3;1
2019-07-21 01:00:00;SUR;0;5;5;1
2019-07-21 01:30:00;SUR;0;2;2;1
2019-07-21 02:00:00;SUR;0;1;1;1
2019-07-21 02:30:00;CONFLICTIVA;2;5;7;2
2019-07-21 03:00:00;NORTE;3;0;3;1
2019-07-21 03:30:00;NORTE;6;0;6;1
2019-07-21 04:00:00;NORTE;15;0;15;1
2019-07-21 04:30:00;NORTE;11;0;11;1
2019-07-21 05:00:00;NORTE;22;0;22;1
2019-07-21 05:30:00;NORTE;32;0;32;1
2019-07-21 06:00:00;NORTE;21;0;21;1
2019-07-21 06:30:00;NORTE;25;0;25;1
2019-07-21 07:00:00;NORTE;36;0;36;1
2019-07-21 07:30:00;NORTE;30;0;30;1
2019-07-21 08:00:00;NORTE;30;0;30;1
2019-07-21 08:30:00;NORTE;37;0;37;1
2019-07-21 09:00:00;NORTE;18;0;18;1
2019-07-21 09:30:00;NORTE;32;0;32;1
2019-07-21 10:00:00;NORTE;38;0;38;1
2019-07-21 10:30:00;NORTE;33;0;33;1
2019-07-21 11:00:00;NORTE;32;0;32;1
2019-07-21 11:30:00;NORTE;28;0;28;1
2019-07-21 12:00:00;NORTE;28;0;28;1
2019-07-21 12:30:00;NORTE;32;0;32;1
2019-07-21 13:00:00;NORTE;42;0;42;1
2019-07-21 13:30:00;NORTE;40;0;40;1
2019-07-21 14:00:00;NORTE;45;0;45;1
2019-07-21 14:30:00;NORTE;27;0;27;1
2019-07-21 15:00:00;NORTE;32;0;32;1
2019-07-21 15:30:00;NORTE;34;0;34;1
2019-07-21 16:00:00;NORTE;22;0;22;1
2019-07-21 16:30:00;NORTE;38;0;38;1
2019-07-21 17:00:00;NORTE;22;0;22;1
2019-07-21 17:30:00;NORTE;6;0;6;1
2019-07-21 17:36:00;NORTE;22;0;22;1
2019-07-21 18:00:00;NORTE;30;0;30;1
2019-07-21 18:30:00;NORTE;2;0;2;1
2019-07-21 18:36:00;NORTE;21;0;21;1
2019-07-21 19:00:00;NORTE;34;0;34;1
2019-07-21 19:30:00;NORTE;39;0;39;1
2019-07-21 20:00:00;NORTE;34;0;34;1
2019-07-21 20:30:00;CONFLICTIVA;10;15;25;2
2019-07-21 21:00:00;SUR;0;22;22;1
2019-07-21 21:30:00;SUR;0;20;20;1
2019-07-21 22:00:00;SUR;0;18;18;1
2019-07-21 22:30:00;SUR;0;15;15;1
2019-07-21 23:00:00;SUR;0;6;6;1
2019-07-21 23:30:00;SUR;0;2;2;1
2019-07-22 00:00:00;SUR;0;1;1;1
2019-07-22 00:30:00;SUR;0;1;1;1
2019-07-22 01:00:00;SUR;0;1;1;1
2019-07-22 01:30:00;SUR;0;2;2;1
2019-07-22 02:00:00;NORTE;5;0;5;1
2019-07-22 02:30:00;NORTE;7;0;7;1
2019-07-22 03:00:00;NORTE;4;0;4;1
2019-07-22 03:30:00;NORTE;4;0;4;1
2019-07-22 04:00:00;NORTE;16;0;16;1
2019-07-22 04:30:00;NORTE;10;0;10;1
2019-07-22 05:00:00;NORTE;27;0;27;1
2019-07-22 05:30:00;NORTE;43;0;43;1
2019-07-22 06:00:00;NORTE;24;0;24;1
2019-07-22 06:30:00;NORTE;29;0;29;1
2019-07-22 07:00:00;NORTE;40;0;40;1
2019-07-22 07:30:00;NORTE;34;0;34;1
2019-07-22 08:00:00;NORTE;39;0;39;1
2019-07-22 08:30:00;NORTE;35;0;35;1
2019-07-22 09:00:00;SUR;2;24;26;1
2019-07-22 09:30:00;SUR;0;37;37;1
2019-07-22 10:00:00;SUR;0;36;36;1
2019-07-22 10:30:00;SUR;0;37;37;1
2019-07-22 11:00:00;SUR;0;38;38;1
2019-07-22 11:30:00;SUR;0;25;25;1
2019-07-22 12:00:00;SUR;0;35;35;1
2019-07-22 12:30:00;SUR;0;29;29;1
2019-07-22 13:00:00;SUR;0;42;42;1
2019-07-22 13:30:00;SUR;0;40;40;1
2019-07-22 14:00:00;SUR;0;40;40;1
2019-07-22 14:30:00;SUR;0;34;34;1
2019-07-22 15:00:00;SUR;0;35;35;1
2019-07-22 15:30:00;SUR;0;26;26;1
2019-07-22 16:00:00;SUR;0;29;29;1
2019-07-22 16:30:00;SUR;0;38;38;1
2019-07-22 17:00:00;SUR;0;30;30;1
2019-07-22 17:30:00;SUR;0;25;25;1
2019-07-22 18:00:00;SUR;0;40;40;1
2019-07-22 18:30:00;SUR;0;33;33;1
2019-07-22 19:00:00;SUR;0;34;34;1
2019-07-22 19:30:00;SUR;0;33;33;1
2019-07-22 20:00:00;SUR;0;35;35;1
2019-07-22 20:30:00;SUR;0;29;29;1
2019-07-22 21:00:00;SUR;0;16;16;1
2019-07-22 21:30:00;SUR;0;16;16;1
2019-07-22 22:00:00;SUR;0;17;17;1
2019-07-22 22:30:00;SUR;0;11;11;1
2019-07-22 23:00:00;SUR;0;2;2;1
2019-07-22 23:30:00;SUR;0;1;1;1
2019-07-23 00:00:00;SUR;0;1;1;1
2019-07-23 00:30:00;SUR;0;2;2;1
2019-07-23 01:30:00;SUR;0;2;2;1
2019-07-23 02:00:00;CONFLICTIVA;1;3;4;2
2019-07-23 02:30:00;NORTE;6;0;6;1
2019-07-23 03:00:00;NORTE;4;0;4;1
2019-07-23 03:30:00;NORTE;8;0;8;1
2019-07-23 04:00:00;NORTE;17;0;17;1
2019-07-23 04:30:00;NORTE;13;0;13;1
2019-07-23 05:00:00;NORTE;23;0;23;1
2019-07-23 05:30:00;NORTE;44;0;44;1
2019-07-23 06:00:00;NORTE;27;0;27;1
2019-07-23 06:30:00;NORTE;27;0;27;1
2019-07-23 07:00:00;NORTE;40;0;40;1
2019-07-23 07:30:00;NORTE;33;0;33;1
2019-07-23 08:00:00;NORTE;39;0;39;1
2019-07-23 08:30:00;NORTE;37;0;37;1
2019-07-23 09:00:00;NORTE;35;0;35;1
2019-07-23 09:30:00;NORTE;31;0;31;1
2019-07-23 10:00:00;NORTE;44;0;44;1
2019-07-23 10:30:00;NORTE;31;0;31;1
2019-07-23 11:00:00;NORTE;33;0;33;1
2019-07-23 11:30:00;SUR;1;23;24;1
2019-07-23 12:00:00;SUR;0;34;34;1
2019-07-23 12:30:00;SUR;0;27;27;1
2019-07-23 13:00:00;SUR;0;38;38;1
2019-07-23 13:30:00;SUR;0;32;32;1
2019-07-23 14:00:00;SUR;0;38;38;1
2019-07-23 14:30:00;SUR;0;42;42;1
2019-07-23 15:00:00;SUR;0;34;34;1
2019-07-23 15:30:00;SUR;0;32;32;1
2019-07-23 16:00:00;SUR;0;23;23;1
2019-07-23 16:30:00;SUR;0;32;32;1
2019-07-23 17:00:00;SUR;0;29;29;1
2019-07-23 17:30:00;SUR;0;18;18;1
2019-07-23 17:51:00;SUR;0;9;9;1
2019-07-23 18:00:00;SUR;0;1;1;1
2019-07-23 18:07:00;SUR;0;14;14;1
2019-07-23 18:30:00;SUR;0;32;32;1
2019-07-23 19:00:00;SUR;0;37;37;1
2019-07-23 19:30:00;SUR;0;40;40;1
2019-07-23 20:00:00;SUR;0;37;37;1
2019-07-23 20:30:00;SUR;0;32;32;1
2019-07-23 21:00:00;SUR;0;22;22;1
2019-07-23 21:30:00;SUR;0;20;20;1
2019-07-23 22:00:00;SUR;0;21;21;1
2019-07-23 22:30:00;SUR;0;16;16;1
2019-07-23 23:00:00;SUR;0;4;4;1
2019-07-23 23:30:00;CONFLICTIVA;1;1;2;2
2019-07-24 00:00:00;SUR;0;1;1;1
2019-07-24 00:30:00;SUR;0;1;1;1
2019-07-24 01:00:00;CONFLICTIVA;1;2;3;2
2019-07-24 02:00:00;NORTE;4;0;4;1
2019-07-24 02:30:00;NORTE;5;0;5;1
2019-07-24 03:00:00;NORTE;3;0;3;1
2019-07-24 03:30:00;NORTE;12;0;12;1
2019-07-24 04:00:00;NORTE;14;0;14;1
2019-07-24 04:30:00;NORTE;15;0;15;1
2019-07-24 05:00:00;NORTE;23;0;23;1
2019-07-24 05:30:00;NORTE;46;0;46;1
2019-07-24 06:00:00;NORTE;25;0;25;1
2019-07-24 06:30:00;NORTE;27;0;27;1
2019-07-24 07:00:00;NORTE;45;0;45;1
2019-07-24 07:30:00;NORTE;30;0;30;1
2019-07-24 08:00:00;NORTE;37;0;37;1
2019-07-24 08:30:00;NORTE;39;0;39;1
2019-07-24 09:00:00;NORTE;25;0;25;1
2019-07-24 09:30:00;SUR;0;28;28;1
2019-07-24 10:00:00;SUR;0;38;38;1
2019-07-24 10:30:00;SUR;0;35;35;1
2019-07-24 11:00:00;SUR;0;34;34;1
2019-07-24 11:30:00;SUR;0;28;28;1
2019-07-24 12:00:00;SUR;0;31;31;1
2019-07-24 12:30:00;SUR;0;32;32;1
2019-07-24 13:00:00;SUR;0;38;38;1
2019-07-24 13:30:00;SUR;0;37;37;1
2019-07-24 14:00:00;SUR;0;34;34;1
2019-07-24 14:30:00;SUR;0;41;41;1
2019-07-24 15:00:00;SUR;0;35;35;1
2019-07-24 15:30:00;SUR;0;20;20;1
2019-07-24 16:00:00;SUR;0;18;18;1
2019-07-24 16:30:00;SUR;0;36;36;1
2019-07-24 17:00:00;SUR;0;24;24;1
2019-07-24 17:30:00;SUR;0;28;28;1
2019-07-24 18:00:00;SUR;0;35;35;1
2019-07-24 18:30:00;SUR;0;35;35;1
2019-07-24 19:00:00;SUR;0;27;27;1
2019-07-24 19:30:00;SUR;0;34;34;1
2019-07-24 20:00:00;SUR;0;33;33;1
2019-07-24 20:30:00;SUR;0;30;30;1
2019-07-24 21:00:00;SUR;0;17;17;1
2019-07-24 21:30:00;SUR;0;21;21;1
2019-07-24 22:00:00;SUR;0;19;19;1
2019-07-24 22:30:00;SUR;0;11;11;1
2019-07-24 23:30:00;SUR;0;3;3;1
2019-07-25 00:00:00;SUR;0;2;2;1
2019-07-25 01:00:00;SUR;0;1;1;1
2019-07-25 01:30:00;SUR;0;1;1;1
2019-07-25 02:00:00;NORTE;3;0;3;1
2019-07-25 02:30:00;NORTE;5;0;5;1
2019-07-25 03:00:00;NORTE;3;0;3;1
2019-07-25 03:30:00;NORTE;7;0;7;1
2019-07-25 04:00:00;NORTE;18;0;18;1
2019-07-25 04:30:00;NORTE;14;0;14;1
2019-07-25 05:00:00;NORTE;22;0;22;1
2019-07-25 05:30:00;NORTE;40;0;40;1
2019-07-25 06:00:00;NORTE;29;0;29;1
2019-07-25 06:30:00;NORTE;26;0;26;1
2019-07-25 07:00:00;NORTE;37;0;37;1
2019-07-25 07:30:00;NORTE;31;0;31;1
2019-07-25 08:00:00;NORTE;36;0;36;1
2019-07-25 08:30:00;CONFLICTIVA;8;25;33;2
2019-07-25 09:00:00;SUR;0;29;29;1
2019-07-25 09:30:00;SUR;0;36;36;1
2019-07-25 10:00:00;SUR;0;32;32;1
2019-07-25 10:30:00;SUR;0;41;41;1
2019-07-25 11:00:00;SUR;0;29;29;1
2019-07-25 11:30:00;SUR;0;30;30;1
2019-07-25 12:00:00;SUR;0;29;29;1
2019-07-25 12:30:00;SUR;0;30;30;1
2019-07-25 13:00:00;SUR;0;38;38;1
2019-07-25 13:30:00;SUR;0;36;36;1
2019-07-25 14:00:00;SUR;0;40;40;1
2019-07-25 14:30:00;SUR;0;37;37;1
2019-07-25 15:00:00;SUR;0;36;36;1
2019-07-25 15:30:00;SUR;0;35;35;1
2019-07-25 16:00:00;SUR;0;20;20;1
2019-07-25 16:30:00;SUR;0;24;24;1
2019-07-25 17:00:00;SUR;0;24;24;1
2019-07-25 17:30:00;SUR;0;29;29;1
2019-07-25 18:00:00;CONFLICTIVA;25;4;29;2
2019-07-25 18:30:00;NORTE;35;0;35;1
2019-07-25 19:00:00;NORTE;33;0;33;1
2019-07-25 19:30:00;NORTE;34;0;34;1
2019-07-25 20:00:00;NORTE;34;0;34;1
2019-07-25 20:30:00;NORTE;31;0;31;1
2019-07-25 21:00:00;NORTE;27;0;27;1
2019-07-25 21:30:00;NORTE;21;0;21;1
2019-07-25 22:00:00;NORTE;21;0;21;1
2019-07-25 22:30:00;NORTE;22;0;22;1
2019-07-25 23:00:00;NORTE;11;0;11;1
2019-07-25 23:30:00;NORTE;3;0;3;1
2019-07-26 00:00:00;NORTE;3;0;3;1
2019-07-26 00:30:00;NORTE;1;0;1;1
2019-07-26 01:00:00;NORTE;3;0;3;1
2019-07-26 01:30:00;NORTE;1;0;1;1
2019-07-26 02:00:00;NORTE;2;0;2;1
2019-07-26 02:30:00;NORTE;3;0;3;1
2019-07-26 03:00:00;NORTE;8;0;8;1
2019-07-26 03:30:00;NORTE;9;0;9;1
2019-07-26 04:00:00;NORTE;13;0;13;1
2019-07-26 04:30:00;NORTE;13;0;13;1
2019-07-26 05:00:00;NORTE;28;0;28;1
2019-07-26 05:30:00;NORTE;40;0;40;1
2019-07-26 06:00:00;NORTE;22;0;22;1
2019-07-26 06:30:00;NORTE;25;0;25;1
2019-07-26 07:00:00;NORTE;37;0;37;1
2019-07-26 07:30:00;NORTE;30;0;30;1
2019-07-26 08:00:00;NORTE;38;0;38;1
2019-07-26 08:30:00;NORTE;38;0;38;1
2019-07-26 09:00:00;CONFLICTIVA;12;13;25;2
2019-07-26 09:30:00;SUR;0;41;41;1
2019-07-26 10:00:00;SUR;0;32;32;1
2019-07-26 10:30:00;SUR;0;33;33;1
2019-07-26 11:00:00;SUR;0;39;39;1
2019-07-26 11:30:00;SUR;0;23;23;1
2019-07-26 12:00:00;SUR;0;24;24;1
2019-07-26 12:30:00;SUR;0;36;36;1
2019-07-26 13:00:00;SUR;0;33;33;1
2019-07-26 13:30:00;SUR;0;37;37;1
2019-07-26 14:00:00;SUR;0;39;39;1
2019-07-26 14:30:00;SUR;0;42;42;1
2019-07-26 15:00:00;SUR;0;36;36;1
2019-07-26 15:30:00;SUR;0;26;26;1
2019-07-26 16:00:00;SUR;0;26;26;1
2019-07-26 16:30:00;SUR;0;34;34;1
2019-07-26 17:00:00;CONFLICTIVA;20;6;26;2
2019-07-26 17:30:00;NORTE;23;0;23;1
2019-07-26 18:00:00;NORTE;30;0;30;1
2019-07-26 18:30:00;NORTE;30;0;30;1
2019-07-26 19:00:00;NORTE;33;0;33;1
2019-07-26 19:30:00;NORTE;29;0;29;1
2019-07-26 20:00:00;NORTE;34;0;34;1
2019-07-26 20:30:00;NORTE;30;0;30;1
2019-07-26 21:00:00;NORTE;22;0;22;1
2019-07-26 21:30:00;NORTE;19;0;19;1
2019-07-26 22:00:00;NORTE;21;0;21;1
2019-07-26 22:30:00;NORTE;18;0;18;1
2019-07-26 23:00:00;NORTE;2;0;2;1
2019-07-26 23:30:00;NORTE;4;0;4;1
2019-07-27 00:00:00;NORTE;2;0;2;1
2019-07-27 01:00:00;NORTE;3;0;3;1
2019-07-27 01:30:00;NORTE;2;0;2;1
2019-07-27 02:00:00;NORTE;3;0;3;1
2019-07-27 02:30:00;NORTE;6;0;6;1
2019-07-27 03:00:00;NORTE;3;0;3;1
2019-07-27 03:30:00;NORTE;4;0;4;1
2019-07-27 04:00:00;NORTE;14;0;14;1
2019-07-27 04:30:00;NORTE;15;0;15;1
2019-07-27 05:00:00;NORTE;28;0;28;1
2019-07-27 05:30:00;NORTE;30;0;30;1
2019-07-27 06:00:00;NORTE;26;0;26;1
2019-07-27 06:30:00;NORTE;20;0;20;1
2019-07-27 07:00:00;NORTE;29;0;29;1
2019-07-27 07:30:00;NORTE;36;0;36;1
2019-07-27 08:00:00;NORTE;34;0;34;1
2019-07-27 08:30:00;NORTE;33;0;33;1
2019-07-27 09:00:00;NORTE;28;0;28;1
2019-07-27 09:30:00;NORTE;32;0;32;1
2019-07-27 10:00:00;NORTE;34;0;34;1
2019-07-27 10:30:00;NORTE;34;0;34;1
2019-07-27 11:00:00;CONFLICTIVA;6;19;25;2
2019-07-27 11:30:00;SUR;0;33;33;1
2019-07-27 12:00:00;SUR;0;24;24;1
2019-07-27 12:30:00;SUR;0;32;32;1
2019-07-27 13:00:00;CONFLICTIVA;15;11;26;2
2019-07-27 13:30:00;NORTE;32;0;32;1
2019-07-27 14:00:00;NORTE;39;0;39;1
2019-07-27 14:30:00;NORTE;33;0;33;1
2019-07-27 15:00:00;NORTE;26;0;26;1
2019-07-27 15:30:00;NORTE;27;0;27;1
2019-07-27 16:00:00;NORTE;26;0;26;1
2019-07-27 16:30:00;NORTE;24;0;24;1
2019-07-27 17:00:00;NORTE;22;0;22;1
2019-07-27 17:30:00;NORTE;25;0;25;1
2019-07-27 18:00:00;NORTE;29;0;29;1
2019-07-27 18:30:00;NORTE;27;0;27;1
2019-07-27 19:00:00;NORTE;22;0;22;1
2019-07-27 19:30:00;NORTE;26;0;26;1
2019-07-27 20:00:00;NORTE;17;0;17;1
2019-07-27 20:30:00;NORTE;27;0;27;1
2019-07-27 21:00:00;NORTE;15;0;15;1
2019-07-27 21:30:00;NORTE;17;0;17;1
2019-07-27 22:00:00;NORTE;19;0;19;1
2019-07-27 22:30:00;NORTE;19;0;19;1
2019-07-27 23:01:34;NORTE;1;0;1;1
2019-07-27 23:03:47;NORTE;1;0;1;1
2019-07-27 23:04:38;NORTE;1;0;1;1
2019-07-27 23:10:27;NORTE;1;0;1;1
2019-07-27 23:20:58;NORTE;1;0;1;1
2019-07-27 23:26:36;NORTE;1;0;1;1
2019-07-27 23:29:44;NORTE;1;0;1;1
2019-07-27 23:30:00;NORTE;5;0;5;1
2019-07-28 00:00:00;NORTE;3;0;3;1
2019-07-28 00:30:00;NORTE;9;0;9;1
2019-07-28 01:00:00;NORTE;5;0;5;1
2019-07-28 01:30:00;NORTE;2;0;2;1
2019-07-28 02:00:00;NORTE;2;0;2;1
2019-07-28 02:30:00;NORTE;3;0;3;1
2019-07-28 03:00:00;NORTE;1;0;1;1
2019-07-28 03:30:00;NORTE;6;0;6;1
2019-07-28 04:00:00;NORTE;14;0;14;1
2019-07-28 04:30:00;NORTE;12;0;12;1
2019-07-28 05:00:00;NORTE;24;0;24;1
2019-07-28 05:30:00;NORTE;28;0;28;1
2019-07-28 06:00:00;NORTE;17;0;17;1
2019-07-28 06:30:00;NORTE;22;0;22;1
2019-07-28 07:00:00;NORTE;33;0;33;1
2019-07-28 07:30:00;NORTE;34;0;34;1
2019-07-28 08:00:00;NORTE;39;0;39;1
2019-07-28 08:30:00;NORTE;34;0;34;1
2019-07-28 09:00:00;NORTE;24;0;24;1
2019-07-28 09:30:00;NORTE;33;0;33;1
2019-07-28 10:00:00;NORTE;29;0;29;1
2019-07-28 10:30:00;NORTE;33;0;33;1
2019-07-28 11:00:00;NORTE;33;0;33;1
2019-07-28 11:30:00;NORTE;27;0;27;1
2019-07-28 12:00:00;NORTE;27;0;27;1
2019-07-28 12:30:00;NORTE;37;0;37;1
2019-07-28 13:00:00;NORTE;29;0;29;1
2019-07-28 13:30:00;NORTE;31;0;31;1
2019-07-28 14:00:00;SUR;0;36;36;1
2019-07-28 14:30:00;SUR;0;43;43;1
2019-07-28 15:00:00;SUR;0;38;38;1
2019-07-28 15:30:00;SUR;0;24;24;1
2019-07-28 16:00:00;SUR;0;18;18;1
2019-07-28 16:30:00;SUR;0;30;30;1
2019-07-28 17:00:00;SUR;0;29;29;1
2019-07-28 17:30:00;SUR;0;21;21;1
2019-07-28 18:00:00;SUR;0;31;31;1
2019-07-28 18:30:00;SUR;0;35;35;1
2019-07-28 19:00:00;SUR;0;26;26;1
2019-07-28 19:30:00;SUR;0;31;31;1
2019-07-28 20:00:00;SUR;0;34;34;1
2019-07-28 20:30:00;SUR;0;30;30;1
2019-07-28 21:00:00;SUR;0;29;29;1
2019-07-28 21:30:00;SUR;0;16;16;1
2019-07-28 22:00:00;CONFLICTIVA;5;17;22;2
2019-07-28 22:30:00;NORTE;16;0;16;1
2019-07-28 23:02:30;NORTE;1;0;1;1
2019-07-28 23:05:50;NORTE;1;0;1;1
2019-07-28 23:09:00;NORTE;1;0;1;1
2019-07-28 23:12:34;NORTE;1;0;1;1
2019-07-28 23:14:03;NORTE;1;0;1;1
2019-07-28 23:19:36;NORTE;1;0;1;1
2019-07-28 23:22:06;NORTE;1;0;1;1
2019-07-28 23:24:24;NORTE;1;0;1;1
2019-07-28 23:30:00;NORTE;3;0;3;1
2019-07-29 00:00:00;NORTE;6;0;6;1
2019-07-29 00:30:00;NORTE;1;0;1;1
2019-07-29 01:00:00;NORTE;2;0;2;1
2019-07-29 01:30:00;NORTE;2;0;2;1
2019-07-29 02:00:00;NORTE;9;0;9;1
2019-07-29 02:30:00;NORTE;6;0;6;1
2019-07-29 03:00:00;NORTE;5;0;5;1
2019-07-29 03:30:00;NORTE;7;0;7;1
2019-07-29 04:00:00;NORTE;9;0;9;1
2019-07-29 04:30:00;NORTE;12;0;12;1
2019-07-29 05:00:00;NORTE;27;0;27;1
2019-07-29 05:30:00;NORTE;45;0;45;1
2019-07-29 06:00:00;NORTE;25;0;25;1
2019-07-29 06:30:00;NORTE;30;0;30;1
2019-07-29 07:00:00;NORTE;36;0;36;1
2019-07-29 07:30:00;NORTE;34;0;34;1
2019-07-29 08:00:00;NORTE;36;0;36;1
2019-07-29 08:30:00;NORTE;43;0;43;1
2019-07-29 09:00:00;NORTE;33;0;33;1
2019-07-29 09:30:00;NORTE;35;0;35;1
2019-07-29 10:00:00;NORTE;39;0;39;1
2019-07-29 10:30:00;NORTE;40;0;40;1
2019-07-29 11:00:00;CONFLICTIVA;4;21;25;2
2019-07-29 11:30:00;SUR;0;25;25;1
2019-07-29 12:00:00;SUR;0;30;30;1
2019-07-29 12:30:00;SUR;0;32;32;1
2019-07-29 13:00:00;SUR;0;38;38;1
2019-07-29 13:30:00;SUR;0;35;35;1
2019-07-29 14:00:00;SUR;0;37;37;1
2019-07-29 14:30:00;SUR;0;35;35;1
2019-07-29 15:00:00;SUR;0;33;33;1
2019-07-29 15:30:00;SUR;0;25;25;1
2019-07-29 16:00:00;SUR;0;25;25;1
2019-07-29 16:30:00;SUR;0;30;30;1
2019-07-29 17:00:00;SUR;0;33;33;1
2019-07-29 17:30:00;SUR;0;29;29;1
2019-07-29 18:00:00;SUR;0;36;36;1
2019-07-29 18:30:00;SUR;0;31;31;1
2019-07-29 19:00:00;NORTE;30;1;31;1
2019-07-29 19:30:00;NORTE;33;0;33;1
2019-07-29 20:00:00;NORTE;36;0;36;1
2019-07-29 20:30:00;NORTE;25;0;25;1
2019-07-29 21:00:00;NORTE;18;0;18;1
2019-07-29 21:30:00;NORTE;21;0;21;1
2019-07-29 22:00:00;NORTE;18;0;18;1
2019-07-29 22:30:00;NORTE;7;0;7;1
2019-07-29 23:00:00;NORTE;3;0;3;1
2019-07-29 23:30:00;NORTE;1;0;1;1
2019-07-30 00:00:00;NORTE;4;0;4;1
2019-07-30 00:30:00;NORTE;1;0;1;1
2019-07-30 01:00:00;NORTE;2;0;2;1
2019-07-30 02:00:00;NORTE;5;0;5;1
2019-07-30 02:30:00;NORTE;6;0;6;1
2019-07-30 03:00:00;NORTE;3;0;3;1
2019-07-30 03:30:00;NORTE;9;0;9;1
2019-07-30 04:00:00;NORTE;20;0;20;1
2019-07-30 04:30:00;NORTE;11;0;11;1
2019-07-30 05:00:00;NORTE;25;0;25;1
2019-07-30 05:30:00;NORTE;43;0;43;1
2019-07-30 06:00:00;NORTE;19;0;19;1
2019-07-30 06:30:00;NORTE;26;0;26;1
2019-07-30 07:00:00;NORTE;38;0;38;1
2019-07-30 07:30:00;NORTE;31;0;31;1
2019-07-30 08:00:00;NORTE;38;0;38;1
2019-07-30 08:30:00;NORTE;38;0;38;1
2019-07-30 09:00:00;NORTE;33;0;33;1
2019-07-30 09:30:00;NORTE;36;0;36;1
2019-07-30 10:00:00;NORTE;36;0;36;1
2019-07-30 10:30:00;NORTE;39;0;39;1
2019-07-30 11:00:00;NORTE;29;0;29;1
2019-07-30 11:30:00;NORTE;32;0;32;1
2019-07-30 12:00:00;NORTE;21;0;21;1
2019-07-30 12:30:00;NORTE;26;0;26;1
2019-07-30 13:00:00;NORTE;46;0;46;1
2019-07-30 13:30:00;NORTE;30;0;30;1
2019-07-30 14:00:00;NORTE;33;0;33;1
2019-07-30 14:30:00;NORTE;42;0;42;1
2019-07-30 15:00:00;NORTE;37;0;37;1
2019-07-30 15:30:00;NORTE;32;0;32;1
2019-07-30 16:00:00;NORTE;18;0;18;1
2019-07-30 16:30:00;NORTE;29;0;29;1
2019-07-30 17:00:00;NORTE;27;0;27;1
2019-07-30 17:30:00;NORTE;34;0;34;1
2019-07-30 18:00:00;NORTE;32;0;32;1
2019-07-30 18:30:00;NORTE;35;0;35;1
2019-07-30 19:00:00;NORTE;27;0;27;1
2019-07-30 19:30:00;NORTE;37;0;37;1
2019-07-30 20:00:00;NORTE;33;0;33;1
2019-07-30 20:30:00;NORTE;30;0;30;1
2019-07-30 21:00:00;NORTE;19;0;19;1
2019-07-30 21:30:00;NORTE;19;0;19;1
2019-07-30 22:00:00;NORTE;16;0;16;1
2019-07-30 22:30:00;NORTE;12;0;12;1
2019-07-30 23:00:00;NORTE;1;0;1;1
2019-07-30 23:30:00;NORTE;3;0;3;1
2019-07-31 00:30:00;NORTE;1;0;1;1
2019-07-31 01:00:00;NORTE;2;0;2;1
2019-07-31 01:30:00;NORTE;2;0;2;1
2019-07-31 02:00:00;NORTE;4;0;4;1
2019-07-31 02:30:00;NORTE;4;0;4;1
2019-07-31 03:00:00;NORTE;5;0;5;1
2019-07-31 03:30:00;NORTE;9;0;9;1
2019-07-31 04:00:00;NORTE;19;0;19;1
2019-07-31 04:30:00;NORTE;11;0;11;1
2019-07-31 05:00:00;NORTE;19;0;19;1
2019-07-31 05:30:00;NORTE;46;0;46;1
2019-07-31 06:00:00;NORTE;30;0;30;1
2019-07-31 06:30:00;NORTE;26;0;26;1
2019-07-31 07:00:00;NORTE;39;0;39;1
2019-07-31 07:30:00;NORTE;28;0;28;1
2019-07-31 08:00:00;NORTE;41;0;41;1
2019-07-31 08:30:00;NORTE;34;0;34;1
2019-07-31 09:00:00;NORTE;34;0;34;1
2019-07-31 09:30:00;NORTE;37;0;37;1
2019-07-31 10:00:00;NORTE;35;0;35;1
2019-07-31 10:30:00;NORTE;40;0;40;1
2019-07-31 11:00:00;NORTE;22;0;22;1
2019-07-31 11:30:00;CONFLICTIVA;30;4;34;2
2019-07-31 12:00:00;SUR;0;31;31;1
2019-07-31 12:30:00;SUR;0;32;32;1
2019-07-31 13:00:00;SUR;0;36;36;1
2019-07-31 13:30:00;SUR;0;36;36;1
2019-07-31 14:00:00;SUR;0;40;40;1
2019-07-31 14:30:00;SUR;0;34;34;1
2019-07-31 15:00:00;SUR;0;32;32;1
2019-07-31 15:30:00;SUR;0;24;24;1
2019-07-31 16:00:00;SUR;0;20;20;1
2019-07-31 16:30:00;SUR;0;31;31;1
2019-07-31 17:00:00;SUR;0;30;30;1
2019-07-31 17:30:00;SUR;0;29;29;1
2019-07-31 18:00:00;SUR;0;42;42;1
2019-07-31 18:30:00;SUR;0;29;29;1
2019-07-31 19:00:00;SUR;0;33;33;1
2019-07-31 19:30:00;SUR;0;32;32;1
2019-07-31 20:00:00;SUR;0;37;37;1
2019-07-31 20:30:00;SUR;0;19;19;1
2019-07-31 21:00:00;SUR;0;24;24;1
2019-07-31 21:30:00;SUR;0;20;20;1
2019-07-31 22:00:00;SUR;0;16;16;1
2019-07-31 22:30:00;SUR;0;9;9;1
2019-07-31 23:00:00;SUR;0;4;4;1
2019-07-31 23:30:00;SUR;0;3;3;1
2019-08-01 00:30:00;SUR;0;3;3;1
2019-08-01 01:00:00;SUR;0;2;2;1
2019-08-01 02:00:00;SUR;0;3;3;1
2019-08-01 02:30:00;SUR;0;6;6;1
2019-08-01 03:00:00;SUR;0;4;4;1
2019-08-01 03:30:00;SUR;0;9;9;1
2019-08-01 04:00:00;CONFLICTIVA;6;10;16;2
2019-08-01 04:30:00;NORTE;11;0;11;1
2019-08-01 05:00:00;NORTE;20;0;20;1
2019-08-01 05:30:00;NORTE;42;0;42;1
2019-08-01 06:00:00;CONFLICTIVA;5;14;19;2
2019-08-01 06:30:00;SUR;0;26;26;1
2019-08-01 07:00:00;SUR;0;38;38;1
2019-08-01 07:30:00;SUR;0;27;27;1
2019-08-01 08:00:00;SUR;0;33;33;1
2019-08-01 08:30:00;SUR;0;39;39;1
2019-08-01 09:00:00;SUR;0;29;29;1
2019-08-01 09:30:00;SUR;0;37;37;1
2019-08-01 10:00:00;SUR;0;30;30;1
2019-08-01 10:30:00;SUR;0;27;27;1
2019-08-01 11:00:00;SUR;0;38;38;1
2019-08-01 11:30:00;SUR;0;31;31;1
2019-08-01 12:00:00;SUR;0;29;29;1
2019-08-01 12:30:00;SUR;0;36;36;1
2019-08-01 13:00:00;SUR;0;32;32;1
2019-08-01 13:30:00;SUR;0;36;36;1
2019-08-01 14:00:00;SUR;0;29;29;1
2019-08-01 14:30:00;SUR;0;36;36;1
2019-08-01 15:00:00;SUR;0;34;34;1
2019-08-01 15:30:00;SUR;0;33;33;1
2019-08-01 16:00:00;SUR;0;27;27;1
2019-08-01 16:30:00;SUR;0;30;30;1
2019-08-01 17:00:00;SUR;0;25;25;1
2019-08-01 17:30:00;SUR;0;21;21;1
2019-08-01 18:00:00;SUR;0;29;29;1
2019-08-01 18:30:00;SUR;0;34;34;1
2019-08-01 19:00:00;SUR;0;28;28;1
2019-08-01 19:30:00;SUR;0;27;27;1
2019-08-01 20:00:00;SUR;0;32;32;1
2019-08-01 20:30:00;SUR;0;22;22;1
2019-08-01 21:00:00;SUR;0;22;22;1
2019-08-01 21:30:00;SUR;0;21;21;1
2019-08-01 22:00:00;CONFLICTIVA;9;3;12;2
2019-08-01 22:30:00;NORTE;24;0;24;1
2019-08-01 23:00:00;NORTE;14;0;14;1
2019-08-01 23:30:00;NORTE;1;0;1;1
2019-08-02 00:00:00;NORTE;3;0;3;1
2019-08-02 00:30:00;NORTE;2;0;2;1
2019-08-02 01:00:00;NORTE;1;0;1;1
2019-08-02 01:30:00;NORTE;1;0;1;1
2019-08-02 02:00:00;NORTE;3;0;3;1
2019-08-02 02:30:00;NORTE;3;0;3;1
2019-08-02 03:00:00;NORTE;8;0;8;1
2019-08-02 03:30:00;NORTE;5;0;5;1
2019-08-02 04:00:00;NORTE;19;0;19;1
2019-08-02 04:30:00;NORTE;9;0;9;1
2019-08-02 05:00:00;NORTE;22;0;22;1
2019-08-02 05:30:00;NORTE;41;0;41;1
2019-08-02 06:00:00;NORTE;22;0;22;1
2019-08-02 06:30:00;NORTE;22;0;22;1
2019-08-02 07:00:00;NORTE;41;0;41;1
2019-08-02 07:30:00;NORTE;36;0;36;1
2019-08-02 08:00:00;NORTE;33;0;33;1
2019-08-02 08:30:00;NORTE;44;0;44;1
2019-08-02 09:00:00;NORTE;29;0;29;1
2019-08-02 09:30:00;NORTE;30;0;30;1
2019-08-02 10:00:00;NORTE;35;0;35;1
2019-08-02 10:30:00;NORTE;37;0;37;1
2019-08-02 11:00:00;NORTE;30;0;30;1
2019-08-02 11:30:00;CONFLICTIVA;18;11;29;2
2019-08-02 12:00:00;SUR;0;34;34;1
2019-08-02 12:30:00;SUR;0;36;36;1
2019-08-02 13:00:00;SUR;0;33;33;1
2019-08-02 13:30:00;SUR;0;36;36;1
2019-08-02 14:00:00;SUR;0;46;46;1
2019-08-02 14:30:00;SUR;0;41;41;1
2019-08-02 15:00:00;SUR;0;34;34;1
2019-08-02 15:30:00;SUR;0;24;24;1
2019-08-02 16:00:00;SUR;0;28;28;1
2019-08-02 16:30:00;SUR;0;30;30;1
2019-08-02 17:00:00;SUR;0;20;20;1
2019-08-02 17:30:00;SUR;0;30;30;1
2019-08-02 18:00:00;SUR;0;34;34;1
2019-08-02 18:30:00;SUR;0;29;29;1
2019-08-02 19:00:00;SUR;0;33;33;1
2019-08-02 19:30:00;SUR;0;32;32;1
2019-08-02 20:00:00;SUR;0;32;32;1
2019-08-02 20:30:00;SUR;0;25;25;1
2019-08-02 21:00:00;SUR;0;21;21;1
2019-08-02 21:30:00;CONFLICTIVA;12;5;17;2
2019-08-02 22:00:00;NORTE;21;0;21;1
2019-08-02 22:30:00;NORTE;11;0;11;1
2019-08-02 23:00:00;NORTE;4;0;4;1
2019-08-03 00:00:00;NORTE;1;0;1;1
2019-08-03 00:30:00;NORTE;2;0;2;1
2019-08-03 01:30:00;NORTE;1;0;1;1
2019-08-03 02:00:00;NORTE;3;0;3;1
2019-08-03 02:30:00;NORTE;8;0;8;1
2019-08-03 03:00:00;NORTE;1;0;1;1
2019-08-03 03:30:00;NORTE;6;0;6;1
2019-08-03 04:00:00;NORTE;14;0;14;1
2019-08-03 04:30:00;NORTE;15;0;15;1
2019-08-03 05:00:00;NORTE;23;0;23;1
2019-08-03 05:30:00;NORTE;35;0;35;1
2019-08-03 06:00:00;NORTE;27;0;27;1
2019-08-03 06:30:00;NORTE;23;0;23;1
2019-08-03 07:00:00;NORTE;34;0;34;1
2019-08-03 07:30:00;NORTE;37;0;37;1
2019-08-03 08:00:00;NORTE;34;0;34;1
2019-08-03 08:30:00;NORTE;32;0;32;1
2019-08-03 09:00:00;CONFLICTIVA;15;6;21;2
2019-08-03 09:30:00;SUR;0;38;38;1
2019-08-03 10:00:00;SUR;0;28;28;1
2019-08-03 10:30:00;SUR;0;31;31;1
2019-08-03 11:00:00;SUR;0;31;31;1
2019-08-03 11:30:00;SUR;0;28;28;1
2019-08-03 12:00:00;SUR;0;29;29;1
2019-08-03 12:30:00;SUR;0;23;23;1
2019-08-03 13:00:00;SUR;0;38;38;1
2019-08-03 13:30:00;SUR;0;32;32;1
2019-08-03 14:00:00;SUR;0;42;42;1
2019-08-03 14:30:00;SUR;0;38;38;1
2019-08-03 15:00:00;SUR;0;25;25;1
2019-08-03 15:30:00;SUR;0;24;24;1
2019-08-03 16:00:00;SUR;0;23;23;1
2019-08-03 16:30:00;SUR;0;21;21;1
2019-08-03 17:00:00;SUR;0;23;23;1
2019-08-03 17:30:00;SUR;0;20;20;1
2019-08-03 18:00:00;SUR;0;30;30;1
2019-08-03 18:30:00;CONFLICTIVA;12;15;27;2
2019-08-03 19:00:00;NORTE;28;0;28;1
2019-08-03 19:30:00;NORTE;25;0;25;1
2019-08-03 20:00:00;NORTE;22;0;22;1
2019-08-03 20:30:00;NORTE;28;0;28;1
2019-08-03 21:00:00;NORTE;18;0;18;1
2019-08-03 21:30:00;NORTE;17;0;17;1
2019-08-03 22:00:00;NORTE;22;0;22;1
2019-08-03 22:30:00;NORTE;14;0;14;1
2019-08-03 23:00:00;NORTE;5;0;5;1
2019-08-03 23:30:00;NORTE;2;0;2;1
2019-08-04 00:00:00;NORTE;3;0;3;1
2019-08-04 00:30:00;NORTE;2;0;2;1
2019-08-04 01:00:00;NORTE;2;0;2;1
2019-08-04 01:30:00;NORTE;2;0;2;1
2019-08-04 02:00:00;NORTE;2;0;2;1
2019-08-04 02:30:00;NORTE;3;0;3;1
2019-08-04 03:00:00;NORTE;3;0;3;1
2019-08-04 03:30:00;NORTE;8;0;8;1
2019-08-04 04:00:00;NORTE;12;0;12;1
2019-08-04 04:30:00;NORTE;14;0;14;1
2019-08-04 05:00:00;NORTE;23;0;23;1
2019-08-04 05:30:00;NORTE;29;0;29;1
2019-08-04 06:00:00;NORTE;21;0;21;1
2019-08-04 06:30:00;NORTE;23;0;23;1
2019-08-04 07:00:00;NORTE;35;0;35;1
2019-08-04 07:30:00;NORTE;24;0;24;1
2019-08-04 08:00:00;NORTE;32;0;32;1
2019-08-04 08:30:00;NORTE;37;0;37;1
2019-08-04 09:00:00;NORTE;23;0;23;1
2019-08-04 09:30:00;NORTE;32;0;32;1
2019-08-04 10:00:00;NORTE;34;0;34;1
2019-08-04 10:30:00;NORTE;23;2;25;1
2019-08-04 11:00:00;SUR;0;40;40;1
2019-08-04 11:30:00;SUR;0;33;33;1
2019-08-04 12:00:00;SUR;0;28;28;1
2019-08-04 12:30:00;SUR;0;34;34;1
2019-08-04 13:00:00;SUR;0;35;35;1
2019-08-04 13:30:00;SUR;0;30;30;1
2019-08-04 14:00:00;SUR;0;48;48;1
2019-08-04 14:30:00;SUR;0;41;41;1
2019-08-04 15:00:00;SUR;0;33;33;1
2019-08-04 15:30:00;SUR;0;24;24;1
2019-08-04 16:00:00;SUR;0;17;17;1
2019-08-04 16:30:00;SUR;0;31;31;1
2019-08-04 17:00:00;SUR;0;25;25;1
2019-08-04 17:30:00;SUR;0;24;24;1
2019-08-04 18:00:00;SUR;0;34;34;1
2019-08-04 18:30:00;SUR;0;26;26;1
2019-08-04 19:00:00;SUR;0;33;33;1
2019-08-04 19:30:00;SUR;0;32;32;1
2019-08-04 20:00:00;SUR;0;32;32;1
2019-08-04 20:30:00;SUR;0;21;21;1
2019-08-04 21:00:00;SUR;0;23;23;1
2019-08-04 21:30:00;SUR;0;19;19;1
2019-08-04 22:00:00;SUR;0;15;15;1
2019-08-04 22:30:00;SUR;0;15;15;1
2019-08-04 23:00:00;CONFLICTIVA;4;5;9;2
2019-08-04 23:30:00;NORTE;4;0;4;1
2019-08-05 00:00:00;NORTE;2;0;2;1
2019-08-05 00:30:00;NORTE;2;0;2;1
2019-08-05 01:30:00;NORTE;2;0;2;1
2019-08-05 02:00:00;NORTE;4;0;4;1
2019-08-05 02:30:00;NORTE;6;0;6;1
2019-08-05 03:00:00;NORTE;6;0;6;1
2019-08-05 03:30:00;NORTE;5;0;5;1
2019-08-05 04:00:00;NORTE;11;0;11;1
2019-08-05 04:30:00;NORTE;13;0;13;1
2019-08-05 05:00:00;NORTE;26;0;26;1
2019-08-05 05:30:00;NORTE;36;0;36;1
2019-08-05 06:00:00;NORTE;22;0;22;1
2019-08-05 06:30:00;NORTE;25;0;25;1
2019-08-05 07:00:00;NORTE;39;0;39;1
2019-08-05 07:30:00;NORTE;40;0;40;1
2019-08-05 08:00:00;NORTE;37;0;37;1
2019-08-05 08:30:00;NORTE;37;0;37;1
2019-08-05 09:00:00;NORTE;33;0;33;1
2019-08-05 09:30:00;NORTE;31;0;31;1
2019-08-05 10:00:00;NORTE;33;0;33;1
2019-08-05 10:30:00;NORTE;35;0;35;1
2019-08-05 11:00:00;CONFLICTIVA;5;22;27;2
2019-08-05 11:30:00;SUR;0;31;31;1
2019-08-05 12:00:00;SUR;0;31;31;1
2019-08-05 12:30:00;SUR;0;28;28;1
2019-08-05 13:00:00;SUR;0;40;40;1
2019-08-05 13:30:00;SUR;0;32;32;1
2019-08-05 14:00:00;SUR;0;42;42;1
2019-08-05 14:30:00;SUR;0;36;36;1
2019-08-05 15:00:00;SUR;0;31;31;1
2019-08-05 15:30:00;SUR;0;31;31;1
2019-08-05 16:00:00;SUR;0;20;20;1
2019-08-05 16:30:00;SUR;0;39;39;1
2019-08-05 17:00:00;SUR;0;20;20;1
2019-08-05 17:30:00;SUR;0;28;28;1
2019-08-05 18:00:00;SUR;0;38;38;1
2019-08-05 18:30:00;SUR;0;31;31;1
2019-08-05 19:00:00;SUR;0;23;23;1
2019-08-05 19:30:00;CONFLICTIVA;12;19;31;2
2019-08-05 20:00:00;NORTE;32;0;32;1
2019-08-05 20:30:00;NORTE;29;0;29;1
2019-08-05 21:00:00;NORTE;14;0;14;1
2019-08-05 21:30:00;NORTE;20;0;20;1
2019-08-05 22:00:00;NORTE;17;0;17;1
2019-08-05 22:30:00;NORTE;15;0;15;1
2019-08-05 23:00:00;NORTE;1;0;1;1
2019-08-06 00:00:00;NORTE;2;0;2;1
2019-08-06 01:00:00;NORTE;2;0;2;1
2019-08-06 01:30:00;NORTE;2;0;2;1
2019-08-06 02:00:00;NORTE;5;0;5;1
2019-08-06 02:30:00;NORTE;7;0;7;1
2019-08-06 03:00:00;NORTE;4;0;4;1
2019-08-06 03:30:00;NORTE;9;0;9;1
2019-08-06 04:00:00;NORTE;17;0;17;1
2019-08-06 04:30:00;NORTE;10;0;10;1
2019-08-06 05:00:00;NORTE;26;0;26;1
2019-08-06 05:30:00;NORTE;34;0;34;1
2019-08-06 06:00:00;NORTE;21;0;21;1
2019-08-06 06:30:00;NORTE;24;0;24;1
2019-08-06 07:00:00;NORTE;39;0;39;1
2019-08-06 07:30:00;NORTE;35;0;35;1
2019-08-06 08:00:00;NORTE;35;0;35;1
2019-08-06 08:30:00;CONFLICTIVA;13;18;31;2
2019-08-06 09:00:00;SUR;0;28;28;1
2019-08-06 09:30:00;SUR;0;37;37;1
2019-08-06 10:00:00;SUR;0;34;34;1
2019-08-06 10:30:00;SUR;0;34;34;1
2019-08-06 11:00:00;SUR;0;29;29;1
2019-08-06 11:30:00;SUR;0;32;32;1
2019-08-06 12:00:00;SUR;0;21;21;1
2019-08-06 12:30:00;SUR;0;34;34;1
2019-08-06 13:00:00;SUR;0;35;35;1
2019-08-06 13:30:00;SUR;0;33;33;1
2019-08-06 14:00:00;SUR;0;38;38;1
2019-08-06 14:30:00;SUR;0;38;38;1
2019-08-06 15:00:00;SUR;0;30;30;1
2019-08-06 15:30:00;SUR;0;30;30;1
2019-08-06 16:00:00;SUR;0;21;21;1
2019-08-06 16:30:00;SUR;0;29;29;1
2019-08-06 17:00:00;SUR;0;27;27;1
2019-08-06 17:30:00;SUR;0;30;30;1
2019-08-06 18:00:00;SUR;0;25;25;1
2019-08-06 18:30:00;SUR;0;26;26;1
2019-08-06 19:00:00;SUR;0;30;30;1
2019-08-06 19:30:00;SUR;0;35;35;1
2019-08-06 20:00:00;SUR;0;35;35;1
2019-08-06 20:30:00;SUR;0;24;24;1
2019-08-06 21:00:00;SUR;0;18;18;1
2019-08-06 21:30:00;SUR;0;20;20;1
2019-08-06 22:00:00;SUR;0;16;16;1
2019-08-06 22:30:00;SUR;0;14;14;1
2019-08-06 23:00:00;CONFLICTIVA;1;1;2;2
2019-08-06 23:30:00;NORTE;2;0;2;1
2019-08-07 00:00:00;NORTE;4;0;4;1
2019-08-07 00:30:00;NORTE;1;0;1;1
2019-08-07 01:30:00;NORTE;1;0;1;1
2019-08-07 02:00:00;NORTE;2;0;2;1
2019-08-07 02:30:00;NORTE;4;0;4;1
2019-08-07 03:00:00;NORTE;6;0;6;1
2019-08-07 03:30:00;NORTE;6;0;6;1
2019-08-07 04:00:00;NORTE;14;0;14;1
2019-08-07 04:30:00;NORTE;14;0;14;1
2019-08-07 05:00:00;NORTE;23;0;23;1
2019-08-07 05:30:00;NORTE;43;0;43;1
2019-08-07 06:00:00;NORTE;24;0;24;1
2019-08-07 06:30:00;NORTE;22;0;22;1
2019-08-07 07:00:00;NORTE;39;0;39;1
2019-08-07 07:30:00;NORTE;36;0;36;1
2019-08-07 08:00:00;NORTE;34;0;34;1
2019-08-07 08:30:00;NORTE;41;0;41;1
2019-08-07 09:00:00;CONFLICTIVA;15;9;24;2
2019-08-07 09:30:00;SUR;0;33;33;1
2019-08-07 10:00:00;SUR;0;36;36;1
2019-08-07 10:30:00;SUR;0;36;36;1
2019-08-07 11:00:00;SUR;0;28;28;1
2019-08-07 11:30:00;SUR;0;30;30;1
2019-08-07 12:00:00;SUR;0;24;24;1
2019-08-07 12:30:00;SUR;0;34;34;1
2019-08-07 13:00:00;SUR;0;38;38;1
2019-08-07 13:30:00;SUR;0;29;29;1
2019-08-07 14:00:00;SUR;0;38;38;1
2019-08-07 14:30:00;SUR;0;38;38;1
2019-08-07 15:00:00;SUR;0;32;32;1
2019-08-07 15:30:00;SUR;0;23;23;1
2019-08-07 16:00:00;SUR;0;21;21;1
2019-08-07 16:30:00;SUR;0;36;36;1
2019-08-07 17:00:00;SUR;1;19;20;1
2019-08-07 17:30:00;SUR;0;27;27;1
2019-08-07 18:00:00;SUR;0;35;35;1
2019-08-07 18:30:00;SUR;0;35;35;1
2019-08-07 19:00:00;SUR;0;30;30;1
2019-08-07 19:30:00;SUR;0;29;29;1
2019-08-07 20:00:00;SUR;0;34;34;1
2019-08-07 20:30:00;SUR;0;28;28;1
2019-08-07 21:00:00;SUR;0;15;15;1
2019-08-07 21:30:00;SUR;0;18;18;1
2019-08-07 22:00:00;SUR;0;19;19;1
2019-08-07 22:30:00;SUR;0;14;14;1
2019-08-07 23:30:00;SUR;0;4;4;1
2019-08-08 00:00:00;SUR;0;2;2;1
2019-08-08 00:30:00;SUR;0;1;1;1
2019-08-08 01:00:00;SUR;0;1;1;1
2019-08-08 01:30:00;SUR;0;1;1;1
2019-08-08 02:00:00;NORTE;4;0;4;1
2019-08-08 02:30:00;NORTE;6;0;6;1
2019-08-08 03:00:00;NORTE;2;0;2;1
2019-08-08 03:30:00;NORTE;10;0;10;1
2019-08-08 04:00:00;NORTE;16;0;16;1
2019-08-08 04:30:00;NORTE;9;0;9;1
2019-08-08 05:00:00;NORTE;23;0;23;1
2019-08-08 05:30:00;NORTE;33;0;33;1
2019-08-08 06:00:00;NORTE;30;0;30;1
2019-08-08 06:30:00;NORTE;30;0;30;1
2019-08-08 07:00:00;NORTE;35;0;35;1
2019-08-08 07:30:00;NORTE;24;0;24;1
2019-08-08 08:00:00;NORTE;36;0;36;1
2019-08-08 08:30:00;NORTE;35;0;35;1
2019-08-08 09:00:00;CONFLICTIVA;3;19;22;2
2019-08-08 09:30:00;SUR;0;35;35;1
2019-08-08 10:00:00;SUR;0;32;32;1
2019-08-08 10:30:00;SUR;0;37;37;1
2019-08-08 11:00:00;SUR;0;36;36;1
2019-08-08 11:30:00;SUR;0;29;29;1
2019-08-08 12:00:00;SUR;0;24;24;1
2019-08-08 12:30:00;SUR;0;33;33;1
2019-08-08 13:00:00;SUR;0;39;39;1
2019-08-08 13:30:00;SUR;0;38;38;1
2019-08-08 14:00:00;SUR;0;35;35;1
2019-08-08 14:30:00;SUR;0;33;33;1
2019-08-08 15:00:00;SUR;0;31;31;1
2019-08-08 15:30:00;SUR;0;30;30;1
2019-08-08 16:00:00;SUR;0;19;19;1
2019-08-08 16:30:00;SUR;0;32;32;1
2019-08-08 17:00:00;SUR;0;24;24;1
2019-08-08 17:30:00;SUR;0;23;23;1
2019-08-08 18:00:00;SUR;0;35;35;1
2019-08-08 18:30:00;SUR;0;26;26;1
2019-08-08 19:00:00;SUR;0;29;29;1
2019-08-08 19:30:00;SUR;0;29;29;1
2019-08-08 20:00:00;SUR;0;35;35;1
2019-08-08 20:30:00;SUR;0;26;26;1
2019-08-08 21:00:00;SUR;0;22;22;1
2019-08-08 21:30:00;SUR;0;24;24;1
2019-08-08 22:00:00;SUR;0;18;18;1
2019-08-08 22:30:00;SUR;0;19;19;1
2019-08-08 23:00:00;SUR;0;5;5;1
2019-08-08 23:30:00;CONFLICTIVA;3;4;7;2
2019-08-09 00:00:00;NORTE;6;0;6;1
2019-08-09 00:30:00;NORTE;1;0;1;1
2019-08-09 01:00:00;NORTE;1;0;1;1
2019-08-09 01:30:00;NORTE;3;0;3;1
2019-08-09 02:00:00;SUR;0;5;5;1
2019-08-09 02:30:00;SUR;0;4;4;1
2019-08-09 03:00:00;SUR;0;6;6;1
2019-08-09 03:30:00;SUR;0;9;9;1
2019-08-09 04:00:00;SUR;0;14;14;1
2019-08-09 04:30:00;SUR;0;10;10;1
2019-08-09 05:00:00;SUR;0;23;23;1
2019-08-09 05:30:00;SUR;0;38;38;1
2019-08-09 06:00:00;SUR;0;27;27;1
2019-08-09 06:30:00;SUR;0;28;28;1
2019-08-09 07:00:00;SUR;0;42;42;1
2019-08-09 07:30:00;SUR;0;31;31;1
2019-08-09 08:00:00;SUR;0;30;30;1
2019-08-09 08:30:00;SUR;0;44;44;1
2019-08-09 09:00:00;SUR;0;33;33;1
2019-08-09 09:30:00;SUR;0;28;28;1
2019-08-09 10:00:00;SUR;0;36;36;1
2019-08-09 10:30:00;SUR;0;31;31;1
2019-08-09 11:00:00;SUR;0;31;31;1
2019-08-09 11:30:00;SUR;0;26;26;1
2019-08-09 12:00:00;SUR;0;34;34;1
2019-08-09 12:30:00;SUR;0;26;26;1
2019-08-09 13:00:00;SUR;0;39;39;1
2019-08-09 13:30:00;SUR;0;40;40;1
2019-08-09 14:00:00;SUR;0;45;45;1
2019-08-09 14:30:00;SUR;0;36;36;1
2019-08-09 15:00:00;SUR;0;36;36;1
2019-08-09 15:30:00;SUR;0;23;23;1
2019-08-09 16:00:00;SUR;0;25;25;1
2019-08-09 16:30:00;SUR;0;32;32;1
2019-08-09 17:00:00;SUR;0;22;22;1
2019-08-09 17:30:00;SUR;0;28;28;1
2019-08-09 18:00:00;SUR;0;28;28;1
2019-08-09 18:30:00;SUR;0;26;26;1
2019-08-09 19:00:00;SUR;0;32;32;1
2019-08-09 19:30:00;SUR;0;30;30;1
2019-08-09 20:00:00;SUR;0;31;31;1
2019-08-09 20:30:00;SUR;0;27;27;1
2019-08-09 21:00:00;SUR;0;23;23;1
2019-08-09 21:30:00;SUR;0;16;16;1
2019-08-09 22:00:00;SUR;0;23;23;1
2019-08-09 22:30:00;SUR;0;12;12;1
2019-08-09 23:00:00;SUR;0;6;6;1
2019-08-09 23:30:00;SUR;0;1;1;1
2019-08-10 00:00:00;SUR;0;1;1;1
2019-08-10 00:30:00;SUR;0;1;1;1
2019-08-10 01:00:00;SUR;0;1;1;1
2019-08-10 01:30:00;SUR;0;1;1;1
2019-08-10 02:00:00;NORTE;5;0;5;1
2019-08-10 02:30:00;NORTE;6;0;6;1
2019-08-10 03:00:00;NORTE;1;0;1;1
2019-08-10 03:30:00;NORTE;9;0;9;1
2019-08-10 04:00:00;NORTE;14;0;14;1
2019-08-10 04:30:00;NORTE;9;0;9;1
2019-08-10 05:00:00;NORTE;32;0;32;1
2019-08-10 05:30:00;NORTE;33;0;33;1
2019-08-10 06:00:00;NORTE;20;0;20;1
2019-08-10 06:30:00;NORTE;25;0;25;1
2019-08-10 07:00:00;NORTE;38;0;38;1
2019-08-10 07:30:00;NORTE;36;0;36;1
2019-08-10 08:00:00;NORTE;24;0;24;1
2019-08-10 08:30:00;NORTE;39;0;39;1
2019-08-10 09:00:00;NORTE;27;0;27;1
2019-08-10 09:30:00;NORTE;33;0;33;1
2019-08-10 10:00:00;NORTE;27;0;27;1
2019-08-10 10:30:00;NORTE;26;0;26;1
2019-08-10 11:00:00;NORTE;34;0;34;1
2019-08-10 11:30:00;NORTE;22;0;22;1
2019-08-10 12:00:00;SUR;0;25;25;1
2019-08-10 12:30:00;SUR;0;33;33;1
2019-08-10 13:00:00;SUR;0;42;42;1
2019-08-10 13:30:00;SUR;0;34;34;1
2019-08-10 14:00:00;SUR;0;42;42;1
2019-08-10 14:30:00;SUR;0;33;33;1
2019-08-10 15:00:00;SUR;0;30;30;1
2019-08-10 15:30:00;SUR;0;23;23;1
2019-08-10 16:00:00;SUR;0;22;22;1
2019-08-10 16:30:00;SUR;0;23;23;1
2019-08-10 17:00:00;SUR;0;19;19;1
2019-08-10 17:30:00;SUR;0;12;12;1
2019-08-10 18:00:00;CONFLICTIVA;19;10;29;2
2019-08-10 18:30:00;NORTE;29;0;29;1
2019-08-10 19:00:00;NORTE;20;0;20;1
2019-08-10 19:30:00;NORTE;29;0;29;1
2019-08-10 20:00:00;NORTE;22;0;22;1
2019-08-10 20:30:00;NORTE;30;0;30;1
2019-08-10 21:00:00;NORTE;17;0;17;1
2019-08-10 21:30:00;NORTE;16;0;16;1
2019-08-10 22:00:00;NORTE;22;0;22;1
2019-08-10 22:30:00;NORTE;6;0;6;1
2019-08-10 23:00:00;NORTE;4;0;4;1
2019-08-10 23:30:00;NORTE;3;0;3;1
2019-08-11 00:00:00;NORTE;4;0;4;1
2019-08-11 00:30:00;NORTE;2;0;2;1
2019-08-11 01:00:00;NORTE;1;0;1;1
2019-08-11 01:30:00;NORTE;1;0;1;1
2019-08-11 02:00:00;NORTE;2;0;2;1
2019-08-11 02:30:00;NORTE;3;0;3;1
2019-08-11 03:00:00;NORTE;3;0;3;1
2019-08-11 03:30:00;NORTE;7;0;7;1
2019-08-11 04:00:00;NORTE;11;0;11;1
2019-08-11 04:30:00;NORTE;7;0;7;1
2019-08-11 05:00:00;NORTE;15;0;15;1
2019-08-11 05:30:00;NORTE;32;0;32;1
2019-08-11 06:00:00;NORTE;22;0;22;1
2019-08-11 06:30:00;NORTE;22;0;22;1
2019-08-11 07:00:00;NORTE;30;0;30;1
2019-08-11 07:30:00;NORTE;25;0;25;1
2019-08-11 08:00:00;NORTE;36;0;36;1
2019-08-11 08:30:00;NORTE;24;2;26;1
2019-08-11 09:00:00;SUR;0;29;29;1
2019-08-11 09:30:00;SUR;0;35;35;1
2019-08-11 10:00:00;SUR;0;33;33;1
2019-08-11 10:30:00;SUR;0;31;31;1
2019-08-11 11:00:00;SUR;0;31;31;1
2019-08-11 11:30:00;SUR;0;26;26;1
2019-08-11 12:00:00;SUR;0;27;27;1
2019-08-11 12:30:00;SUR;0;32;32;1
2019-08-11 13:00:00;SUR;0;38;38;1
2019-08-11 13:30:00;SUR;0;37;37;1
2019-08-11 14:00:00;SUR;0;45;45;1
2019-08-11 14:30:00;SUR;0;43;43;1
2019-08-11 15:00:00;SUR;0;28;28;1
2019-08-11 15:30:00;SUR;0;26;26;1
2019-08-11 16:00:00;SUR;0;19;19;1
2019-08-11 16:30:00;SUR;0;30;30;1
2019-08-11 17:00:00;SUR;0;26;26;1
2019-08-11 17:30:00;SUR;0;21;21;1
2019-08-11 18:00:00;SUR;0;34;34;1
2019-08-11 18:30:00;CONFLICTIVA;13;14;27;2
2019-08-11 19:00:00;NORTE;30;0;30;1
2019-08-11 19:30:00;NORTE;32;0;32;1
2019-08-11 20:00:00;NORTE;30;0;30;1
2019-08-11 20:30:00;NORTE;29;0;29;1
2019-08-11 21:00:00;NORTE;16;0;16;1
2019-08-11 21:30:00;NORTE;23;0;23;1
2019-08-11 22:00:00;NORTE;25;0;25;1
2019-08-11 22:30:00;NORTE;16;0;16;1
2019-08-11 23:00:00;NORTE;5;0;5;1
2019-08-11 23:30:00;NORTE;2;0;2;1
2019-08-12 00:00:00;NORTE;2;0;2;1
2019-08-12 00:30:00;NORTE;1;0;1;1
2019-08-12 01:00:00;NORTE;2;0;2;1
2019-08-12 02:00:00;NORTE;2;0;2;1
2019-08-12 02:30:00;NORTE;9;0;9;1
2019-08-12 03:00:00;NORTE;2;0;2;1
2019-08-12 03:30:00;NORTE;6;0;6;1
2019-08-12 04:00:00;NORTE;15;0;15;1
2019-08-12 04:30:00;NORTE;6;0;6;1
2019-08-12 05:00:00;NORTE;32;0;32;1
2019-08-12 05:30:00;NORTE;36;0;36;1
2019-08-12 06:00:00;NORTE;24;0;24;1
2019-08-12 06:30:00;NORTE;24;0;24;1
2019-08-12 07:00:00;NORTE;32;0;32;1
2019-08-12 07:30:00;NORTE;32;0;32;1
2019-08-12 08:00:00;NORTE;36;0;36;1
2019-08-12 08:30:00;NORTE;37;0;37;1
2019-08-12 09:00:00;NORTE;34;0;34;1
2019-08-12 09:30:00;NORTE;30;0;30;1
2019-08-12 10:00:00;NORTE;32;0;32;1
2019-08-12 10:30:00;NORTE;39;0;39;1
2019-08-12 11:00:00;NORTE;35;0;35;1
2019-08-12 11:30:00;NORTE;20;0;20;1
2019-08-12 12:00:00;NORTE;21;0;21;1
2019-08-12 12:30:00;NORTE;36;0;36;1
2019-08-12 13:00:00;NORTE;39;0;39;1
2019-08-12 13:30:00;NORTE;34;0;34;1
2019-08-12 14:00:00;NORTE;38;0;38;1
2019-08-12 14:30:00;NORTE;36;0;36;1
2019-08-12 15:00:00;NORTE;34;0;34;1
2019-08-12 15:30:00;NORTE;24;0;24;1
2019-08-12 16:00:00;NORTE;18;0;18;1
2019-08-12 16:30:00;NORTE;37;0;37;1
2019-08-12 17:00:00;NORTE;24;0;24;1
2019-08-12 17:30:00;NORTE;29;0;29;1
2019-08-12 18:00:00;NORTE;32;0;32;1
2019-08-12 18:30:00;NORTE;31;0;31;1
2019-08-12 19:00:00;NORTE;27;0;27;1
2019-08-12 19:30:00;NORTE;35;0;35;1
2019-08-12 20:00:00;NORTE;27;0;27;1
2019-08-12 20:30:00;NORTE;25;0;25;1
2019-08-12 21:00:00;NORTE;25;0;25;1
2019-08-12 21:30:00;NORTE;15;0;15;1
2019-08-12 22:00:00;NORTE;21;0;21;1
2019-08-12 22:30:00;NORTE;13;0;13;1
2019-08-12 23:00:00;NORTE;2;0;2;1
2019-08-12 23:30:00;NORTE;1;0;1;1
2019-08-13 00:00:00;NORTE;1;0;1;1
2019-08-13 00:30:00;NORTE;1;0;1;1
2019-08-13 01:30:00;NORTE;2;0;2;1
2019-08-13 02:00:00;NORTE;4;0;4;1
2019-08-13 02:30:00;NORTE;5;0;5;1
2019-08-13 03:00:00;NORTE;5;0;5;1
2019-08-13 03:30:00;NORTE;7;0;7;1
2019-08-13 04:00:00;NORTE;12;0;12;1
2019-08-13 04:30:00;NORTE;10;0;10;1
2019-08-13 05:00:00;NORTE;30;0;30;1
2019-08-13 05:30:00;NORTE;40;0;40;1
2019-08-13 06:00:00;NORTE;19;0;19;1
2019-08-13 06:30:00;NORTE;21;0;21;1
2019-08-13 07:00:00;NORTE;42;1;43;1
2019-08-13 07:30:00;NORTE;37;0;37;1
2019-08-13 08:00:00;NORTE;34;0;34;1
2019-08-13 08:30:00;NORTE;33;0;33;1
2019-08-13 09:00:00;NORTE;30;0;30;1
2019-08-13 09:30:00;NORTE;31;0;31;1
2019-08-13 10:00:00;NORTE;33;0;33;1
2019-08-13 10:30:00;NORTE;44;0;44;1
2019-08-13 11:00:00;NORTE;26;0;26;1
2019-08-13 11:30:00;NORTE;30;0;30;1
2019-08-13 12:00:00;NORTE;26;0;26;1
2019-08-13 12:30:00;NORTE;32;0;32;1
2019-08-13 13:00:00;NORTE;47;0;47;1
2019-08-13 13:30:00;NORTE;25;0;25;1
2019-08-13 14:00:00;NORTE;44;0;44;1
2019-08-13 14:30:00;NORTE;32;0;32;1
2019-08-13 15:00:00;NORTE;32;0;32;1
2019-08-13 15:30:00;NORTE;24;0;24;1
2019-08-13 16:00:00;NORTE;21;0;21;1
2019-08-13 16:30:00;NORTE;37;0;37;1
2019-08-13 17:00:00;NORTE;27;0;27;1
2019-08-13 17:30:00;NORTE;31;0;31;1
2019-08-13 18:00:00;NORTE;26;0;26;1
2019-08-13 18:30:00;NORTE;28;0;28;1
2019-08-13 19:00:00;NORTE;35;0;35;1
2019-08-13 19:30:00;NORTE;35;0;35;1
2019-08-13 20:00:00;NORTE;24;0;24;1
2019-08-13 20:30:00;NORTE;23;0;23;1
2019-08-13 21:00:00;NORTE;20;0;20;1
2019-08-13 21:30:00;NORTE;17;0;17;1
2019-08-13 22:00:00;NORTE;18;0;18;1
2019-08-13 22:30:00;NORTE;9;0;9;1
2019-08-13 23:30:00;NORTE;3;0;3;1
2019-08-14 00:00:00;NORTE;2;0;2;1
2019-08-14 00:30:00;NORTE;1;0;1;1
2019-08-14 01:00:00;NORTE;1;0;1;1
2019-08-14 02:00:00;NORTE;3;0;3;1
2019-08-14 02:30:00;NORTE;3;0;3;1
2019-08-14 03:00:00;NORTE;6;0;6;1
2019-08-14 03:30:00;NORTE;6;0;6;1
2019-08-14 04:00:00;NORTE;18;0;18;1
2019-08-14 04:30:00;NORTE;12;1;13;1
2019-08-14 05:00:00;NORTE;22;0;22;1
2019-08-14 05:30:00;NORTE;43;0;43;1
2019-08-14 06:00:00;NORTE;21;0;21;1
2019-08-14 06:30:00;NORTE;21;0;21;1
2019-08-14 07:00:00;NORTE;39;0;39;1
2019-08-14 07:30:00;NORTE;34;0;34;1
2019-08-14 08:00:00;NORTE;35;0;35;1
2019-08-14 08:30:00;NORTE;39;0;39;1
2019-08-14 09:00:00;NORTE;27;0;27;1
2019-08-14 09:30:00;NORTE;34;0;34;1
2019-08-14 10:00:00;NORTE;39;0;39;1
2019-08-14 10:30:00;NORTE;34;0;34;1
2019-08-14 11:00:00;NORTE;34;0;34;1
2019-08-14 11:30:00;NORTE;27;0;27;1
2019-08-14 12:00:00;NORTE;28;0;28;1
2019-08-14 12:30:00;NORTE;32;0;32;1
2019-08-14 13:00:00;NORTE;37;0;37;1
2019-08-14 13:30:00;NORTE;28;0;28;1
2019-08-14 14:00:00;NORTE;39;0;39;1
2019-08-14 14:30:00;NORTE;36;0;36;1
2019-08-14 15:00:00;NORTE;24;0;24;1
2019-08-14 15:30:00;NORTE;26;0;26;1
2019-08-14 16:00:00;NORTE;24;0;24;1
2019-08-14 16:30:06;NORTE;1;0;1;1
2019-08-14 16:31:08;NORTE;1;0;1;1
2019-08-14 16:31:59;NORTE;1;0;1;1
2019-08-14 16:33:40;NORTE;1;0;1;1
2019-08-14 16:36:01;NORTE;1;0;1;1
2019-08-14 16:36:59;NORTE;1;0;1;1
2019-08-14 16:38:24;NORTE;1;0;1;1
2019-08-14 16:39:22;NORTE;1;0;1;1
2019-08-14 16:39:52;NORTE;1;0;1;1
2019-08-14 16:41:17;NORTE;1;0;1;1
2019-08-14 16:41:26;NORTE;1;0;1;1
2019-08-14 16:41:59;NORTE;1;0;1;1
2019-08-14 16:42:30;NORTE;1;0;1;1
2019-08-14 16:43:22;NORTE;1;0;1;1
2019-08-14 16:43:49;NORTE;1;0;1;1
2019-08-14 16:44:45;NORTE;1;0;1;1
2019-08-14 16:45:40;NORTE;1;0;1;1
2019-08-14 16:46:29;NORTE;1;0;1;1
2019-08-14 16:46:43;NORTE;1;0;1;1
2019-08-14 16:48:10;NORTE;1;0;1;1
2019-08-14 16:48:40;NORTE;1;0;1;1
2019-08-14 16:48:50;NORTE;1;0;1;1
2019-08-14 16:50:41;NORTE;1;0;1;1
2019-08-14 16:50:51;NORTE;1;0;1;1
2019-08-14 16:51:32;NORTE;1;0;1;1
2019-08-14 16:52:05;NORTE;1;0;1;1
2019-08-14 16:52:15;NORTE;1;0;1;1
2019-08-14 16:52:25;NORTE;1;0;1;1
2019-08-14 16:53:47;NORTE;1;0;1;1
2019-08-14 16:55:57;NORTE;1;0;1;1
2019-08-14 16:57:15;NORTE;1;0;1;1
2019-08-14 16:58:19;NORTE;1;0;1;1
2019-08-14 16:58:48;NORTE;1;0;1;1
2019-08-14 16:58:50;NORTE;1;0;1;1
2019-08-14 16:59:12;NORTE;1;0;1;1
2019-08-14 17:00:00;NORTE;23;0;23;1
2019-08-14 17:30:00;NORTE;29;0;29;1
2019-08-14 18:00:00;NORTE;34;0;34;1
2019-08-14 18:30:00;NORTE;28;0;28;1
2019-08-14 19:00:00;NORTE;30;0;30;1
2019-08-14 19:30:00;NORTE;34;0;34;1
2019-08-14 20:00:00;NORTE;29;0;29;1
2019-08-14 20:30:00;NORTE;21;0;21;1
2019-08-14 21:00:00;NORTE;23;0;23;1
2019-08-14 21:30:00;NORTE;16;0;16;1
2019-08-14 22:00:00;NORTE;11;0;11;1
2019-08-14 22:30:00;NORTE;11;0;11;1
2019-08-14 23:00:00;NORTE;1;0;1;1
2019-08-14 23:30:00;NORTE;1;0;1;1
2019-08-15 00:00:00;NORTE;2;0;2;1
2019-08-15 00:30:00;NORTE;1;0;1;1
2019-08-15 01:30:00;NORTE;2;0;2;1
2019-08-15 02:00:00;NORTE;5;0;5;1
2019-08-15 02:30:00;NORTE;4;0;4;1
2019-08-15 03:00:00;NORTE;5;0;5;1
2019-08-15 03:30:00;NORTE;9;0;9;1
2019-08-15 04:00:00;NORTE;9;0;9;1
2019-08-15 04:30:00;NORTE;17;0;17;1
2019-08-15 05:00:00;NORTE;19;0;19;1
2019-08-15 05:30:00;NORTE;42;0;42;1
2019-08-15 06:00:00;NORTE;21;0;21;1
2019-08-15 06:30:00;NORTE;25;0;25;1
2019-08-15 07:00:00;NORTE;35;0;35;1
2019-08-15 07:30:00;NORTE;35;0;35;1
2019-08-15 08:00:00;NORTE;33;0;33;1
2019-08-15 08:30:00;NORTE;35;0;35;1
2019-08-15 09:00:00;NORTE;31;0;31;1
2019-08-15 09:30:00;NORTE;33;0;33;1
2019-08-15 10:00:00;NORTE;30;0;30;1
2019-08-15 10:30:00;NORTE;40;0;40;1
2019-08-15 11:00:00;NORTE;30;0;30;1
2019-08-15 11:30:00;NORTE;35;0;35;1
2019-08-15 12:00:00;NORTE;24;0;24;1
2019-08-15 12:30:00;NORTE;34;0;34;1
2019-08-15 13:00:00;NORTE;40;0;40;1
2019-08-15 13:30:00;NORTE;32;0;32;1
2019-08-15 14:00:00;NORTE;40;0;40;1
2019-08-15 14:30:00;NORTE;41;0;41;1
2019-08-15 15:00:00;NORTE;28;0;28;1
2019-08-15 15:30:00;NORTE;20;0;20;1
2019-08-15 16:00:00;NORTE;22;0;22;1
2019-08-15 16:30:00;NORTE;33;0;33;1
2019-08-15 17:00:00;NORTE;21;0;21;1
2019-08-15 17:30:00;NORTE;27;0;27;1
2019-08-15 18:00:00;NORTE;35;0;35;1
2019-08-15 18:30:00;NORTE;29;0;29;1
2019-08-15 19:00:00;NORTE;31;0;31;1
2019-08-15 19:30:00;NORTE;33;0;33;1
2019-08-15 20:00:00;NORTE;27;0;27;1
2019-08-15 20:30:00;NORTE;29;0;29;1
2019-08-15 21:00:00;NORTE;18;0;18;1
2019-08-15 21:30:00;NORTE;20;0;20;1
2019-08-15 22:00:00;NORTE;21;0;21;1
2019-08-15 22:30:00;NORTE;9;0;9;1
2019-08-15 23:00:00;NORTE;4;0;4;1
2019-08-15 23:30:00;NORTE;2;0;2;1
2019-08-16 00:00:00;NORTE;6;0;6;1
2019-08-16 00:30:00;NORTE;1;0;1;1
2019-08-16 01:30:00;NORTE;1;0;1;1
2019-08-16 02:00:00;NORTE;2;0;2;1
2019-08-16 02:30:00;NORTE;5;0;5;1
2019-08-16 03:00:00;NORTE;7;0;7;1
2019-08-16 03:30:00;NORTE;7;0;7;1
2019-08-16 04:00:00;NORTE;11;0;11;1
2019-08-16 04:30:00;NORTE;14;0;14;1
2019-08-16 05:00:00;NORTE;22;0;22;1
2019-08-16 05:30:00;NORTE;36;0;36;1
2019-08-16 06:00:00;NORTE;19;0;19;1
2019-08-16 06:30:00;NORTE;29;0;29;1
2019-08-16 07:00:00;NORTE;39;0;39;1
2019-08-16 07:30:00;NORTE;34;0;34;1
2019-08-16 08:00:00;NORTE;41;0;41;1
2019-08-16 08:30:00;NORTE;38;0;38;1
2019-08-16 09:00:00;NORTE;25;0;25;1
2019-08-16 09:30:00;NORTE;33;0;33;1
2019-08-16 10:00:00;NORTE;33;0;33;1
2019-08-16 10:30:00;NORTE;37;0;37;1
2019-08-16 11:00:00;CONFLICTIVA;13;14;27;2
2019-08-16 11:30:00;SUR;0;30;30;1
2019-08-16 12:00:00;SUR;0;33;33;1
2019-08-16 12:30:00;SUR;0;30;30;1
2019-08-16 13:00:00;SUR;0;40;40;1
2019-08-16 13:30:00;SUR;0;39;39;1
2019-08-16 14:00:00;SUR;0;46;46;1
2019-08-16 14:30:00;SUR;0;37;37;1
2019-08-16 15:00:00;SUR;0;36;36;1
2019-08-16 15:30:00;SUR;0;33;33;1
2019-08-16 16:00:00;SUR;0;18;18;1
2019-08-16 16:30:00;SUR;0;34;34;1
2019-08-16 17:00:00;SUR;0;26;26;1
2019-08-16 17:30:00;SUR;0;23;23;1
2019-08-16 18:00:00;SUR;0;38;38;1
2019-08-16 18:30:00;SUR;0;32;32;1
2019-08-16 19:00:00;SUR;0;25;25;1
2019-08-16 19:30:00;SUR;0;36;36;1
2019-08-16 20:00:00;SUR;0;24;24;1
2019-08-16 20:30:00;SUR;0;24;24;1
2019-08-16 21:00:00;SUR;0;18;18;1
2019-08-16 21:30:00;SUR;0;20;20;1
2019-08-16 22:00:00;NORTE;16;0;16;1
2019-08-16 22:30:00;NORTE;9;0;9;1
2019-08-16 23:00:00;NORTE;3;0;3;1
2019-08-16 23:30:00;NORTE;1;0;1;1
2019-08-17 00:00:00;NORTE;1;0;1;1
2019-08-17 00:30:00;NORTE;2;0;2;1
2019-08-17 01:30:00;NORTE;2;0;2;1
2019-08-17 02:00:00;NORTE;4;0;4;1
2019-08-17 02:30:00;NORTE;5;0;5;1
2019-08-17 03:00:00;NORTE;5;0;5;1
2019-08-17 03:30:00;NORTE;5;0;5;1
2019-08-17 04:00:00;NORTE;9;0;9;1
2019-08-17 04:30:00;NORTE;18;0;18;1
2019-08-17 05:00:00;NORTE;23;0;23;1
2019-08-17 05:30:00;NORTE;38;0;38;1
2019-08-17 06:00:00;NORTE;20;0;20;1
2019-08-17 06:30:00;NORTE;23;0;23;1
2019-08-17 07:00:00;NORTE;37;0;37;1
2019-08-17 07:30:00;NORTE;37;0;37;1
2019-08-17 08:00:00;NORTE;28;0;28;1
2019-08-17 08:30:00;CONFLICTIVA;15;16;31;2
2019-08-17 09:00:00;SUR;0;26;26;1
2019-08-17 09:30:00;SUR;0;37;37;1
2019-08-17 10:00:00;SUR;0;33;33;1
2019-08-17 10:30:00;SUR;0;26;26;1
2019-08-17 11:00:00;SUR;0;37;37;1
2019-08-17 11:30:00;SUR;0;28;28;1
2019-08-17 12:00:00;SUR;0;25;25;1
2019-08-17 12:30:00;SUR;0;35;35;1
2019-08-17 13:00:00;SUR;0;30;30;1
2019-08-17 13:30:00;SUR;0;39;39;1
2019-08-17 14:00:00;SUR;0;34;34;1
2019-08-17 14:30:00;SUR;0;35;35;1
2019-08-17 15:00:00;SUR;0;30;30;1
2019-08-17 15:30:00;SUR;0;20;20;1
2019-08-17 16:00:00;SUR;0;20;20;1
2019-08-17 16:30:00;SUR;0;25;25;1
2019-08-17 17:00:00;SUR;0;23;23;1
2019-08-17 17:30:00;SUR;0;17;17;1
2019-08-17 18:00:00;SUR;0;26;26;1
2019-08-17 18:30:00;SUR;0;29;29;1
2019-08-17 19:00:00;SUR;0;21;21;1
2019-08-17 19:30:00;SUR;0;32;32;1
2019-08-17 20:00:00;SUR;0;25;25;1
2019-08-17 20:30:00;SUR;0;19;19;1
2019-08-17 21:00:00;SUR;0;21;21;1
2019-08-17 21:30:00;SUR;0;14;14;1
2019-08-17 22:00:00;NORTE;17;0;17;1
2019-08-17 22:30:00;NORTE;14;0;14;1
2019-08-17 23:00:00;NORTE;3;0;3;1
2019-08-17 23:30:00;NORTE;8;0;8;1
2019-08-18 00:00:00;NORTE;2;0;2;1
2019-08-18 00:30:00;NORTE;1;0;1;1
2019-08-18 01:00:00;NORTE;3;0;3;1
2019-08-18 02:00:00;NORTE;2;0;2;1
2019-08-18 02:30:00;NORTE;4;0;4;1
2019-08-18 03:00:00;NORTE;1;0;1;1
2019-08-18 03:30:00;NORTE;8;0;8;1
2019-08-18 04:00:00;NORTE;9;0;9;1
2019-08-18 04:30:00;NORTE;17;0;17;1
2019-08-18 05:00:00;NORTE;21;0;21;1
2019-08-18 05:30:00;NORTE;29;0;29;1
2019-08-18 06:00:00;NORTE;18;0;18;1
2019-08-18 06:30:00;NORTE;24;0;24;1
2019-08-18 07:00:00;NORTE;36;0;36;1
2019-08-18 07:30:00;NORTE;31;0;31;1
2019-08-18 08:00:00;NORTE;32;0;32;1
2019-08-18 08:30:00;NORTE;33;0;33;1
2019-08-18 09:00:00;CONFLICTIVA;17;4;21;2
2019-08-18 09:30:00;SUR;0;29;29;1
2019-08-18 10:00:00;SUR;0;37;37;1
2019-08-18 10:30:00;SUR;0;32;32;1
2019-08-18 11:00:00;SUR;0;35;35;1
2019-08-18 11:30:00;SUR;0;35;35;1
2019-08-18 12:00:00;SUR;0;19;19;1
2019-08-18 12:30:00;SUR;0;37;37;1
2019-08-18 13:00:00;SUR;0;36;36;1
2019-08-18 13:30:00;SUR;0;35;35;1
2019-08-18 14:00:00;SUR;0;45;45;1
2019-08-18 14:30:00;SUR;0;34;34;1
2019-08-18 15:00:00;SUR;0;36;36;1
2019-08-18 15:30:00;SUR;0;26;26;1
2019-08-18 16:00:00;SUR;0;19;19;1
2019-08-18 16:30:00;SUR;0;26;26;1
2019-08-18 17:00:00;SUR;0;26;26;1
2019-08-18 17:30:00;SUR;0;30;30;1
2019-08-18 18:00:00;SUR;0;28;28;1
2019-08-18 18:30:00;SUR;0;35;35;1
2019-08-18 19:00:00;SUR;0;27;27;1
2019-08-18 19:30:00;SUR;0;32;32;1
2019-08-18 20:00:00;SUR;0;24;24;1
2019-08-18 20:30:00;SUR;0;25;25;1
2019-08-18 21:00:00;CONFLICTIVA;2;15;17;2
2019-08-18 21:30:00;NORTE;21;0;21;1
2019-08-18 22:00:00;NORTE;17;0;17;1
2019-08-18 22:30:00;NORTE;17;0;17;1
2019-08-18 23:00:00;NORTE;6;0;6;1
2019-08-18 23:30:00;NORTE;4;0;4;1
2019-08-19 00:00:00;NORTE;2;0;2;1
2019-08-19 00:30:00;NORTE;2;0;2;1
2019-08-19 01:00:00;NORTE;1;0;1;1
2019-08-19 01:30:00;NORTE;2;0;2;1
2019-08-19 02:00:00;NORTE;4;0;4;1
2019-08-19 02:30:00;NORTE;2;0;2;1
2019-08-19 03:00:00;NORTE;6;0;6;1
2019-08-19 03:30:00;NORTE;7;0;7;1
2019-08-19 04:00:00;NORTE;11;0;11;1
2019-08-19 04:30:00;NORTE;8;0;8;1
2019-08-19 05:00:00;NORTE;26;0;26;1
2019-08-19 05:30:00;NORTE;43;0;43;1
2019-08-19 06:00:00;NORTE;23;0;23;1
2019-08-19 06:30:00;NORTE;25;0;25;1
2019-08-19 07:00:00;NORTE;35;0;35;1
2019-08-19 07:30:00;NORTE;35;0;35;1
2019-08-19 08:00:00;NORTE;39;0;39;1
2019-08-19 08:30:00;NORTE;39;0;39;1
2019-08-19 09:00:00;NORTE;34;0;34;1
2019-08-19 09:30:00;NORTE;34;0;34;1
2019-08-19 10:00:00;NORTE;40;0;40;1
2019-08-19 10:30:00;CONFLICTIVA;10;19;29;2
2019-08-19 11:00:00;SUR;0;34;34;1
2019-08-19 11:30:00;SUR;0;22;22;1
2019-08-19 12:00:00;SUR;0;24;24;1
2019-08-19 12:30:00;SUR;0;33;33;1
2019-08-19 13:00:00;SUR;0;43;43;1
2019-08-19 13:30:00;SUR;0;28;28;1
2019-08-19 14:00:00;SUR;0;39;39;1
2019-08-19 14:30:00;SUR;0;34;34;1
2019-08-19 15:00:00;SUR;0;32;32;1
2019-08-19 15:30:00;SUR;0;23;23;1
2019-08-19 16:00:00;SUR;0;21;21;1
2019-08-19 16:30:00;SUR;0;37;37;1
2019-08-19 17:00:00;SUR;0;21;21;1
2019-08-19 17:30:00;NORTE;25;1;26;1
2019-08-19 18:00:00;NORTE;37;0;37;1
2019-08-19 18:30:00;NORTE;30;0;30;1
2019-08-19 19:00:00;NORTE;30;0;30;1
2019-08-19 19:30:00;NORTE;31;0;31;1
2019-08-19 20:00:00;NORTE;28;0;28;1
2019-08-19 20:30:00;NORTE;23;0;23;1
2019-08-19 21:00:00;NORTE;18;0;18;1
2019-08-19 21:30:00;NORTE;17;0;17;1
2019-08-19 22:00:00;NORTE;21;0;21;1
2019-08-19 22:30:00;NORTE;9;0;9;1
2019-08-19 23:00:00;NORTE;4;0;4;1
2019-08-19 23:30:00;NORTE;5;0;5;1
2019-08-20 00:30:00;NORTE;1;0;1;1
2019-08-20 01:30:00;NORTE;1;0;1;1
2019-08-20 02:00:00;NORTE;6;0;6;1
2019-08-20 02:30:00;NORTE;5;0;5;1
2019-08-20 03:00:00;NORTE;3;0;3;1
2019-08-20 03:30:00;NORTE;11;0;11;1
2019-08-20 04:00:00;NORTE;15;0;15;1
2019-08-20 04:30:00;NORTE;8;0;8;1
2019-08-20 05:00:00;NORTE;25;0;25;1
2019-08-20 05:30:00;NORTE;40;0;40;1
2019-08-20 06:00:00;NORTE;21;0;21;1
2019-08-20 06:30:00;NORTE;20;0;20;1
2019-08-20 07:00:00;NORTE;43;0;43;1
2019-08-20 07:30:00;NORTE;35;0;35;1
2019-08-20 08:00:00;NORTE;38;0;38;1
2019-08-20 08:30:00;NORTE;39;0;39;1
2019-08-20 09:00:00;NORTE;29;0;29;1
2019-08-20 09:30:00;NORTE;39;0;39;1
2019-08-20 10:00:00;NORTE;32;0;32;1
2019-08-20 10:30:00;NORTE;38;0;38;1
2019-08-20 11:00:00;NORTE;28;0;28;1
2019-08-20 11:30:00;NORTE;29;0;29;1
2019-08-20 12:00:00;NORTE;23;0;23;1
2019-08-20 12:30:00;NORTE;30;0;30;1
2019-08-20 13:00:00;NORTE;38;0;38;1
2019-08-20 13:30:00;NORTE;33;0;33;1
2019-08-20 14:00:00;NORTE;39;0;39;1
2019-08-20 14:30:00;NORTE;39;0;39;1
2019-08-20 15:00:00;NORTE;33;0;33;1
2019-08-20 15:30:00;NORTE;22;0;22;1
2019-08-20 16:00:00;NORTE;21;0;21;1
2019-08-20 16:30:00;NORTE;34;0;34;1
2019-08-20 17:00:00;NORTE;31;0;31;1
2019-08-20 17:30:00;NORTE;27;0;27;1
2019-08-20 18:00:00;NORTE;39;0;39;1
2019-08-20 18:30:00;NORTE;30;0;30;1
2019-08-20 19:00:00;NORTE;33;0;33;1
2019-08-20 19:30:00;NORTE;31;1;32;1
2019-08-20 20:00:00;NORTE;27;0;27;1
2019-08-20 20:30:00;NORTE;24;0;24;1
2019-08-20 21:00:00;NORTE;15;0;15;1
2019-08-20 21:30:00;NORTE;15;0;15;1
2019-08-20 22:00:00;NORTE;20;0;20;1
2019-08-20 22:30:00;NORTE;10;0;10;1
2019-08-20 23:00:00;NORTE;1;0;1;1
2019-08-20 23:30:00;NORTE;1;0;1;1
2019-08-21 00:00:00;NORTE;1;0;1;1
2019-08-21 00:30:00;NORTE;1;0;1;1
2019-08-21 01:30:00;NORTE;2;0;2;1
2019-08-21 02:00:00;NORTE;3;0;3;1
2019-08-21 02:30:00;NORTE;4;0;4;1
2019-08-21 03:00:00;NORTE;3;0;3;1
2019-08-21 03:30:00;NORTE;8;0;8;1
2019-08-21 04:00:00;NORTE;15;0;15;1
2019-08-21 04:30:00;NORTE;14;0;14;1
2019-08-21 05:00:00;NORTE;23;0;23;1
2019-08-21 05:30:00;NORTE;44;0;44;1
2019-08-21 06:00:00;NORTE;16;0;16;1
2019-08-21 06:30:00;NORTE;23;0;23;1
2019-08-21 07:00:00;NORTE;41;0;41;1
2019-08-21 07:30:00;NORTE;32;0;32;1
2019-08-21 08:00:00;NORTE;31;0;31;1
2019-08-21 08:30:00;NORTE;37;0;37;1
2019-08-21 09:00:00;NORTE;34;0;34;1
2019-08-21 09:30:00;NORTE;35;0;35;1
2019-08-21 10:00:00;NORTE;32;0;32;1
2019-08-21 10:30:00;NORTE;35;0;35;1
2019-08-21 11:00:00;NORTE;35;0;35;1
2019-08-21 11:30:00;NORTE;28;0;28;1
2019-08-21 12:00:00;NORTE;18;0;18;1
2019-08-21 12:30:00;NORTE;32;0;32;1
2019-08-21 13:00:00;NORTE;35;0;35;1
2019-08-21 13:30:00;NORTE;37;0;37;1
2019-08-21 14:00:00;NORTE;37;0;37;1
2019-08-21 14:30:00;NORTE;32;0;32;1
2019-08-21 15:00:00;NORTE;32;0;32;1
2019-08-21 15:30:00;NORTE;26;0;26;1
2019-08-21 16:00:00;NORTE;14;0;14;1
2019-08-21 16:30:00;NORTE;33;0;33;1
2019-08-21 17:00:00;NORTE;28;0;28;1
2019-08-21 17:30:00;NORTE;28;0;28;1
2019-08-21 18:00:00;NORTE;32;0;32;1
2019-08-21 18:30:00;SUR;0;18;18;1
2019-08-21 19:00:00;SUR;0;35;35;1
2019-08-21 19:30:00;SUR;0;26;26;1
2019-08-21 20:02:12;SUR;0;1;1;1
2019-08-21 20:18:00;NORTE;5;0;5;1
2019-08-21 20:30:00;NORTE;5;0;5;1
2019-08-21 20:42:00;NORTE;19;0;19;1
2019-08-21 21:00:00;NORTE;13;0;13;1
2019-08-21 21:13:00;NORTE;13;0;13;1
2019-08-21 21:30:00;NORTE;17;0;17;1
2019-08-21 22:00:00;NORTE;28;0;28;1
2019-08-21 22:30:00;NORTE;18;0;18;1
2019-08-21 23:00:00;NORTE;5;0;5;1
2019-08-21 23:30:00;NORTE;5;0;5;1
2019-08-22 00:00:00;NORTE;1;0;1;1
2019-08-22 00:30:00;NORTE;2;0;2;1
2019-08-22 01:00:00;NORTE;1;0;1;1
2019-08-22 01:30:00;NORTE;1;0;1;1
2019-08-22 02:00:00;NORTE;2;0;2;1
2019-08-22 02:30:00;NORTE;5;0;5;1
2019-08-22 03:00:00;NORTE;7;0;7;1
2019-08-22 03:30:00;NORTE;7;0;7;1
2019-08-22 04:00:00;NORTE;11;0;11;1
2019-08-22 04:30:00;NORTE;14;0;14;1
2019-08-22 05:00:00;NORTE;20;0;20;1
2019-08-22 05:30:00;NORTE;40;0;40;1
2019-08-22 06:00:00;NORTE;23;0;23;1
2019-08-22 06:30:00;NORTE;25;0;25;1
2019-08-22 07:00:00;NORTE;30;0;30;1
2019-08-22 07:30:00;NORTE;31;0;31;1
2019-08-22 08:00:00;NORTE;37;0;37;1
2019-08-22 08:30:00;NORTE;32;0;32;1
2019-08-22 09:00:00;NORTE;30;0;30;1
2019-08-22 09:30:00;NORTE;39;0;39;1
2019-08-22 10:00:00;NORTE;29;0;29;1
2019-08-22 10:30:00;NORTE;39;0;39;1
2019-08-22 11:00:00;NORTE;34;0;34;1
2019-08-22 11:30:00;NORTE;29;0;29;1
2019-08-22 12:00:00;NORTE;28;0;28;1
2019-08-22 12:30:00;NORTE;35;0;35;1
2019-08-22 13:00:00;NORTE;38;0;38;1
2019-08-22 13:30:00;NORTE;29;0;29;1
2019-08-22 14:00:00;NORTE;44;0;44;1
2019-08-22 14:30:00;NORTE;36;0;36;1
2019-08-22 15:00:00;NORTE;34;0;34;1
2019-08-22 15:30:00;NORTE;25;1;26;1
2019-08-22 16:00:00;NORTE;22;0;22;1
2019-08-22 16:30:00;NORTE;32;0;32;1
2019-08-22 17:00:00;NORTE;21;0;21;1
2019-08-22 17:30:00;NORTE;30;0;30;1
2019-08-22 18:00:00;NORTE;34;0;34;1
2019-08-22 18:30:00;NORTE;26;0;26;1
2019-08-22 19:00:00;NORTE;29;0;29;1
2019-08-22 19:30:00;NORTE;28;0;28;1
2019-08-22 20:00:00;NORTE;35;0;35;1
2019-08-22 20:30:00;NORTE;29;0;29;1
2019-08-22 21:00:00;NORTE;17;0;17;1
2019-08-22 21:30:00;NORTE;21;0;21;1
2019-08-22 22:00:00;NORTE;18;0;18;1
2019-08-22 22:30:00;NORTE;12;0;12;1
2019-08-22 23:00:00;NORTE;4;0;4;1
2019-08-22 23:30:00;NORTE;2;0;2;1
2019-08-23 00:00:00;NORTE;3;0;3;1
2019-08-23 00:30:00;NORTE;1;0;1;1
2019-08-23 01:30:00;NORTE;1;0;1;1
2019-08-23 02:00:00;NORTE;3;0;3;1
2019-08-23 02:30:00;NORTE;7;0;7;1
2019-08-23 03:00:00;NORTE;4;0;4;1
2019-08-23 03:30:00;NORTE;7;0;7;1
2019-08-23 04:00:00;NORTE;17;0;17;1
2019-08-23 04:30:00;NORTE;11;0;11;1
2019-08-23 05:00:00;NORTE;19;0;19;1
2019-08-23 05:30:00;NORTE;41;0;41;1
2019-08-23 06:00:00;NORTE;22;0;22;1
2019-08-23 06:30:00;NORTE;30;0;30;1
2019-08-23 07:00:00;NORTE;38;0;38;1
2019-08-23 07:30:00;NORTE;28;0;28;1
2019-08-23 08:00:00;NORTE;38;0;38;1
2019-08-23 08:30:00;NORTE;35;0;35;1
2019-08-23 09:00:00;NORTE;29;0;29;1
2019-08-23 09:30:00;NORTE;37;0;37;1
2019-08-23 10:00:00;NORTE;30;0;30;1
2019-08-23 10:30:00;NORTE;35;0;35;1
2019-08-23 11:00:00;NORTE;35;0;35;1
2019-08-23 11:30:00;NORTE;30;0;30;1
2019-08-23 12:00:00;NORTE;30;0;30;1
2019-08-23 12:30:00;NORTE;33;0;33;1
2019-08-23 13:00:00;NORTE;43;0;43;1
2019-08-23 13:30:00;NORTE;41;0;41;1
2019-08-23 14:00:00;NORTE;37;0;37;1
2019-08-23 14:30:00;NORTE;36;0;36;1
2019-08-23 15:00:00;NORTE;33;0;33;1
2019-08-23 15:30:00;NORTE;21;0;21;1
2019-08-23 16:00:00;NORTE;25;0;25;1
2019-08-23 16:30:00;NORTE;36;0;36;1
2019-08-23 17:00:00;NORTE;25;0;25;1
2019-08-23 17:31:04;NORTE;1;0;1;1
2019-08-23 17:32:48;NORTE;1;0;1;1
2019-08-23 17:33:30;NORTE;1;0;1;1
2019-08-23 17:35:57;NORTE;1;0;1;1
2019-08-23 17:36:49;NORTE;1;0;1;1
2019-08-23 17:37:51;NORTE;1;0;1;1
2019-08-23 17:38:33;NORTE;1;0;1;1
2019-08-23 17:40:20;NORTE;1;0;1;1
2019-08-23 17:40:29;NORTE;1;0;1;1
2019-08-23 17:42:39;NORTE;1;0;1;1
2019-08-23 17:43:02;NORTE;1;0;1;1
2019-08-23 17:44:28;NORTE;1;0;1;1
2019-08-23 17:44:50;NORTE;1;0;1;1
2019-08-23 17:45:58;NORTE;1;0;1;1
2019-08-23 17:46:00;NORTE;1;0;1;1
2019-08-23 17:46:52;NORTE;1;0;1;1
2019-08-23 17:47:46;NORTE;1;0;1;1
2019-08-23 17:48:07;NORTE;1;0;1;1
2019-08-23 17:50:26;NORTE;1;0;1;1
2019-08-23 17:50:42;NORTE;1;0;1;1
2019-08-23 17:50:58;NORTE;1;0;1;1
2019-08-23 17:54:16;NORTE;1;0;1;1
2019-08-23 17:55:03;NORTE;1;0;1;1
2019-08-23 17:55:36;NORTE;1;0;1;1
2019-08-23 17:55:52;NORTE;1;0;1;1
2019-08-23 17:56:39;NORTE;1;0;1;1
2019-08-23 17:56:48;NORTE;1;0;1;1
2019-08-23 17:57:23;NORTE;1;0;1;1
2019-08-23 17:58:41;NORTE;1;0;1;1
2019-08-23 17:59:25;NORTE;1;0;1;1
2019-08-23 18:00:55;NORTE;1;0;1;1
2019-08-23 18:02:57;NORTE;1;0;1;1
2019-08-23 18:04:21;NORTE;1;0;1;1
2019-08-23 18:05:28;NORTE;1;0;1;1
2019-08-23 18:06:13;NORTE;1;0;1;1
2019-08-23 18:07:45;NORTE;1;0;1;1
2019-08-23 18:07:56;NORTE;1;0;1;1
2019-08-23 18:09:20;NORTE;1;0;1;1
2019-08-23 18:09:25;NORTE;1;0;1;1
2019-08-23 18:11:19;NORTE;1;0;1;1
2019-08-23 18:12:52;NORTE;1;0;1;1
2019-08-23 18:13:19;NORTE;1;0;1;1
2019-08-23 18:15:09;NORTE;1;0;1;1
2019-08-23 18:15:29;NORTE;1;0;1;1
2019-08-23 18:16:22;NORTE;1;0;1;1
2019-08-23 18:16:36;NORTE;1;0;1;1
2019-08-23 18:18:12;NORTE;1;0;1;1
2019-08-23 18:18:17;NORTE;1;0;1;1
2019-08-23 18:19:26;NORTE;1;0;1;1
2019-08-23 18:19:48;NORTE;1;0;1;1
2019-08-23 18:20:24;NORTE;1;0;1;1
2019-08-23 18:21:48;NORTE;1;0;1;1
2019-08-23 18:22:26;NORTE;1;0;1;1
2019-08-23 18:22:55;NORTE;1;0;1;1
2019-08-23 18:24:15;NORTE;1;0;1;1
2019-08-23 18:24:33;NORTE;1;0;1;1
2019-08-23 18:24:55;NORTE;1;0;1;1
2019-08-23 18:26:09;NORTE;1;0;1;1
2019-08-23 18:26:14;NORTE;1;0;1;1
2019-08-23 18:26:30;NORTE;1;0;1;1
2019-08-23 18:27:42;NORTE;1;0;1;1
2019-08-23 18:28:31;NORTE;1;0;1;1
2019-08-23 18:28:48;NORTE;1;0;1;1
2019-08-23 18:29:06;NORTE;1;0;1;1
2019-08-23 18:29:44;NORTE;1;0;1;1
2019-08-23 18:30:00;NORTE;28;0;28;1
2019-08-23 19:00:00;NORTE;27;0;27;1
2019-08-23 19:30:00;NORTE;31;0;31;1
2019-08-23 20:00:00;NORTE;22;0;22;1
2019-08-23 20:30:00;NORTE;30;0;30;1
2019-08-23 21:00:00;NORTE;16;0;16;1
2019-08-23 21:30:00;NORTE;22;0;22;1
2019-08-23 22:00:00;NORTE;15;0;15;1
2019-08-23 22:30:00;NORTE;9;0;9;1
2019-08-24 00:30:00;NORTE;1;0;1;1
2019-08-24 01:30:00;NORTE;2;0;2;1
2019-08-24 02:00:00;NORTE;7;0;7;1
2019-08-24 02:30:00;NORTE;5;0;5;1
2019-08-24 03:00:00;NORTE;4;0;4;1
2019-08-24 03:30:00;NORTE;5;0;5;1
2019-08-24 04:00:00;NORTE;13;0;13;1
2019-08-24 04:30:00;NORTE;17;0;17;1
2019-08-24 05:00:00;NORTE;24;0;24;1
2019-08-24 05:30:00;NORTE;36;0;36;1
2019-08-24 06:00:00;NORTE;16;0;16;1
2019-08-24 06:30:00;NORTE;23;0;23;1
2019-08-24 07:00:00;NORTE;41;0;41;1
2019-08-24 07:30:00;NORTE;34;0;34;1
2019-08-24 08:00:00;NORTE;30;0;30;1
2019-08-24 08:30:00;NORTE;34;1;35;1
2019-08-24 09:00:00;NORTE;29;0;29;1
2019-08-24 09:30:00;NORTE;33;0;33;1
2019-08-24 10:00:00;NORTE;30;0;30;1
2019-08-24 10:30:00;NORTE;28;0;28;1
2019-08-24 11:00:00;NORTE;32;0;32;1
2019-08-24 11:30:00;SUR;0;29;29;1
2019-08-24 12:00:00;SUR;0;27;27;1
2019-08-24 12:30:00;SUR;0;31;31;1
2019-08-24 13:00:00;SUR;0;34;34;1
2019-08-24 13:30:00;SUR;0;36;36;1
2019-08-24 14:00:00;SUR;0;36;36;1
2019-08-24 14:30:00;SUR;0;32;32;1
2019-08-24 15:00:00;SUR;0;33;33;1
2019-08-24 15:30:00;SUR;0;21;21;1
2019-08-24 16:00:00;SUR;0;16;16;1
2019-08-24 16:30:00;SUR;0;29;29;1
2019-08-24 17:00:00;SUR;0;13;13;1
2019-08-24 17:30:00;CONFLICTIVA;13;11;24;2
2019-08-24 18:00:00;NORTE;30;0;30;1
2019-08-24 18:30:00;NORTE;25;0;25;1
2019-08-24 19:00:00;NORTE;27;0;27;1
2019-08-24 19:30:00;NORTE;29;0;29;1
2019-08-24 20:00:00;NORTE;21;0;21;1
2019-08-24 20:30:00;NORTE;22;0;22;1
2019-08-24 21:00:00;NORTE;15;0;15;1
2019-08-24 21:30:00;NORTE;22;0;22;1
2019-08-24 22:00:00;NORTE;21;0;21;1
2019-08-24 22:30:00;NORTE;7;0;7;1
2019-08-24 23:00:00;NORTE;5;0;5;1
2019-08-24 23:30:00;NORTE;3;0;3;1
2019-08-25 00:00:00;NORTE;4;0;4;1
2019-08-25 00:30:00;NORTE;2;0;2;1
2019-08-25 01:00:00;NORTE;1;0;1;1
2019-08-25 01:30:00;NORTE;1;0;1;1
2019-08-25 02:00:00;NORTE;5;0;5;1
2019-08-25 02:30:00;NORTE;3;0;3;1
2019-08-25 03:00:00;NORTE;2;0;2;1
2019-08-25 03:30:00;NORTE;9;0;9;1
2019-08-25 04:00:00;NORTE;12;0;12;1
2019-08-25 04:30:00;NORTE;13;0;13;1
2019-08-25 05:00:00;NORTE;22;0;22;1
2019-08-25 05:30:00;NORTE;33;0;33;1
2019-08-25 06:00:00;NORTE;20;0;20;1
2019-08-25 06:30:00;NORTE;23;0;23;1
2019-08-25 07:00:00;NORTE;31;0;31;1
2019-08-25 07:30:00;NORTE;28;0;28;1
2019-08-25 08:00:00;NORTE;28;1;29;1
2019-08-25 08:30:00;NORTE;43;0;43;1
2019-08-25 09:00:00;SUR;2;19;21;1
2019-08-25 09:30:00;SUR;0;35;35;1
2019-08-25 10:00:00;SUR;0;30;30;1
2019-08-25 10:30:00;SUR;0;31;31;1
2019-08-25 11:00:00;SUR;0;30;30;1
2019-08-25 11:30:00;SUR;0;28;28;1
2019-08-25 12:00:00;SUR;0;28;28;1
2019-08-25 12:30:00;SUR;0;30;30;1
2019-08-25 13:00:00;SUR;0;43;43;1
2019-08-25 13:30:00;SUR;0;33;33;1
2019-08-25 14:00:00;SUR;0;41;41;1
2019-08-25 14:30:00;SUR;0;36;36;1
2019-08-25 15:00:00;SUR;0;36;36;1
2019-08-25 15:30:00;SUR;0;17;17;1
2019-08-25 16:00:00;SUR;0;22;22;1
2019-08-25 16:30:00;SUR;0;32;32;1
2019-08-25 17:00:00;SUR;0;24;24;1
2019-08-25 17:30:00;SUR;0;28;28;1
2019-08-25 18:00:00;SUR;0;33;33;1
2019-08-25 18:30:00;SUR;0;35;35;1
2019-08-25 19:00:00;SUR;0;31;31;1
2019-08-25 19:30:00;SUR;0;30;30;1
2019-08-25 20:00:00;SUR;0;24;24;1
2019-08-25 20:30:00;SUR;0;23;23;1
2019-08-25 21:00:00;SUR;0;21;21;1
2019-08-25 21:30:00;SUR;0;19;19;1
2019-08-25 22:00:00;SUR;0;18;18;1
2019-08-25 22:30:00;SUR;0;16;16;1
2019-08-25 23:00:00;SUR;0;3;3;1
2019-08-25 23:30:00;SUR;0;2;2;1
2019-08-26 00:00:00;SUR;0;3;3;1
2019-08-26 00:30:00;SUR;0;1;1;1
2019-08-26 01:00:00;SUR;0;1;1;1
2019-08-26 02:00:00;NORTE;5;0;5;1
2019-08-26 02:30:00;NORTE;5;0;5;1
2019-08-26 03:00:00;NORTE;3;0;3;1
2019-08-26 03:30:00;NORTE;6;0;6;1
2019-08-26 04:00:00;NORTE;11;0;11;1
2019-08-26 04:30:00;NORTE;13;0;13;1
2019-08-26 05:00:00;NORTE;22;0;22;1
2019-08-26 05:30:00;NORTE;39;0;39;1
2019-08-26 06:00:00;NORTE;25;0;25;1
2019-08-26 06:30:00;NORTE;26;0;26;1
2019-08-26 07:00:00;NORTE;34;0;34;1
2019-08-26 07:30:00;NORTE;34;0;34;1
2019-08-26 08:00:00;NORTE;36;0;36;1
2019-08-26 08:30:00;NORTE;32;0;32;1
2019-08-26 09:00:00;NORTE;40;0;40;1
2019-08-26 09:30:00;CONFLICTIVA;8;19;27;2
2019-08-26 10:00:00;SUR;0;36;36;1
2019-08-26 10:30:00;SUR;0;31;31;1
2019-08-26 11:00:00;SUR;0;40;40;1
2019-08-26 11:30:00;SUR;0;31;31;1
2019-08-26 12:00:00;SUR;0;25;25;1
2019-08-26 12:30:00;SUR;0;28;28;1
2019-08-26 13:00:00;SUR;0;38;38;1
2019-08-26 13:30:00;SUR;0;32;32;1
2019-08-26 14:00:00;SUR;0;19;19;1
2019-08-26 14:13:00;SUR;0;11;11;1
2019-08-26 14:30:00;SUR;0;10;10;1
2019-08-26 14:38:00;SUR;0;31;31;1
2019-08-26 15:00:00;SUR;0;12;12;1
2019-08-26 15:17:00;SUR;0;14;14;1
2019-08-26 15:30:00;SUR;0;9;9;1
2019-08-26 15:40:00;SUR;0;20;20;1
2019-08-26 16:00:00;SUR;0;19;19;1
2019-08-26 16:30:00;SUR;0;8;8;1
2019-08-26 16:40:00;SUR;0;13;13;1
2019-08-26 17:00:00;SUR;0;35;35;1
2019-08-26 17:30:00;SUR;0;18;18;1
2019-08-26 18:00:00;CONFLICTIVA;6;13;19;2
2019-08-26 18:30:00;NORTE;14;0;14;1
2019-08-26 18:45:00;NORTE;5;0;5;1
2019-08-26 19:13:00;NORTE;3;0;3;1
2019-08-26 19:30:00;CONFLICTIVA;8;7;15;2
2019-08-26 20:00:00;SUR;0;33;33;1
2019-08-26 20:30:00;SUR;0;16;16;1
2019-08-26 21:00:00;NORTE;12;0;12;1
2019-08-26 21:20:00;NORTE;10;0;10;1
2019-08-26 21:30:00;NORTE;20;0;20;1
2019-08-26 22:00:00;NORTE;22;0;22;1
2019-08-26 22:30:00;NORTE;21;0;21;1
2019-08-26 23:00:00;NORTE;20;0;20;1
2019-08-26 23:30:00;NORTE;20;0;20;1
2019-08-27 00:00:00;NORTE;8;0;8;1
2019-08-27 00:30:00;NORTE;5;0;5;1
2019-08-27 01:00:00;NORTE;5;0;5;1
2019-08-27 01:30:00;NORTE;2;0;2;1
2019-08-27 02:00:00;NORTE;5;0;5;1
2019-08-27 02:30:00;NORTE;5;0;5;1
2019-08-27 03:00:00;NORTE;7;0;7;1
2019-08-27 03:30:00;NORTE;5;0;5;1
2019-08-27 04:00:00;NORTE;11;0;11;1
2019-08-27 04:30:00;NORTE;11;0;11;1
2019-08-27 05:00:00;NORTE;23;0;23;1
2019-08-27 05:30:00;NORTE;38;0;38;1
2019-08-27 06:00:00;NORTE;22;0;22;1
2019-08-27 06:30:00;NORTE;23;0;23;1
2019-08-27 07:00:00;NORTE;40;0;40;1
2019-08-27 07:30:00;NORTE;35;0;35;1
2019-08-27 08:00:00;NORTE;36;0;36;1
2019-08-27 08:30:00;NORTE;35;0;35;1
2019-08-27 09:00:00;NORTE;28;0;28;1
2019-08-27 09:30:00;NORTE;30;0;30;1
2019-08-27 10:00:00;NORTE;45;0;45;1
2019-08-27 10:30:00;NORTE;32;0;32;1
2019-08-27 11:00:00;NORTE;25;0;25;1
2019-08-27 11:30:00;NORTE;30;0;30;1
2019-08-27 12:00:00;NORTE;20;0;20;1
2019-08-27 12:30:00;NORTE;30;0;30;1
2019-08-27 13:00:00;NORTE;34;0;34;1
2019-08-27 13:30:00;NORTE;39;0;39;1
2019-08-27 14:00:00;NORTE;44;0;44;1
2019-08-27 14:30:00;NORTE;33;0;33;1
2019-08-27 15:00:00;NORTE;36;0;36;1
2019-08-27 15:30:00;NORTE;28;0;28;1
2019-08-27 16:00:00;NORTE;18;0;18;1
2019-08-27 16:30:00;NORTE;36;0;36;1
2019-08-27 17:00:00;NORTE;26;0;26;1
2019-08-27 17:30:00;NORTE;27;0;27;1
2019-08-27 18:00:00;NORTE;27;0;27;1
2019-08-27 18:30:00;NORTE;31;0;31;1
2019-08-27 19:00:00;NORTE;30;0;30;1
2019-08-27 19:30:00;NORTE;30;0;30;1
2019-08-27 20:00:00;NORTE;23;0;23;1
2019-08-27 20:30:00;NORTE;25;0;25;1
2019-08-27 21:00:00;NORTE;19;0;19;1
2019-08-27 21:30:00;NORTE;20;0;20;1
2019-08-27 22:00:00;NORTE;19;0;19;1
2019-08-27 22:30:00;NORTE;12;0;12;1
2019-08-27 23:00:00;NORTE;5;0;5;1
2019-08-27 23:30:00;NORTE;5;0;5;1
2019-08-28 00:00:00;NORTE;3;0;3;1
2019-08-28 00:30:00;NORTE;1;0;1;1
2019-08-28 02:00:00;NORTE;3;0;3;1
2019-08-28 02:30:00;NORTE;6;0;6;1
2019-08-28 03:00:00;NORTE;3;0;3;1
2019-08-28 03:30:00;NORTE;7;0;7;1
2019-08-28 04:00:00;NORTE;20;0;20;1
2019-08-28 04:30:00;NORTE;12;0;12;1
2019-08-28 05:00:00;NORTE;21;0;21;1
2019-08-28 05:30:00;NORTE;40;0;40;1
2019-08-28 06:00:00;NORTE;25;0;25;1
2019-08-28 06:30:00;NORTE;26;0;26;1
2019-08-28 07:00:00;NORTE;37;0;37;1
2019-08-28 07:30:00;NORTE;31;0;31;1
2019-08-28 08:00:00;NORTE;38;0;38;1
2019-08-28 08:30:00;NORTE;35;0;35;1
2019-08-28 09:00:00;NORTE;26;0;26;1
2019-08-28 09:30:00;NORTE;31;0;31;1
2019-08-28 10:00:00;NORTE;34;0;34;1
2019-08-28 10:30:00;NORTE;33;0;33;1
2019-08-28 11:00:00;NORTE;28;0;28;1
2019-08-28 11:30:00;NORTE;33;0;33;1
2019-08-28 12:00:00;NORTE;17;0;17;1
2019-08-28 12:30:00;NORTE;33;0;33;1
2019-08-28 13:00:00;NORTE;40;0;40;1
2019-08-28 13:30:00;NORTE;26;0;26;1
2019-08-28 14:00:00;NORTE;33;0;33;1
2019-08-28 14:30:00;NORTE;38;0;38;1
2019-08-28 15:00:00;NORTE;35;0;35;1
2019-08-28 15:30:00;NORTE;15;0;15;1
2019-08-28 16:00:00;NORTE;26;0;26;1
2019-08-28 16:30:00;NORTE;33;0;33;1
2019-08-28 17:00:00;NORTE;20;0;20;1
2019-08-28 17:30:00;NORTE;31;0;31;1
2019-08-28 18:00:00;NORTE;36;0;36;1
2019-08-28 18:30:00;NORTE;29;0;29;1
2019-08-28 19:00:00;NORTE;29;0;29;1
2019-08-28 19:30:00;NORTE;31;0;31;1
2019-08-28 20:00:00;NORTE;28;0;28;1
2019-08-28 20:30:00;NORTE;20;0;20;1
2019-08-28 21:00:00;NORTE;20;0;20;1
2019-08-28 21:30:00;NORTE;18;0;18;1
2019-08-28 22:00:00;NORTE;17;0;17;1
2019-08-28 22:30:00;NORTE;8;0;8;1
2019-08-28 23:00:00;NORTE;1;0;1;1
2019-08-28 23:30:00;NORTE;2;0;2;1
2019-08-29 00:00:00;NORTE;2;0;2;1
2019-08-29 00:30:00;NORTE;1;0;1;1
2019-08-29 01:30:00;NORTE;2;0;2;1
2019-08-29 02:00:00;NORTE;3;0;3;1
2019-08-29 02:30:00;NORTE;5;0;5;1
2019-08-29 03:00:00;NORTE;4;0;4;1
2019-08-29 03:30:00;NORTE;7;0;7;1
2019-08-29 04:00:00;NORTE;12;0;12;1
2019-08-29 04:30:00;NORTE;13;0;13;1
2019-08-29 05:00:00;NORTE;19;0;19;1
2019-08-29 05:30:00;NORTE;44;0;44;1
2019-08-29 06:00:00;NORTE;24;0;24;1
2019-08-29 06:30:00;NORTE;26;0;26;1
2019-08-29 07:00:00;NORTE;46;0;46;1
2019-08-29 07:30:00;NORTE;33;0;33;1
2019-08-29 08:00:00;NORTE;31;0;31;1
2019-08-29 08:30:00;NORTE;31;0;31;1
2019-08-29 09:00:00;NORTE;32;0;32;1
2019-08-29 09:30:00;NORTE;30;0;30;1
2019-08-29 10:00:00;NORTE;38;0;38;1
2019-08-29 10:30:00;NORTE;37;0;37;1
2019-08-29 11:00:00;NORTE;30;0;30;1
2019-08-29 11:30:00;NORTE;24;0;24;1
2019-08-29 12:00:00;NORTE;28;0;28;1
2019-08-29 12:30:00;NORTE;36;0;36;1
2019-08-29 13:00:00;NORTE;41;0;41;1
2019-08-29 13:30:00;NORTE;39;0;39;1
2019-08-29 14:00:00;NORTE;37;0;37;1
2019-08-29 14:30:00;NORTE;40;0;40;1
2019-08-29 15:00:35;NORTE;1;0;1;1
2019-08-29 15:01:07;NORTE;1;0;1;1
2019-08-29 15:01:19;NORTE;1;0;1;1
2019-08-29 15:02:18;NORTE;1;0;1;1
2019-08-29 15:02:28;NORTE;1;0;1;1
2019-08-29 15:03:23;NORTE;1;0;1;1
2019-08-29 15:05:12;NORTE;1;0;1;1
2019-08-29 15:05:26;NORTE;1;0;1;1
2019-08-29 15:05:33;NORTE;1;0;1;1
2019-08-29 15:06:12;NORTE;1;0;1;1
2019-08-29 15:06:36;NORTE;1;0;1;1
2019-08-29 15:08:17;NORTE;1;0;1;1
2019-08-29 15:09:50;NORTE;1;0;1;1
2019-08-29 15:10:08;NORTE;1;0;1;1
2019-08-29 15:10:28;NORTE;1;0;1;1
2019-08-29 15:11:58;NORTE;1;0;1;1
2019-08-29 15:12:10;NORTE;1;0;1;1
2019-08-29 15:13:10;NORTE;1;0;1;1
2019-08-29 15:15:34;NORTE;1;0;1;1
2019-08-29 15:16:42;NORTE;1;0;1;1
2019-08-29 15:16:46;NORTE;1;0;1;1
2019-08-29 15:17:46;NORTE;1;0;1;1
2019-08-29 15:18:23;NORTE;1;0;1;1
2019-08-29 15:19:16;NORTE;1;0;1;1
2019-08-29 15:19:17;NORTE;1;0;1;1
2019-08-29 15:20:38;NORTE;1;0;1;1
2019-08-29 15:21:08;NORTE;1;0;1;1
2019-08-29 15:22:01;NORTE;1;0;1;1
2019-08-29 15:22:13;NORTE;1;0;1;1
2019-08-29 15:22:44;NORTE;1;0;1;1
2019-08-29 15:23:40;NORTE;1;0;1;1
2019-08-29 15:24:03;NORTE;1;0;1;1
2019-08-29 15:24:47;NORTE;1;0;1;1
2019-08-29 15:25:40;NORTE;1;0;1;1
2019-08-29 15:26:38;NORTE;1;0;1;1
2019-08-29 15:26:55;NORTE;1;0;1;1
2019-08-29 15:27:50;NORTE;1;0;1;1
2019-08-29 15:28:27;NORTE;1;0;1;1
2019-08-29 15:30:00;NORTE;24;0;24;1
2019-08-29 16:00:00;NORTE;22;0;22;1
2019-08-29 16:30:00;NORTE;27;0;27;1
2019-08-29 17:00:00;NORTE;24;0;24;1
2019-08-29 17:30:00;NORTE;31;0;31;1
2019-08-29 18:00:00;NORTE;33;0;33;1
2019-08-29 18:30:00;NORTE;27;0;27;1
2019-08-29 19:00:00;NORTE;33;0;33;1
2019-08-29 19:30:00;NORTE;29;0;29;1
2019-08-29 20:00:00;NORTE;27;0;27;1
2019-08-29 20:30:00;NORTE;29;0;29;1
2019-08-29 21:00:00;NORTE;16;0;16;1
2019-08-29 21:30:00;NORTE;24;0;24;1
2019-08-29 22:00:00;NORTE;21;0;21;1
2019-08-29 22:30:00;NORTE;11;0;11;1
2019-08-29 23:00:00;NORTE;4;0;4;1
2019-08-29 23:30:00;NORTE;3;0;3;1
2019-08-30 00:00:00;NORTE;1;0;1;1
2019-08-30 00:30:00;NORTE;1;0;1;1
2019-08-30 01:30:00;NORTE;3;0;3;1
2019-08-30 02:00:00;NORTE;3;0;3;1
2019-08-30 02:30:00;NORTE;5;0;5;1
2019-08-30 03:00:00;NORTE;6;0;6;1
2019-08-30 03:30:00;NORTE;7;0;7;1
2019-08-30 04:00:00;NORTE;14;0;14;1
2019-08-30 04:30:00;NORTE;11;0;11;1
2019-08-30 05:00:00;NORTE;23;0;23;1
2019-08-30 05:30:00;NORTE;36;0;36;1
2019-08-30 06:00:00;NORTE;18;0;18;1
2019-08-30 06:30:00;NORTE;26;0;26;1
2019-08-30 07:00:00;NORTE;36;0;36;1
2019-08-30 07:30:00;NORTE;24;0;24;1
2019-08-30 08:00:00;NORTE;38;0;38;1
2019-08-30 08:30:00;NORTE;30;0;30;1
2019-08-30 09:00:00;NORTE;23;0;23;1
2019-08-30 09:30:00;NORTE;34;0;34;1
2019-08-30 10:00:00;NORTE;33;0;33;1
2019-08-30 10:30:00;NORTE;39;0;39;1
2019-08-30 11:00:00;NORTE;33;0;33;1
2019-08-30 11:30:00;NORTE;26;0;26;1
2019-08-30 12:00:00;NORTE;22;0;22;1
2019-08-30 12:30:00;NORTE;37;0;37;1
2019-08-30 13:00:00;NORTE;35;0;35;1
2019-08-30 13:30:00;NORTE;30;0;30;1
2019-08-30 14:00:00;NORTE;34;0;34;1
2019-08-30 14:30:00;NORTE;33;0;33;1
2019-08-30 15:00:00;NORTE;33;0;33;1
2019-08-30 15:30:00;NORTE;32;0;32;1
2019-08-30 16:00:00;NORTE;18;0;18;1
2019-08-30 16:30:00;NORTE;2;0;2;1
2019-08-30 16:37:00;CONFLICTIVA;10;5;15;2
2019-08-30 17:00:00;SUR;0;33;33;1
2019-08-30 17:30:00;SUR;0;26;26;1
2019-08-30 18:00:00;SUR;0;23;23;1
2019-08-30 18:30:00;SUR;0;30;30;1
2019-08-30 19:00:00;SUR;0;35;35;1
2019-08-30 19:30:00;SUR;0;30;30;1
2019-08-30 20:00:00;SUR;0;27;27;1
2019-08-30 20:30:00;SUR;0;29;29;1
2019-08-30 21:00:00;SUR;0;19;19;1
2019-08-30 21:30:00;SUR;0;18;18;1
2019-08-30 22:00:00;NORTE;17;1;18;1
2019-08-30 22:30:00;NORTE;14;0;14;1
2019-08-30 23:00:00;NORTE;2;0;2;1
2019-08-30 23:30:00;NORTE;2;0;2;1
2019-08-31 00:00:00;NORTE;1;0;1;1
2019-08-31 01:00:00;NORTE;1;0;1;1
2019-08-31 01:30:00;NORTE;1;0;1;1
2019-08-31 02:00:00;NORTE;5;0;5;1
2019-08-31 02:30:00;NORTE;4;0;4;1
2019-08-31 03:00:00;NORTE;5;0;5;1
2019-08-31 03:30:00;NORTE;5;0;5;1
2019-08-31 04:00:00;NORTE;13;0;13;1
2019-08-31 04:30:00;NORTE;15;0;15;1
2019-08-31 05:00:00;NORTE;22;0;22;1
2019-08-31 05:30:00;NORTE;34;0;34;1
2019-08-31 06:00:00;NORTE;12;0;12;1
2019-08-31 06:30:00;NORTE;23;0;23;1
2019-08-31 07:00:00;NORTE;36;0;36;1
2019-08-31 07:30:00;NORTE;32;0;32;1
2019-08-31 08:00:00;NORTE;27;0;27;1
2019-08-31 08:30:00;NORTE;36;0;36;1
2019-08-31 09:00:00;NORTE;19;0;19;1
2019-08-31 09:30:00;NORTE;31;0;31;1
2019-08-31 10:00:00;NORTE;29;0;29;1
2019-08-31 10:30:00;NORTE;26;0;26;1
2019-08-31 11:00:00;NORTE;33;0;33;1
2019-08-31 11:30:00;NORTE;26;0;26;1
2019-08-31 12:00:00;NORTE;21;0;21;1
2019-08-31 12:30:00;NORTE;35;0;35;1
2019-08-31 13:00:00;NORTE;35;0;35;1
2019-08-31 13:30:00;NORTE;41;0;41;1
2019-08-31 14:00:00;NORTE;38;0;38;1
2019-08-31 14:30:00;NORTE;30;0;30;1
2019-08-31 15:00:00;NORTE;36;0;36;1
2019-08-31 15:30:00;NORTE;22;0;22;1
2019-08-31 16:00:00;NORTE;16;0;16;1
2019-08-31 16:30:00;NORTE;24;0;24;1
2019-08-31 17:00:00;NORTE;24;0;24;1
2019-08-31 17:30:00;NORTE;15;0;15;1
2019-08-31 18:00:00;NORTE;33;0;33;1
2019-08-31 18:30:00;NORTE;19;0;19;1
2019-08-31 19:00:00;NORTE;24;0;24;1
2019-08-31 19:30:00;NORTE;33;0;33;1
2019-08-31 20:00:00;NORTE;13;0;13;1
2019-08-31 20:30:00;NORTE;31;0;31;1
2019-08-31 21:00:00;NORTE;12;0;12;1
2019-08-31 21:30:00;NORTE;23;0;23;1
2019-08-31 22:00:00;NORTE;15;0;15;1
2019-08-31 22:30:00;NORTE;12;0;12;1
2019-08-31 23:00:00;NORTE;5;0;5;1
2019-08-31 23:30:00;NORTE;1;0;1;1
2019-09-01 00:00:00;NORTE;1;0;1;1
2019-09-01 00:30:00;NORTE;2;0;2;1
2019-09-01 01:00:00;NORTE;3;0;3;1
2019-09-01 01:30:00;NORTE;1;0;1;1
2019-09-01 02:00:00;NORTE;1;0;1;1
2019-09-01 02:30:00;NORTE;3;0;3;1
2019-09-01 03:00:00;NORTE;3;0;3;1
2019-09-01 03:30:00;NORTE;6;0;6;1
2019-09-01 04:00:00;NORTE;15;0;15;1
2019-09-01 04:30:00;NORTE;13;0;13;1
2019-09-01 05:00:00;NORTE;12;0;12;1
2019-09-01 05:30:00;NORTE;32;0;32;1
2019-09-01 06:00:00;NORTE;21;0;21;1
2019-09-01 06:30:00;NORTE;18;0;18;1
2019-09-01 07:00:00;NORTE;30;0;30;1
2019-09-01 07:30:00;NORTE;28;0;28;1
2019-09-01 08:00:00;NORTE;32;0;32;1
2019-09-01 08:30:00;NORTE;34;0;34;1
2019-09-01 09:00:00;NORTE;23;0;23;1
2019-09-01 09:30:00;NORTE;31;0;31;1
2019-09-01 10:00:00;NORTE;28;0;28;1
2019-09-01 10:30:00;NORTE;31;0;31;1
2019-09-01 11:00:00;NORTE;27;0;27;1
2019-09-01 11:30:00;NORTE;27;0;27;1
2019-09-01 12:00:00;NORTE;30;0;30;1
2019-09-01 12:30:00;NORTE;24;1;25;1
2019-09-01 13:00:00;SUR;0;36;36;1
2019-09-01 13:30:00;SUR;0;40;40;1
2019-09-01 14:00:00;SUR;0;28;28;1
2019-09-01 14:30:00;CONFLICTIVA;7;13;20;2
2019-09-01 15:00:00;NORTE;13;0;13;1
2019-09-01 15:30:00;NORTE;37;0;37;1
2019-09-01 16:00:00;NORTE;26;0;26;1
2019-09-01 16:30:00;NORTE;2;0;2;1
2019-09-01 17:00:00;NORTE;3;0;3;1
2019-09-01 17:30:00;NORTE;25;0;25;1
2019-09-01 18:00:00;NORTE;33;0;33;1
2019-09-01 18:30:00;NORTE;27;0;27;1
2019-09-01 19:00:00;NORTE;28;0;28;1
2019-09-01 19:30:00;NORTE;30;0;30;1
2019-09-01 20:00:00;NORTE;38;0;38;1
2019-09-01 20:30:00;NORTE;31;0;31;1
2019-09-01 21:00:00;NORTE;23;0;23;1
2019-09-01 21:30:00;NORTE;26;0;26;1
2019-09-01 22:00:00;NORTE;18;0;18;1
2019-09-01 22:30:00;NORTE;18;0;18;1
2019-09-01 23:00:00;NORTE;8;0;8;1
2019-09-01 23:30:00;NORTE;4;0;4;1
2019-09-02 00:00:00;NORTE;6;0;6;1
2019-09-02 00:30:00;NORTE;1;0;1;1
2019-09-02 01:00:00;NORTE;2;0;2;1
2019-09-02 01:30:00;NORTE;2;0;2;1
2019-09-02 02:00:00;NORTE;3;0;3;1
2019-09-02 02:30:00;NORTE;5;0;5;1
2019-09-02 03:00:00;NORTE;2;0;2;1
2019-09-02 03:30:00;NORTE;8;0;8;1
2019-09-02 04:00:00;NORTE;9;0;9;1
2019-09-02 04:30:00;NORTE;17;0;17;1
2019-09-02 05:00:00;NORTE;23;0;23;1
2019-09-02 05:30:00;NORTE;42;0;42;1
2019-09-02 06:00:00;NORTE;22;0;22;1
2019-09-02 06:30:00;NORTE;24;0;24;1
2019-09-02 07:00:00;NORTE;45;0;45;1
2019-09-02 07:30:00;NORTE;34;0;34;1
2019-09-02 08:00:00;NORTE;33;0;33;1
2019-09-02 08:30:00;NORTE;42;0;42;1
2019-09-02 09:00:00;NORTE;30;0;30;1
2019-09-02 09:30:00;NORTE;33;0;33;1
2019-09-02 10:00:00;NORTE;39;0;39;1
2019-09-02 10:30:00;NORTE;31;0;31;1
2019-09-02 11:00:00;NORTE;33;0;33;1
2019-09-02 11:30:00;NORTE;29;0;29;1
2019-09-02 12:00:00;NORTE;28;0;28;1
2019-09-02 12:30:00;NORTE;37;0;37;1
2019-09-02 13:00:00;NORTE;36;0;36;1
2019-09-02 13:30:00;NORTE;35;0;35;1
2019-09-02 14:00:00;NORTE;40;0;40;1
2019-09-02 14:30:00;NORTE;35;0;35;1
2019-09-02 15:00:00;NORTE;34;0;34;1
2019-09-02 15:30:00;NORTE;27;0;27;1
2019-09-02 16:00:00;NORTE;25;0;25;1
2019-09-02 16:30:00;NORTE;40;0;40;1
2019-09-02 17:00:00;NORTE;27;0;27;1
2019-09-02 17:30:00;NORTE;30;0;30;1
2019-09-02 18:00:00;NORTE;35;0;35;1
2019-09-02 18:30:00;NORTE;35;0;35;1
2019-09-02 19:00:00;NORTE;33;0;33;1
2019-09-02 19:30:00;NORTE;31;0;31;1
2019-09-02 20:00:00;NORTE;27;0;27;1
2019-09-02 20:30:00;NORTE;30;0;30;1
2019-09-02 21:00:00;NORTE;19;0;19;1
2019-09-02 21:30:00;NORTE;13;0;13;1
2019-09-02 22:00:00;NORTE;18;0;18;1
2019-09-02 22:30:00;NORTE;8;0;8;1
2019-09-02 23:00:00;NORTE;2;0;2;1
2019-09-03 00:00:00;NORTE;2;0;2;1
2019-09-03 01:00:00;NORTE;1;0;1;1
2019-09-03 01:30:00;NORTE;1;0;1;1
2019-09-03 02:00:00;NORTE;5;0;5;1
2019-09-03 02:30:00;NORTE;5;0;5;1
2019-09-03 03:00:00;NORTE;8;0;8;1
2019-09-03 03:30:00;NORTE;8;0;8;1
2019-09-03 04:00:00;NORTE;13;0;13;1
2019-09-03 04:30:00;NORTE;15;0;15;1
2019-09-03 05:00:00;NORTE;27;0;27;1
2019-09-03 05:30:00;NORTE;40;0;40;1
2019-09-03 06:00:00;NORTE;27;0;27;1
2019-09-03 06:30:00;NORTE;23;0;23;1
2019-09-03 07:00:00;NORTE;37;0;37;1
2019-09-03 07:30:00;NORTE;36;0;36;1
2019-09-03 08:00:00;NORTE;33;0;33;1
2019-09-03 08:30:00;NORTE;39;0;39;1
2019-09-03 09:00:00;NORTE;31;0;31;1
2019-09-03 09:30:00;NORTE;34;0;34;1
2019-09-03 10:00:00;NORTE;36;0;36;1
2019-09-03 10:30:00;NORTE;31;0;31;1
2019-09-03 11:00:00;NORTE;35;0;35;1
2019-09-03 11:30:00;NORTE;31;0;31;1
2019-09-03 12:00:00;NORTE;33;0;33;1
2019-09-03 12:30:00;NORTE;28;0;28;1
2019-09-03 13:00:00;NORTE;32;0;32;1
2019-09-03 13:30:00;NORTE;37;0;37;1
2019-09-03 14:00:00;NORTE;35;0;35;1
2019-09-03 14:30:00;NORTE;38;0;38;1
2019-09-03 15:00:00;NORTE;33;0;33;1
2019-09-03 15:30:00;NORTE;35;0;35;1
2019-09-03 16:00:00;NORTE;20;0;20;1
2019-09-03 16:30:00;NORTE;36;0;36;1
2019-09-03 17:00:00;NORTE;29;0;29;1
2019-09-03 17:30:00;NORTE;30;0;30;1
2019-09-03 18:00:00;NORTE;38;0;38;1
2019-09-03 18:30:00;NORTE;38;0;38;1
2019-09-03 19:00:00;NORTE;31;0;31;1
2019-09-03 19:30:00;NORTE;31;0;31;1
2019-09-03 20:00:00;NORTE;29;0;29;1
2019-09-03 20:30:00;NORTE;34;0;34;1
2019-09-03 21:00:00;NORTE;22;0;22;1
2019-09-03 21:30:00;NORTE;15;0;15;1
2019-09-03 22:00:00;NORTE;17;0;17;1
2019-09-03 22:30:00;NORTE;8;0;8;1
2019-09-03 23:00:00;NORTE;3;0;3;1
2019-09-03 23:30:00;NORTE;2;0;2;1
2019-09-04 00:00:00;NORTE;2;0;2;1
2019-09-04 00:30:00;NORTE;1;0;1;1
2019-09-04 01:00:00;NORTE;1;0;1;1
2019-09-04 01:30:00;NORTE;1;0;1;1
2019-09-04 02:00:00;NORTE;4;0;4;1
2019-09-04 02:30:00;NORTE;3;0;3;1
2019-09-04 03:00:00;NORTE;6;0;6;1
2019-09-04 03:30:00;NORTE;11;0;11;1
2019-09-04 04:00:00;NORTE;16;0;16;1
2019-09-04 04:30:00;NORTE;12;0;12;1
2019-09-04 05:00:00;NORTE;27;0;27;1
2019-09-04 05:30:00;NORTE;38;0;38;1
2019-09-04 06:00:00;NORTE;26;0;26;1
2019-09-04 06:30:00;NORTE;27;0;27;1
2019-09-04 07:00:00;NORTE;41;0;41;1
2019-09-04 07:30:21;NORTE;1;0;1;1
2019-09-04 07:35:01;NORTE;1;0;1;1
2019-09-04 07:35:08;NORTE;1;0;1;1
2019-09-04 07:35:35;NORTE;1;0;1;1
2019-09-04 07:36:18;NORTE;1;0;1;1
2019-09-04 07:37:59;NORTE;1;0;1;1
2019-09-04 07:38:56;NORTE;1;0;1;1
2019-09-04 07:39:35;NORTE;1;0;1;1
2019-09-04 07:40:33;NORTE;1;0;1;1
2019-09-04 07:41:13;NORTE;1;0;1;1
2019-09-04 07:41:54;NORTE;1;0;1;1
2019-09-04 07:42:32;NORTE;1;0;1;1
2019-09-04 07:42:48;NORTE;1;0;1;1
2019-09-04 07:44:46;NORTE;1;0;1;1
2019-09-04 07:45:03;NORTE;1;0;1;1
2019-09-04 07:46:26;NORTE;1;0;1;1
2019-09-04 07:47:21;NORTE;1;0;1;1
2019-09-04 07:48:49;NORTE;1;0;1;1
2019-09-04 07:51:28;NORTE;1;0;1;1
2019-09-04 07:52:13;NORTE;1;0;1;1
2019-09-04 07:53:29;NORTE;1;0;1;1
2019-09-04 07:54:38;NORTE;1;0;1;1
2019-09-04 07:54:45;NORTE;1;0;1;1
2019-09-04 07:56:28;NORTE;1;0;1;1
2019-09-04 07:56:59;NORTE;1;0;1;1
2019-09-04 07:57:51;NORTE;1;0;1;1
2019-09-04 07:59:04;NORTE;1;0;1;1
2019-09-04 07:59:34;NORTE;1;0;1;1
2019-09-04 08:00:00;NORTE;37;0;37;1
2019-09-04 08:30:00;NORTE;43;0;43;1
2019-09-04 09:00:00;NORTE;31;0;31;1
2019-09-04 09:30:00;NORTE;30;0;30;1
2019-09-04 10:00:00;NORTE;39;0;39;1
2019-09-04 10:30:00;NORTE;37;0;37;1
2019-09-04 11:00:00;NORTE;28;0;28;1
2019-09-04 11:30:00;NORTE;30;0;30;1
2019-09-04 12:00:00;NORTE;29;0;29;1
2019-09-04 12:30:00;NORTE;36;0;36;1
2019-09-04 13:00:00;NORTE;38;0;38;1
2019-09-04 13:30:00;NORTE;32;0;32;1
2019-09-04 14:00:00;NORTE;36;0;36;1
2019-09-04 14:30:00;NORTE;35;0;35;1
2019-09-04 15:00:00;NORTE;34;0;34;1
2019-09-04 15:30:00;NORTE;22;0;22;1
2019-09-04 16:00:00;NORTE;24;0;24;1
2019-09-04 16:30:00;NORTE;34;0;34;1
2019-09-04 17:00:00;NORTE;29;0;29;1
2019-09-04 17:30:00;NORTE;30;0;30;1
2019-09-04 18:00:00;NORTE;41;0;41;1
2019-09-04 18:30:00;NORTE;29;0;29;1
2019-09-04 19:00:00;NORTE;32;0;32;1
2019-09-04 19:30:00;NORTE;30;0;30;1
2019-09-04 20:00:00;NORTE;41;0;41;1
2019-09-04 20:30:00;NORTE;23;0;23;1
2019-09-04 21:00:00;NORTE;17;0;17;1
2019-09-04 21:30:00;NORTE;18;0;18;1
2019-09-04 22:00:00;NORTE;12;0;12;1
2019-09-04 22:30:00;NORTE;6;0;6;1
2019-09-04 23:00:00;NORTE;4;0;4;1
2019-09-04 23:30:00;NORTE;3;0;3;1
2019-09-05 00:30:00;NORTE;1;0;1;1
2019-09-05 01:30:00;NORTE;1;0;1;1
2019-09-05 02:00:00;NORTE;3;0;3;1
2019-09-05 02:30:00;NORTE;5;0;5;1
2019-09-05 03:00:00;NORTE;3;0;3;1
2019-09-05 03:30:00;NORTE;11;0;11;1
2019-09-05 04:00:00;NORTE;12;0;12;1
2019-09-05 04:30:00;NORTE;18;0;18;1
2019-09-05 05:00:00;NORTE;22;0;22;1
2019-09-05 05:30:00;NORTE;46;0;46;1
2019-09-05 06:00:00;NORTE;20;0;20;1
2019-09-05 06:30:00;NORTE;26;0;26;1
2019-09-05 07:00:00;NORTE;40;0;40;1
2019-09-05 07:30:00;NORTE;33;0;33;1
2019-09-05 08:00:00;NORTE;39;0;39;1
2019-09-05 08:30:00;NORTE;36;0;36;1
2019-09-05 09:00:00;NORTE;29;0;29;1
2019-09-05 09:30:00;NORTE;36;0;36;1
2019-09-05 10:00:00;NORTE;30;0;30;1
2019-09-05 10:30:00;NORTE;39;0;39;1
2019-09-05 11:00:00;NORTE;32;0;32;1
2019-09-05 11:30:00;NORTE;24;0;24;1
2019-09-05 12:00:00;NORTE;35;0;35;1
2019-09-05 12:30:00;NORTE;33;0;33;1
2019-09-05 13:00:00;NORTE;42;0;42;1
2019-09-05 13:30:00;NORTE;43;0;43;1
2019-09-05 14:00:00;NORTE;32;0;32;1
2019-09-05 14:30:00;NORTE;37;0;37;1
2019-09-05 15:00:00;NORTE;35;0;35;1
2019-09-05 15:30:00;NORTE;25;0;25;1
2019-09-05 16:00:00;NORTE;14;0;14;1
2019-09-05 16:30:00;NORTE;28;0;28;1
2019-09-05 17:00:00;NORTE;24;0;24;1
2019-09-05 17:30:00;NORTE;33;0;33;1
2019-09-05 18:00:00;NORTE;35;0;35;1
2019-09-05 18:30:00;NORTE;32;0;32;1
2019-09-05 19:00:00;NORTE;34;0;34;1
2019-09-05 19:30:00;NORTE;30;0;30;1
2019-09-05 20:00:00;NORTE;32;0;32;1
2019-09-05 20:30:00;NORTE;29;0;29;1
2019-09-05 21:00:00;NORTE;22;0;22;1
2019-09-05 21:30:00;NORTE;23;0;23;1
2019-09-05 22:00:00;NORTE;18;0;18;1
2019-09-05 22:30:00;NORTE;10;0;10;1
2019-09-05 23:00:00;NORTE;4;0;4;1
2019-09-05 23:30:00;NORTE;3;0;3;1
2019-09-06 00:00:00;NORTE;1;0;1;1
2019-09-06 00:30:00;NORTE;2;0;2;1
2019-09-06 01:00:00;NORTE;1;0;1;1
2019-09-06 01:30:00;NORTE;2;0;2;1
2019-09-06 02:00:00;NORTE;3;0;3;1
2019-09-06 02:30:00;NORTE;7;0;7;1
2019-09-06 03:00:00;NORTE;4;0;4;1
2019-09-06 03:30:00;NORTE;7;0;7;1
2019-09-06 04:00:00;NORTE;11;0;11;1
2019-09-06 04:30:00;NORTE;16;0;16;1
2019-09-06 05:00:00;NORTE;28;1;29;1
2019-09-06 05:30:00;NORTE;36;0;36;1
2019-09-06 06:00:00;NORTE;19;0;19;1
2019-09-06 06:30:00;NORTE;27;0;27;1
2019-09-06 07:00:00;NORTE;37;0;37;1
2019-09-06 07:30:00;NORTE;32;0;32;1
2019-09-06 08:00:00;NORTE;35;0;35;1
2019-09-06 08:30:00;NORTE;35;0;35;1
2019-09-06 09:00:00;NORTE;27;0;27;1
2019-09-06 09:30:00;NORTE;42;0;42;1
2019-09-06 10:00:00;NORTE;31;0;31;1
2019-09-06 10:30:00;NORTE;39;0;39;1
2019-09-06 11:00:00;NORTE;33;0;33;1
2019-09-06 11:30:00;NORTE;31;0;31;1
2019-09-06 12:00:00;NORTE;27;0;27;1
2019-09-06 12:30:00;NORTE;34;0;34;1
2019-09-06 13:00:00;NORTE;41;0;41;1
2019-09-06 13:30:00;NORTE;38;0;38;1
2019-09-06 14:00:00;NORTE;38;0;38;1
2019-09-06 14:30:00;NORTE;36;0;36;1
2019-09-06 15:00:00;NORTE;34;0;34;1
2019-09-06 15:30:00;NORTE;24;0;24;1
2019-09-06 16:00:00;NORTE;18;0;18;1
2019-09-06 16:30:00;NORTE;45;0;45;1
2019-09-06 17:00:00;NORTE;26;0;26;1
2019-09-06 17:30:00;NORTE;29;0;29;1
2019-09-06 18:00:00;NORTE;37;0;37;1
2019-09-06 18:30:00;NORTE;31;0;31;1
2019-09-06 19:00:00;NORTE;34;0;34;1
2019-09-06 19:30:00;NORTE;31;0;31;1
2019-09-06 20:00:00;NORTE;34;0;34;1
2019-09-06 20:30:00;NORTE;26;0;26;1
2019-09-06 21:00:00;NORTE;17;0;17;1
2019-09-06 21:30:00;NORTE;15;0;15;1
2019-09-06 22:00:00;NORTE;15;0;15;1
2019-09-06 22:30:00;NORTE;7;0;7;1
2019-09-06 23:00:00;NORTE;3;0;3;1
2019-09-07 00:00:00;NORTE;1;0;1;1
2019-09-07 01:00:00;NORTE;2;0;2;1
2019-09-07 01:30:00;NORTE;1;0;1;1
2019-09-07 02:00:00;NORTE;5;0;5;1
2019-09-07 02:30:00;NORTE;6;0;6;1
2019-09-07 03:00:00;NORTE;3;0;3;1
2019-09-07 03:30:00;NORTE;5;0;5;1
2019-09-07 04:00:00;NORTE;15;0;15;1
2019-09-07 04:30:00;NORTE;12;0;12;1
2019-09-07 05:00:00;NORTE;26;0;26;1
2019-09-07 05:30:00;NORTE;28;0;28;1
2019-09-07 06:00:00;NORTE;24;0;24;1
2019-09-07 06:30:00;NORTE;34;0;34;1
2019-09-07 07:00:00;NORTE;37;0;37;1
2019-09-07 07:30:00;NORTE;34;0;34;1
2019-09-07 08:00:00;NORTE;26;0;26;1
2019-09-07 08:30:00;NORTE;37;0;37;1
2019-09-07 09:00:00;NORTE;27;0;27;1
2019-09-07 09:30:00;NORTE;34;0;34;1
2019-09-07 10:00:00;NORTE;38;0;38;1
2019-09-07 10:30:00;NORTE;33;0;33;1
2019-09-07 11:00:00;NORTE;28;0;28;1
2019-09-07 11:30:00;NORTE;33;0;33;1
2019-09-07 12:00:00;NORTE;27;0;27;1
2019-09-07 12:30:00;NORTE;34;0;34;1
2019-09-07 13:00:00;NORTE;30;0;30;1
2019-09-07 13:30:00;NORTE;37;0;37;1
2019-09-07 14:00:00;NORTE;37;0;37;1
2019-09-07 14:30:00;NORTE;30;0;30;1
2019-09-07 15:00:00;NORTE;23;0;23;1
2019-09-07 15:30:00;NORTE;25;0;25;1
2019-09-07 16:00:00;NORTE;16;0;16;1
2019-09-07 16:30:00;NORTE;30;0;30;1
2019-09-07 17:00:00;NORTE;23;0;23;1
2019-09-07 17:30:00;NORTE;20;0;20;1
2019-09-07 18:00:00;NORTE;39;0;39;1
2019-09-07 18:30:00;NORTE;19;0;19;1
2019-09-07 19:00:00;NORTE;28;0;28;1
2019-09-07 19:30:00;NORTE;33;0;33;1
2019-09-07 20:00:00;NORTE;19;0;19;1
2019-09-07 20:30:00;NORTE;16;0;16;1
2019-09-07 21:00:00;NORTE;16;0;16;1
2019-09-07 21:30:00;NORTE;19;0;19;1
2019-09-07 22:00:00;NORTE;18;0;18;1
2019-09-07 22:30:00;NORTE;6;0;6;1
2019-09-07 23:00:00;NORTE;2;0;2;1
2019-09-07 23:30:00;NORTE;2;0;2;1
2019-09-08 00:30:00;NORTE;2;0;2;1
2019-09-08 01:00:00;NORTE;2;0;2;1
2019-09-08 01:30:00;NORTE;2;0;2;1
2019-09-08 02:30:00;NORTE;3;0;3;1
2019-09-08 03:00:00;NORTE;4;0;4;1
2019-09-08 03:30:00;NORTE;6;0;6;1
2019-09-08 04:00:00;NORTE;14;0;14;1
2019-09-08 04:30:00;NORTE;14;0;14;1
2019-09-08 05:00:00;NORTE;18;0;18;1
2019-09-08 05:30:00;NORTE;30;0;30;1
2019-09-08 06:00:00;NORTE;19;0;19;1
2019-09-08 06:30:00;NORTE;27;0;27;1
2019-09-08 07:00:00;NORTE;34;0;34;1
2019-09-08 07:30:00;NORTE;25;0;25;1
2019-09-08 08:00:00;NORTE;36;0;36;1
2019-09-08 08:30:00;NORTE;34;0;34;1
2019-09-08 09:00:00;NORTE;25;0;25;1
2019-09-08 09:30:00;NORTE;36;0;36;1
2019-09-08 10:00:00;NORTE;30;0;30;1
2019-09-08 10:30:00;NORTE;37;0;37;1
2019-09-08 11:00:00;NORTE;34;0;34;1
2019-09-08 11:30:00;NORTE;28;0;28;1
2019-09-08 12:00:00;NORTE;31;0;31;1
2019-09-08 12:30:00;NORTE;30;0;30;1
2019-09-08 13:00:00;NORTE;42;0;42;1
2019-09-08 13:30:00;NORTE;37;0;37;1
2019-09-08 14:00:00;NORTE;36;0;36;1
2019-09-08 14:30:00;NORTE;47;0;47;1
2019-09-08 15:00:00;NORTE;35;0;35;1
2019-09-08 15:30:00;NORTE;25;0;25;1
2019-09-08 16:00:00;NORTE;18;0;18;1
2019-09-08 16:30:00;NORTE;32;0;32;1
2019-09-08 17:00:00;NORTE;19;0;19;1
2019-09-08 17:30:00;NORTE;32;0;32;1
2019-09-08 18:00:00;NORTE;36;0;36;1
2019-09-08 18:30:00;NORTE;33;0;33;1
2019-09-08 19:00:00;NORTE;35;0;35;1
2019-09-08 19:30:00;NORTE;27;0;27;1
2019-09-08 20:00:00;NORTE;33;0;33;1
2019-09-08 20:30:00;NORTE;27;0;27;1
2019-09-08 21:00:00;NORTE;22;0;22;1
2019-09-08 21:30:00;NORTE;21;0;21;1
2019-09-08 22:00:00;NORTE;23;0;23;1
2019-09-08 22:30:00;NORTE;8;0;8;1
2019-09-08 23:00:00;NORTE;3;0;3;1
2019-09-08 23:30:00;NORTE;2;0;2;1
2019-09-09 00:00:00;NORTE;5;0;5;1
2019-09-09 00:30:00;NORTE;2;0;2;1
2019-09-09 01:30:00;NORTE;2;0;2;1
2019-09-09 02:00:00;NORTE;6;0;6;1
2019-09-09 02:30:00;NORTE;4;0;4;1
2019-09-09 03:00:00;NORTE;1;0;1;1
2019-09-09 03:30:00;NORTE;9;0;9;1
2019-09-09 04:00:00;NORTE;8;0;8;1
2019-09-09 04:30:00;NORTE;11;0;11;1
2019-09-09 05:00:00;NORTE;25;0;25;1
2019-09-09 05:30:00;NORTE;47;0;47;1
2019-09-09 06:00:00;NORTE;26;0;26;1
2019-09-09 06:30:00;NORTE;31;0;31;1
2019-09-09 07:00:00;NORTE;32;0;32;1
2019-09-09 07:30:00;NORTE;32;0;32;1
2019-09-09 08:00:00;NORTE;35;0;35;1
2019-09-09 08:30:00;NORTE;40;0;40;1
2019-09-09 09:00:00;NORTE;25;0;25;1
2019-09-09 09:30:00;NORTE;39;0;39;1
2019-09-09 10:00:00;NORTE;40;0;40;1
2019-09-09 10:30:00;NORTE;30;0;30;1
2019-09-09 11:00:00;CONFLICTIVA;4;25;29;2
2019-09-09 11:30:00;SUR;0;32;32;1
2019-09-09 12:00:00;SUR;0;29;29;1
2019-09-09 12:30:00;SUR;0;34;34;1
2019-09-09 13:00:00;SUR;0;40;40;1
2019-09-09 13:30:00;SUR;0;39;39;1
2019-09-09 14:00:00;SUR;0;40;40;1
2019-09-09 14:30:00;SUR;0;31;31;1
2019-09-09 15:00:00;SUR;0;34;34;1
2019-09-09 15:30:00;SUR;0;20;20;1
2019-09-09 16:00:00;SUR;0;24;24;1
2019-09-09 16:30:00;SUR;0;35;35;1
2019-09-09 17:00:00;SUR;0;25;25;1
2019-09-09 17:30:00;SUR;0;27;27;1
2019-09-09 18:00:00;SUR;0;39;39;1
2019-09-09 18:30:00;CONFLICTIVA;24;3;27;2
2019-09-09 19:00:00;NORTE;34;0;34;1
2019-09-09 19:30:00;NORTE;33;0;33;1
2019-09-09 20:00:00;NORTE;29;0;29;1
2019-09-09 20:30:00;NORTE;26;0;26;1
2019-09-09 21:00:00;NORTE;22;0;22;1
2019-09-09 21:30:00;NORTE;14;0;14;1
2019-09-09 22:00:00;NORTE;13;0;13;1
2019-09-09 22:30:00;NORTE;8;0;8;1
2019-09-09 23:00:00;NORTE;3;0;3;1
2019-09-09 23:30:00;NORTE;3;0;3;1
2019-09-10 01:00:33;NORTE;1;0;1;1
2019-09-10 01:30:00;NORTE;1;0;1;1
2019-09-10 02:00:00;NORTE;6;0;6;1
2019-09-10 02:30:00;NORTE;5;0;5;1
2019-09-10 03:00:00;NORTE;3;0;3;1
2019-09-10 03:30:00;NORTE;5;0;5;1
2019-09-10 04:00:00;NORTE;14;0;14;1
2019-09-10 04:30:00;NORTE;12;0;12;1
2019-09-10 05:00:00;NORTE;29;0;29;1
2019-09-10 05:30:00;NORTE;44;0;44;1
2019-09-10 06:00:00;NORTE;14;0;14;1
2019-09-10 06:30:00;NORTE;26;0;26;1
2019-09-10 07:00:00;NORTE;40;0;40;1
2019-09-10 07:30:00;NORTE;32;0;32;1
2019-09-10 08:00:00;NORTE;39;0;39;1
2019-09-10 08:30:00;NORTE;39;0;39;1
2019-09-10 09:00:00;NORTE;26;0;26;1
2019-09-10 09:30:00;NORTE;41;0;41;1
2019-09-10 10:00:00;NORTE;36;0;36;1
2019-09-10 10:30:00;NORTE;38;0;38;1
2019-09-10 11:00:00;NORTE;24;0;24;1
2019-09-10 11:30:00;NORTE;36;0;36;1
2019-09-10 12:00:00;NORTE;23;0;23;1
2019-09-10 12:30:00;NORTE;29;0;29;1
2019-09-10 13:00:00;NORTE;42;0;42;1
2019-09-10 13:30:00;NORTE;32;0;32;1
2019-09-10 14:00:00;NORTE;40;0;40;1
2019-09-10 14:30:00;NORTE;38;0;38;1
2019-09-10 15:00:00;NORTE;29;0;29;1
2019-09-10 15:30:00;NORTE;24;0;24;1
2019-09-10 16:00:00;NORTE;29;0;29;1
2019-09-10 16:30:00;NORTE;34;0;34;1
2019-09-10 17:00:00;NORTE;25;0;25;1
2019-09-10 17:30:00;NORTE;29;0;29;1
2019-09-10 18:00:00;NORTE;37;0;37;1
2019-09-10 18:30:00;NORTE;32;0;32;1
2019-09-10 19:00:00;NORTE;31;0;31;1
2019-09-10 19:30:00;NORTE;34;0;34;1
2019-09-10 20:00:00;NORTE;31;0;31;1
2019-09-10 20:30:00;NORTE;25;0;25;1
2019-09-10 21:00:00;NORTE;24;0;24;1
2019-09-10 21:30:00;NORTE;18;0;18;1
2019-09-10 22:00:00;NORTE;13;0;13;1
2019-09-10 22:30:00;NORTE;9;0;9;1
2019-09-10 23:00:00;NORTE;8;0;8;1
2019-09-10 23:30:00;NORTE;4;0;4;1
2019-09-11 01:00:00;NORTE;1;0;1;1
2019-09-11 01:30:00;NORTE;1;0;1;1
2019-09-11 02:00:00;NORTE;3;0;3;1
2019-09-11 02:30:00;NORTE;3;0;3;1
2019-09-11 03:00:00;NORTE;3;0;3;1
2019-09-11 03:30:00;NORTE;6;0;6;1
2019-09-11 04:00:00;NORTE;16;0;16;1
2019-09-11 04:30:00;NORTE;17;0;17;1
2019-09-11 05:00:00;NORTE;26;0;26;1
2019-09-11 05:30:00;NORTE;23;0;23;1
2019-09-11 06:00:00;NORTE;14;0;14;1
2019-09-11 06:30:00;NORTE;27;0;27;1
2019-09-11 07:00:00;NORTE;40;0;40;1
2019-09-11 07:30:00;NORTE;31;0;31;1
2019-09-11 08:00:00;NORTE;37;0;37;1
2019-09-11 08:30:00;NORTE;35;0;35;1
2019-09-11 09:00:00;NORTE;30;0;30;1
2019-09-11 09:30:00;NORTE;38;0;38;1
2019-09-11 10:00:00;NORTE;31;0;31;1
2019-09-11 10:30:00;NORTE;34;0;34;1
2019-09-11 11:00:00;NORTE;32;0;32;1
2019-09-11 11:30:00;NORTE;29;0;29;1
2019-09-11 12:00:00;NORTE;29;1;30;1
2019-09-11 12:30:00;NORTE;28;0;28;1
2019-09-11 13:00:00;NORTE;43;0;43;1
2019-09-11 13:30:00;NORTE;36;0;36;1
2019-09-11 14:00:00;NORTE;36;0;36;1
2019-09-11 14:30:00;NORTE;34;0;34;1
2019-09-11 15:00:00;NORTE;9;0;9;1
2019-09-11 15:30:00;NORTE;17;0;17;1
2019-09-11 16:00:00;NORTE;25;0;25;1
2019-09-11 16:30:00;NORTE;41;0;41;1
2019-09-11 17:00:00;NORTE;20;0;20;1
2019-09-11 17:30:00;NORTE;38;0;38;1
2019-09-11 18:00:00;NORTE;39;0;39;1
2019-09-11 18:30:05;NORTE;1;0;1;1
2019-09-11 18:31:00;NORTE;1;0;1;1
2019-09-11 18:31:44;NORTE;1;0;1;1
2019-09-11 18:32:50;NORTE;1;0;1;1
2019-09-11 18:33:21;NORTE;1;0;1;1
2019-09-11 18:34:23;NORTE;1;0;1;1
2019-09-11 18:34:40;NORTE;1;0;1;1
2019-09-11 18:36:05;NORTE;1;0;1;1
2019-09-11 18:37:10;NORTE;1;0;1;1
2019-09-11 18:38:47;NORTE;1;0;1;1
2019-09-11 18:39:08;NORTE;1;0;1;1
2019-09-11 18:39:44;NORTE;1;0;1;1
2019-09-11 18:41:23;NORTE;1;0;1;1
2019-09-11 18:42:06;NORTE;1;0;1;1
2019-09-11 18:44:01;NORTE;1;0;1;1
2019-09-11 18:44:17;NORTE;1;0;1;1
2019-09-11 18:46:25;NORTE;1;0;1;1
2019-09-11 18:46:29;NORTE;1;0;1;1
2019-09-11 18:48:11;NORTE;1;0;1;1
2019-09-11 18:48:24;NORTE;1;0;1;1
2019-09-11 18:49:14;NORTE;1;0;1;1
2019-09-11 18:49:48;NORTE;1;0;1;1
2019-09-11 18:49:57;NORTE;1;0;1;1
2019-09-11 18:49:59;NORTE;1;0;1;1
2019-09-11 18:51:25;NORTE;1;0;1;1
2019-09-11 18:52:44;NORTE;1;0;1;1
2019-09-11 18:53:32;NORTE;1;0;1;1
2019-09-11 18:53:33;NORTE;1;0;1;1
2019-09-11 18:53:58;NORTE;1;0;1;1
2019-09-11 18:54:45;NORTE;1;0;1;1
2019-09-11 18:55:59;NORTE;1;0;1;1
2019-09-11 18:56:02;NORTE;1;0;1;1
2019-09-11 18:56:31;NORTE;1;0;1;1
2019-09-11 18:57:44;NORTE;1;0;1;1
2019-09-11 18:59:20;NORTE;1;0;1;1
2019-09-11 19:00:00;NORTE;29;0;29;1
2019-09-11 19:30:00;NORTE;33;0;33;1
2019-09-11 20:00:00;NORTE;32;0;32;1
2019-09-11 20:30:00;NORTE;22;0;22;1
2019-09-11 21:00:00;NORTE;19;0;19;1
2019-09-11 21:30:00;NORTE;13;0;13;1
2019-09-11 22:00:00;NORTE;20;0;20;1
2019-09-11 22:30:00;NORTE;9;0;9;1
2019-09-11 23:30:00;NORTE;1;0;1;1
2019-09-12 00:00:00;NORTE;2;0;2;1
2019-09-12 00:30:00;NORTE;1;0;1;1
2019-09-12 01:00:00;NORTE;1;0;1;1
2019-09-12 01:30:00;NORTE;1;0;1;1
2019-09-12 02:00:00;NORTE;4;0;4;1
2019-09-12 02:30:00;NORTE;5;0;5;1
2019-09-12 03:00:00;NORTE;5;0;5;1
2019-09-12 03:30:00;NORTE;6;0;6;1
2019-09-12 04:00:00;NORTE;13;0;13;1
2019-09-12 04:30:00;NORTE;16;0;16;1
2019-09-12 05:00:00;NORTE;27;0;27;1
2019-09-12 05:30:00;NORTE;38;0;38;1
2019-09-12 06:00:00;NORTE;25;0;25;1
2019-09-12 06:30:00;NORTE;26;0;26;1
2019-09-12 07:00:00;NORTE;37;0;37;1
2019-09-12 07:30:00;NORTE;37;0;37;1
2019-09-12 08:00:00;NORTE;35;0;35;1
2019-09-12 08:30:00;NORTE;38;0;38;1
2019-09-12 09:00:00;NORTE;24;0;24;1
2019-09-12 09:30:00;NORTE;43;0;43;1
2019-09-12 10:00:00;NORTE;38;0;38;1
2019-09-12 10:30:00;NORTE;39;0;39;1
2019-09-12 11:00:00;NORTE;34;0;34;1
2019-09-12 11:30:00;NORTE;31;0;31;1
2019-09-12 12:00:00;NORTE;29;0;29;1
2019-09-12 12:30:00;NORTE;34;0;34;1
2019-09-12 13:00:00;NORTE;39;0;39;1
2019-09-12 13:30:00;NORTE;28;0;28;1
2019-09-12 14:00:00;NORTE;34;0;34;1
2019-09-12 14:30:00;NORTE;33;0;33;1
2019-09-12 15:00:00;NORTE;35;0;35;1
2019-09-12 15:30:00;CONFLICTIVA;27;5;32;2
2019-09-12 16:00:00;SUR;0;26;26;1
2019-09-12 16:30:00;SUR;0;29;29;1
2019-09-12 17:00:00;SUR;0;28;28;1
2019-09-12 17:30:00;SUR;0;34;34;1
2019-09-12 18:00:00;CONFLICTIVA;11;19;30;2
2019-09-12 18:30:00;NORTE;40;0;40;1
2019-09-12 19:00:00;NORTE;30;0;30;1
2019-09-12 19:30:00;NORTE;34;0;34;1
2019-09-12 20:00:00;NORTE;32;0;32;1
2019-09-12 20:30:00;NORTE;25;0;25;1
2019-09-12 21:00:00;NORTE;22;0;22;1
2019-09-12 21:30:00;NORTE;23;0;23;1
2019-09-12 22:00:00;NORTE;14;0;14;1
2019-09-12 22:30:00;NORTE;9;0;9;1
2019-09-12 23:00:00;NORTE;5;0;5;1
2019-09-12 23:30:00;NORTE;3;0;3;1
2019-09-13 00:30:00;NORTE;1;0;1;1
2019-09-13 01:30:00;NORTE;2;0;2;1
2019-09-13 02:00:00;NORTE;2;0;2;1
2019-09-13 02:30:00;NORTE;4;0;4;1
2019-09-13 03:00:00;NORTE;7;0;7;1
2019-09-13 03:30:00;NORTE;6;0;6;1
2019-09-13 04:00:00;NORTE;16;0;16;1
2019-09-13 04:30:00;NORTE;11;0;11;1
2019-09-13 05:00:00;NORTE;23;0;23;1
2019-09-13 05:30:00;NORTE;42;1;43;1
2019-09-13 06:00:00;NORTE;26;0;26;1
2019-09-13 06:30:00;NORTE;26;0;26;1
2019-09-13 07:00:00;NORTE;40;0;40;1
2019-09-13 07:30:00;NORTE;31;0;31;1
2019-09-13 08:00:00;NORTE;29;0;29;1
2019-09-13 08:30:00;NORTE;40;0;40;1
2019-09-13 09:00:00;NORTE;27;0;27;1
2019-09-13 09:30:00;NORTE;34;0;34;1
2019-09-13 10:00:00;NORTE;41;0;41;1
2019-09-13 10:30:00;NORTE;36;0;36;1
2019-09-13 11:00:00;NORTE;27;0;27;1
2019-09-13 11:30:00;NORTE;33;0;33;1
2019-09-13 12:00:00;CONFLICTIVA;10;14;24;2
2019-09-13 12:30:00;SUR;0;31;31;1
2019-09-13 13:00:00;SUR;0;42;42;1
2019-09-13 13:30:00;CONFLICTIVA;3;25;28;2
2019-09-13 14:00:00;NORTE;44;0;44;1
2019-09-13 14:30:00;NORTE;44;0;44;1
2019-09-13 15:00:00;NORTE;30;0;30;1
2019-09-13 15:30:00;NORTE;31;0;31;1
2019-09-13 16:00:00;NORTE;21;0;21;1
2019-09-13 16:30:00;NORTE;34;0;34;1
2019-09-13 17:00:00;NORTE;29;0;29;1
2019-09-13 17:30:00;NORTE;26;0;26;1
2019-09-13 18:00:00;NORTE;38;0;38;1
2019-09-13 18:30:00;NORTE;30;0;30;1
2019-09-13 19:00:00;NORTE;36;0;36;1
2019-09-13 19:30:00;NORTE;32;0;32;1
2019-09-13 20:00:00;NORTE;35;0;35;1
2019-09-13 20:30:00;NORTE;27;0;27;1
2019-09-13 21:00:00;NORTE;9;0;9;1
2019-09-13 21:30:00;NORTE;20;0;20;1
2019-09-13 22:00:00;NORTE;21;0;21;1
2019-09-13 22:30:00;NORTE;8;0;8;1
2019-09-13 23:00:00;NORTE;3;0;3;1
2019-09-13 23:30:00;NORTE;3;0;3;1
2019-09-14 00:00:00;NORTE;3;0;3;1
2019-09-14 00:30:00;NORTE;3;0;3;1
2019-09-14 01:00:00;NORTE;1;0;1;1
2019-09-14 02:00:00;NORTE;3;0;3;1
2019-09-14 02:30:00;NORTE;7;0;7;1
2019-09-14 03:00:00;NORTE;4;0;4;1
2019-09-14 03:30:00;NORTE;5;0;5;1
2019-09-14 04:00:00;NORTE;15;0;15;1
2019-09-14 04:30:00;NORTE;10;0;10;1
2019-09-14 05:00:00;NORTE;21;0;21;1
2019-09-14 05:30:00;NORTE;35;0;35;1
2019-09-14 06:00:00;NORTE;23;0;23;1
2019-09-14 06:30:00;NORTE;27;0;27;1
2019-09-14 07:00:00;NORTE;38;0;38;1
2019-09-14 07:30:00;NORTE;31;0;31;1
2019-09-14 08:00:00;NORTE;37;0;37;1
2019-09-14 08:30:00;NORTE;38;0;38;1
2019-09-14 09:00:00;NORTE;28;0;28;1
2019-09-14 09:30:00;NORTE;35;0;35;1
2019-09-14 10:00:00;NORTE;35;0;35;1
2019-09-14 10:30:00;NORTE;21;2;23;1
2019-09-14 11:00:00;SUR;0;11;11;1
2019-09-14 11:14:00;SUR;0;18;18;1
2019-09-14 11:30:00;SUR;0;27;27;1
2019-09-14 12:00:00;SUR;0;24;24;1
2019-09-14 12:30:00;CONFLICTIVA;8;17;25;2
2019-09-14 13:00:00;NORTE;18;0;18;1
2019-09-14 13:15:00;NORTE;21;0;21;1
2019-09-14 13:30:00;NORTE;26;0;26;1
2019-09-14 14:00:00;SUR;1;39;40;1
2019-09-14 14:30:00;SUR;0;37;37;1
2019-09-14 15:00:00;SUR;0;31;31;1
2019-09-14 15:30:00;SUR;0;17;17;1
2019-09-14 15:48:00;NORTE;12;0;12;1
2019-09-14 16:00:00;NORTE;25;0;25;1
2019-09-14 16:30:00;NORTE;6;0;6;1
2019-09-14 16:37:00;NORTE;15;0;15;1
2019-09-14 16:51:00;NORTE;8;0;8;1
2019-09-14 17:00:00;NORTE;22;0;22;1
2019-09-14 17:30:00;NORTE;14;0;14;1
2019-09-14 18:00:00;NORTE;35;0;35;1
2019-09-14 18:30:00;NORTE;26;0;26;1
2019-09-14 19:00:00;NORTE;26;0;26;1
2019-09-14 19:30:00;NORTE;32;0;32;1
2019-09-14 20:00:00;NORTE;22;0;22;1
2019-09-14 20:30:00;NORTE;19;0;19;1
2019-09-14 21:00:00;NORTE;19;0;19;1
2019-09-14 21:30:00;NORTE;15;0;15;1
2019-09-14 22:00:00;NORTE;16;0;16;1
2019-09-14 22:30:00;NORTE;10;0;10;1
2019-09-14 23:00:00;NORTE;2;0;2;1
2019-09-14 23:30:00;NORTE;1;0;1;1
2019-09-15 00:00:00;NORTE;1;0;1;1
2019-09-15 00:30:00;NORTE;3;0;3;1
2019-09-15 01:00:00;NORTE;1;0;1;1
2019-09-15 01:30:00;NORTE;2;0;2;1
2019-09-15 02:00:00;NORTE;3;0;3;1
2019-09-15 02:30:00;NORTE;2;0;2;1
2019-09-15 03:00:00;NORTE;5;0;5;1
2019-09-15 03:30:00;NORTE;2;0;2;1
2019-09-15 04:00:00;NORTE;16;0;16;1
2019-09-15 04:30:00;NORTE;11;0;11;1
2019-09-15 05:00:00;NORTE;17;0;17;1
2019-09-15 05:30:00;NORTE;30;0;30;1
2019-09-15 06:00:00;NORTE;21;0;21;1
2019-09-15 06:30:00;NORTE;27;0;27;1
2019-09-15 07:00:00;NORTE;31;0;31;1
2019-09-15 07:30:00;NORTE;23;0;23;1
2019-09-15 08:00:00;NORTE;23;0;23;1
2019-09-15 08:18:00;NORTE;13;0;13;1
2019-09-15 08:30:00;NORTE;16;0;16;1
2019-09-15 08:44:00;NORTE;20;0;20;1
2019-09-15 09:00:00;NORTE;31;0;31;1
2019-09-15 09:30:00;NORTE;30;0;30;1
2019-09-15 10:00:00;NORTE;30;0;30;1
2019-09-15 10:30:00;NORTE;34;0;34;1
2019-09-15 11:00:00;NORTE;30;0;30;1
2019-09-15 11:30:00;NORTE;28;0;28;1
2019-09-15 12:00:00;NORTE;19;0;19;1
2019-09-15 12:19:00;NORTE;10;0;10;1
2019-09-15 12:30:00;NORTE;8;0;8;1
2019-09-15 12:41:00;NORTE;16;0;16;1
2019-09-15 13:00:00;NORTE;39;0;39;1
2019-09-15 13:30:00;NORTE;26;0;26;1
2019-09-15 13:53:00;NORTE;7;0;7;1
2019-09-15 14:00:00;NORTE;40;0;40;1
2019-09-15 14:30:00;NORTE;38;0;38;1
2019-09-15 15:00:00;NORTE;33;0;33;1
2019-09-15 15:30:00;NORTE;32;0;32;1
2019-09-15 16:00:00;NORTE;26;0;26;1
2019-09-15 16:30:00;NORTE;28;0;28;1
2019-09-15 17:00:00;NORTE;32;0;32;1
2019-09-15 17:30:00;NORTE;31;0;31;1
2019-09-15 18:00:00;NORTE;33;0;33;1
2019-09-15 18:30:00;NORTE;31;0;31;1
2019-09-15 19:00:00;NORTE;36;0;36;1
2019-09-15 19:30:00;NORTE;28;0;28;1
2019-09-15 20:00:00;NORTE;25;0;25;1
2019-09-15 20:30:00;NORTE;31;0;31;1
2019-09-15 21:00:00;NORTE;18;0;18;1
2019-09-15 21:30:00;NORTE;25;0;25;1
2019-09-15 22:00:00;NORTE;25;0;25;1
2019-09-15 22:30:00;NORTE;12;0;12;1
2019-09-15 23:00:00;NORTE;4;0;4;1
2019-09-15 23:30:00;NORTE;1;0;1;1
2019-09-16 00:00:00;NORTE;3;0;3;1
2019-09-16 00:30:00;NORTE;2;0;2;1
2019-09-16 01:00:00;NORTE;1;0;1;1
2019-09-16 02:00:00;NORTE;5;0;5;1
2019-09-16 02:30:00;NORTE;7;0;7;1
2019-09-16 03:30:00;NORTE;6;0;6;1
2019-09-16 04:00:00;NORTE;12;0;12;1
2019-09-16 04:30:00;NORTE;10;0;10;1
2019-09-16 05:00:00;NORTE;21;0;21;1
2019-09-16 05:30:00;NORTE;42;0;42;1
2019-09-16 06:00:00;NORTE;26;0;26;1
2019-09-16 06:30:00;NORTE;27;0;27;1
2019-09-16 07:00:00;NORTE;38;0;38;1
2019-09-16 07:30:00;NORTE;32;0;32;1
2019-09-16 08:00:00;NORTE;33;0;33;1
2019-09-16 08:30:00;NORTE;42;0;42;1
2019-09-16 09:00:00;NORTE;34;0;34;1
2019-09-16 09:30:00;NORTE;35;0;35;1
2019-09-16 10:00:00;NORTE;40;0;40;1
2019-09-16 10:30:00;NORTE;38;0;38;1
2019-09-16 11:00:00;NORTE;35;0;35;1
2019-09-16 11:30:00;NORTE;31;0;31;1
2019-09-16 12:00:00;NORTE;28;0;28;1
2019-09-16 12:30:00;NORTE;36;0;36;1
2019-09-16 13:00:00;NORTE;45;0;45;1
2019-09-16 13:30:00;NORTE;35;0;35;1
2019-09-16 14:00:00;NORTE;47;0;47;1
2019-09-16 14:30:00;NORTE;28;0;28;1
2019-09-16 15:00:00;NORTE;36;0;36;1
2019-09-16 15:30:00;NORTE;24;0;24;1
2019-09-16 16:00:00;NORTE;20;0;20;1
2019-09-16 16:30:00;NORTE;37;0;37;1
2019-09-16 17:00:00;NORTE;29;0;29;1
2019-09-16 17:30:00;NORTE;30;0;30;1
2019-09-16 18:00:00;NORTE;37;0;37;1
2019-09-16 18:30:00;NORTE;32;0;32;1
2019-09-16 19:00:00;NORTE;33;0;33;1
2019-09-16 19:30:00;NORTE;33;0;33;1
2019-09-16 20:00:00;NORTE;27;0;27;1
2019-09-16 20:30:00;NORTE;28;0;28;1
2019-09-16 21:00:00;NORTE;20;0;20;1
2019-09-16 21:30:00;NORTE;10;0;10;1
2019-09-16 22:00:00;NORTE;14;0;14;1
2019-09-16 22:30:00;NORTE;5;0;5;1
2019-09-16 23:00:00;NORTE;1;0;1;1
2019-09-16 23:30:00;NORTE;3;0;3;1
2019-09-17 01:00:00;NORTE;2;0;2;1
2019-09-17 01:30:00;NORTE;1;0;1;1
2019-09-17 02:00:00;NORTE;2;0;2;1
2019-09-17 02:30:00;NORTE;10;0;10;1
2019-09-17 03:00:00;NORTE;4;0;4;1
2019-09-17 03:30:00;NORTE;6;0;6;1
2019-09-17 04:00:00;NORTE;12;0;12;1
2019-09-17 04:30:00;NORTE;13;0;13;1
2019-09-17 05:00:00;NORTE;24;0;24;1
2019-09-17 05:30:00;NORTE;43;0;43;1
2019-09-17 06:00:00;NORTE;21;0;21;1
2019-09-17 06:30:00;NORTE;29;0;29;1
2019-09-17 07:00:00;NORTE;38;0;38;1
2019-09-17 07:30:00;NORTE;32;0;32;1
2019-09-17 08:00:00;NORTE;32;0;32;1
2019-09-17 08:30:00;NORTE;42;0;42;1
2019-09-17 09:00:00;NORTE;26;0;26;1
2019-09-17 09:30:00;NORTE;41;0;41;1
2019-09-17 10:00:00;NORTE;36;0;36;1
2019-09-17 10:30:00;NORTE;44;0;44;1
2019-09-17 11:00:00;NORTE;31;0;31;1
2019-09-17 11:30:00;NORTE;27;0;27;1
2019-09-17 12:00:00;NORTE;32;0;32;1
2019-09-17 12:30:00;NORTE;27;0;27;1
2019-09-17 13:00:00;NORTE;38;0;38;1
2019-09-17 13:30:00;NORTE;35;0;35;1
2019-09-17 14:00:00;NORTE;33;0;33;1
2019-09-17 14:30:00;NORTE;36;0;36;1
2019-09-17 15:00:00;NORTE;40;0;40;1
2019-09-17 15:30:00;NORTE;26;0;26;1
2019-09-17 16:00:00;NORTE;27;0;27;1
2019-09-17 16:30:00;NORTE;31;0;31;1
2019-09-17 17:00:00;NORTE;32;0;32;1
2019-09-17 17:30:00;NORTE;27;0;27;1
2019-09-17 18:00:00;NORTE;32;0;32;1
2019-09-17 18:30:00;NORTE;36;0;36;1
2019-09-17 19:00:00;NORTE;33;0;33;1
2019-09-17 19:30:00;NORTE;24;0;24;1
2019-09-17 20:00:00;NORTE;27;0;27;1
2019-09-17 20:30:00;NORTE;28;0;28;1
2019-09-17 21:00:00;NORTE;25;0;25;1
2019-09-17 21:30:00;NORTE;19;0;19;1
2019-09-17 22:00:00;NORTE;21;0;21;1
2019-09-17 22:30:00;NORTE;11;0;11;1
2019-09-17 23:00:00;NORTE;4;0;4;1
2019-09-17 23:30:00;NORTE;3;0;3;1
2019-09-18 00:00:00;NORTE;1;0;1;1
2019-09-18 01:00:00;NORTE;1;0;1;1
2019-09-18 01:30:00;NORTE;1;0;1;1
2019-09-18 02:00:00;NORTE;5;0;5;1
2019-09-18 02:30:00;NORTE;4;0;4;1
2019-09-18 03:00:00;NORTE;4;0;4;1
2019-09-18 03:30:00;NORTE;6;0;6;1
2019-09-18 04:00:00;NORTE;13;0;13;1
2019-09-18 04:30:00;NORTE;13;0;13;1
2019-09-18 05:00:00;NORTE;22;0;22;1
2019-09-18 05:30:00;NORTE;39;0;39;1
2019-09-18 06:00:00;NORTE;18;0;18;1
2019-09-18 06:30:00;NORTE;29;0;29;1
2019-09-18 07:00:00;NORTE;33;0;33;1
2019-09-18 07:30:00;NORTE;27;0;27;1
2019-09-18 08:00:00;NORTE;39;0;39;1
2019-09-18 08:30:05;NORTE;1;0;1;1
2019-09-18 08:30:26;NORTE;1;0;1;1
2019-09-18 08:30:31;NORTE;1;0;1;1
2019-09-18 08:31:05;NORTE;1;0;1;1
2019-09-18 08:32:20;NORTE;1;0;1;1
2019-09-18 08:32:30;NORTE;1;0;1;1
2019-09-18 08:33:41;NORTE;1;0;1;1
2019-09-18 08:34:41;NORTE;1;0;1;1
2019-09-18 08:35:37;NORTE;1;0;1;1
2019-09-18 08:36:05;NORTE;1;0;1;1
2019-09-18 08:37:08;NORTE;1;0;1;1
2019-09-18 08:38:03;NORTE;1;0;1;1
2019-09-18 08:38:28;NORTE;1;0;1;1
2019-09-18 08:39:03;NORTE;1;0;1;1
2019-09-18 08:39:54;NORTE;1;0;1;1
2019-09-18 08:40:03;NORTE;1;0;1;1
2019-09-18 08:41:23;NORTE;1;0;1;1
2019-09-18 08:41:27;NORTE;1;0;1;1
2019-09-18 08:41:41;NORTE;1;0;1;1
2019-09-18 08:42:45;NORTE;1;0;1;1
2019-09-18 08:43:18;NORTE;1;0;1;1
2019-09-18 08:43:34;NORTE;1;0;1;1
2019-09-18 08:45:04;NORTE;1;0;1;1
2019-09-18 08:46:26;NORTE;1;0;1;1
2019-09-18 08:47:46;NORTE;1;0;1;1
2019-09-18 08:47:58;NORTE;1;0;1;1
2019-09-18 08:48:52;NORTE;1;0;1;1
2019-09-18 08:50:19;NORTE;1;0;1;1
2019-09-18 08:50:44;NORTE;1;0;1;1
2019-09-18 08:53:09;NORTE;1;0;1;1
2019-09-18 08:53:14;NORTE;1;0;1;1
2019-09-18 08:53:47;NORTE;1;0;1;1
2019-09-18 08:54:56;NORTE;1;0;1;1
2019-09-18 08:55:06;NORTE;1;0;1;1
2019-09-18 08:56:09;NORTE;1;0;1;1
2019-09-18 08:57:29;NORTE;1;0;1;1
2019-09-18 08:57:32;NORTE;1;0;1;1
2019-09-18 08:57:53;NORTE;1;0;1;1
2019-09-18 08:58:39;NORTE;1;0;1;1
2019-09-18 08:58:40;NORTE;1;0;1;1
2019-09-18 09:00:56;NORTE;1;0;1;1
2019-09-18 09:03:04;NORTE;1;0;1;1
2019-09-18 09:04:23;NORTE;1;0;1;1
2019-09-18 09:05:58;NORTE;1;0;1;1
2019-09-18 09:07:29;NORTE;1;0;1;1
2019-09-18 09:07:30;NORTE;1;0;1;1
2019-09-18 09:08:07;NORTE;1;0;1;1
2019-09-18 09:09:35;NORTE;1;0;1;1
2019-09-18 09:09:44;NORTE;1;0;1;1
2019-09-18 09:11:03;NORTE;1;0;1;1
2019-09-18 09:11:50;NORTE;1;0;1;1
2019-09-18 09:13:05;NORTE;1;0;1;1
2019-09-18 09:13:30;NORTE;1;0;1;1
2019-09-18 09:14:20;NORTE;1;0;1;1
2019-09-18 09:15:08;NORTE;1;0;1;1
2019-09-18 09:17:16;NORTE;1;0;1;1
2019-09-18 09:17:32;NORTE;1;0;1;1
2019-09-18 09:18:48;NORTE;1;0;1;1
2019-09-18 09:21:01;NORTE;1;0;1;1
2019-09-18 09:21:10;NORTE;1;0;1;1
2019-09-18 09:22:32;NORTE;1;0;1;1
2019-09-18 09:24:49;NORTE;1;0;1;1
2019-09-18 09:26:41;NORTE;1;0;1;1
2019-09-18 09:28:15;NORTE;1;0;1;1
2019-09-18 09:29:07;NORTE;1;0;1;1
2019-09-18 09:30:52;NORTE;1;0;1;1
2019-09-18 09:31:39;NORTE;1;0;1;1
2019-09-18 09:31:59;NORTE;1;0;1;1
2019-09-18 09:34:02;NORTE;1;0;1;1
2019-09-18 09:36:57;NORTE;1;0;1;1
2019-09-18 09:37:17;NORTE;1;0;1;1
2019-09-18 09:38:13;NORTE;1;0;1;1
2019-09-18 09:38:56;NORTE;1;0;1;1
2019-09-18 09:39:22;NORTE;1;0;1;1
2019-09-18 09:39:50;NORTE;1;0;1;1
2019-09-18 09:40:39;NORTE;1;0;1;1
2019-09-18 09:42:26;NORTE;1;0;1;1
2019-09-18 09:45:28;NORTE;1;0;1;1
2019-09-18 09:46:06;NORTE;1;0;1;1
2019-09-18 09:47:01;NORTE;1;0;1;1
2019-09-18 09:47:08;NORTE;1;0;1;1
2019-09-18 09:47:17;NORTE;1;0;1;1
2019-09-18 09:48:39;NORTE;1;0;1;1
2019-09-18 09:48:57;NORTE;1;0;1;1
2019-09-18 09:49:22;NORTE;1;0;1;1
2019-09-18 09:50:43;NORTE;1;0;1;1
2019-09-18 09:51:31;NORTE;1;0;1;1
2019-09-18 09:52:12;NORTE;1;0;1;1
2019-09-18 09:52:17;NORTE;1;0;1;1
2019-09-18 09:53:45;NORTE;1;0;1;1
2019-09-18 09:54:01;NORTE;1;0;1;1
2019-09-18 09:55:43;NORTE;1;0;1;1
2019-09-18 09:55:49;NORTE;1;0;1;1
2019-09-18 09:56:52;NORTE;1;0;1;1
2019-09-18 09:57:17;NORTE;1;0;1;1
2019-09-18 09:57:45;NORTE;1;0;1;1
2019-09-18 09:58:59;NORTE;1;0;1;1
2019-09-18 09:59:18;NORTE;1;0;1;1
2019-09-18 10:01:51;NORTE;1;0;1;1
2019-09-18 10:01:53;NORTE;1;0;1;1
2019-09-18 10:03:27;NORTE;1;0;1;1
2019-09-18 10:03:52;NORTE;1;0;1;1
2019-09-18 10:05:02;NORTE;1;0;1;1
2019-09-18 10:05:06;NORTE;1;0;1;1
2019-09-18 10:05:35;NORTE;1;0;1;1
2019-09-18 10:06:45;NORTE;1;0;1;1
2019-09-18 10:07:01;NORTE;1;0;1;1
2019-09-18 10:08:09;NORTE;1;0;1;1
2019-09-18 10:09:17;NORTE;1;0;1;1
2019-09-18 10:09:47;NORTE;1;0;1;1
2019-09-18 10:11:00;NORTE;1;0;1;1
2019-09-18 10:11:49;NORTE;1;0;1;1
2019-09-18 10:12:35;NORTE;1;0;1;1
2019-09-18 10:13:53;NORTE;1;0;1;1
2019-09-18 10:15:18;NORTE;1;0;1;1
2019-09-18 10:16:11;NORTE;1;0;1;1
2019-09-18 10:17:35;NORTE;1;0;1;1
2019-09-18 10:18:18;NORTE;1;0;1;1
2019-09-18 10:18:34;NORTE;1;0;1;1
2019-09-18 10:20:02;NORTE;1;0;1;1
2019-09-18 10:20:35;NORTE;1;0;1;1
2019-09-18 10:22:19;NORTE;1;0;1;1
2019-09-18 10:24:07;NORTE;1;0;1;1
2019-09-18 10:24:50;NORTE;1;0;1;1
2019-09-18 10:25:45;NORTE;1;0;1;1
2019-09-18 10:28:02;NORTE;1;0;1;1
2019-09-18 10:28:33;NORTE;1;0;1;1
2019-09-18 10:29:32;NORTE;1;0;1;1
2019-09-18 10:29:49;NORTE;1;0;1;1
2019-09-18 10:30:00;NORTE;34;0;34;1
2019-09-18 11:00:28;NORTE;1;0;1;1
2019-09-18 11:01:07;NORTE;1;0;1;1
2019-09-18 11:01:11;NORTE;1;0;1;1
2019-09-18 11:02:07;NORTE;1;0;1;1
2019-09-18 11:04:19;NORTE;1;0;1;1
2019-09-18 11:04:21;NORTE;1;0;1;1
2019-09-18 11:04:37;NORTE;1;0;1;1
2019-09-18 11:05:32;NORTE;1;0;1;1
2019-09-18 11:06:22;NORTE;1;0;1;1
2019-09-18 11:07:08;NORTE;1;0;1;1
2019-09-18 11:08:03;NORTE;1;0;1;1
2019-09-18 11:08:10;NORTE;1;0;1;1
2019-09-18 11:09:25;NORTE;1;0;1;1
2019-09-18 11:09:55;NORTE;1;0;1;1
2019-09-18 11:10:33;NORTE;1;0;1;1
2019-09-18 11:11:35;NORTE;1;0;1;1
2019-09-18 11:12:08;NORTE;1;0;1;1
2019-09-18 11:12:44;NORTE;1;0;1;1
2019-09-18 11:14:10;NORTE;1;0;1;1
2019-09-18 11:14:29;NORTE;1;0;1;1
2019-09-18 11:14:49;NORTE;1;0;1;1
2019-09-18 11:16:02;NORTE;1;0;1;1
2019-09-18 11:17:42;NORTE;1;0;1;1
2019-09-18 11:19:08;NORTE;1;0;1;1
2019-09-18 11:20:43;NORTE;1;0;1;1
2019-09-18 11:20:59;NORTE;1;0;1;1
2019-09-18 11:22:03;NORTE;1;0;1;1
2019-09-18 11:22:29;NORTE;1;0;1;1
2019-09-18 11:24:18;NORTE;1;0;1;1
2019-09-18 11:24:41;NORTE;1;0;1;1
2019-09-18 11:26:03;NORTE;1;0;1;1
2019-09-18 11:27:27;NORTE;1;0;1;1
2019-09-18 11:28:11;NORTE;1;0;1;1
2019-09-18 11:30:00;NORTE;30;0;30;1
2019-09-18 12:00:00;NORTE;29;0;29;1
2019-09-18 12:30:00;NORTE;36;0;36;1
2019-09-18 13:00:00;NORTE;36;0;36;1
2019-09-18 13:30:00;NORTE;34;0;34;1
2019-09-18 14:00:00;NORTE;37;0;37;1
2019-09-18 14:30:00;NORTE;41;0;41;1
2019-09-18 15:00:00;NORTE;25;0;25;1
2019-09-18 15:30:00;NORTE;26;0;26;1
2019-09-18 16:00:00;NORTE;24;0;24;1
2019-09-18 16:30:00;NORTE;33;0;33;1
2019-09-18 17:00:00;NORTE;26;0;26;1
2019-09-18 17:30:00;NORTE;31;0;31;1
2019-09-18 18:00:00;NORTE;30;0;30;1
2019-09-18 19:00:00;NORTE;22;0;22;1
2019-09-18 19:30:00;NORTE;37;0;37;1
2019-09-18 20:00:00;NORTE;33;0;33;1
2019-09-18 20:30:00;NORTE;33;0;33;1
2019-09-18 21:00:00;NORTE;17;0;17;1
2019-09-18 21:30:00;NORTE;19;0;19;1
2019-09-18 22:00:00;NORTE;10;0;10;1
2019-09-18 22:30:00;NORTE;6;0;6;1
2019-09-18 23:00:00;NORTE;3;0;3;1
2019-09-18 23:30:00;NORTE;2;0;2;1
2019-09-19 00:00:00;NORTE;1;0;1;1
2019-09-19 01:00:00;NORTE;2;0;2;1
2019-09-19 01:30:00;NORTE;1;0;1;1
2019-09-19 02:00:00;NORTE;4;0;4;1
2019-09-19 02:30:00;NORTE;5;0;5;1
2019-09-19 03:00:00;NORTE;5;0;5;1
2019-09-19 03:30:00;NORTE;8;0;8;1
2019-09-19 04:00:00;NORTE;8;0;8;1
2019-09-19 04:30:00;NORTE;16;0;16;1
2019-09-19 05:00:00;NORTE;23;0;23;1
2019-09-19 05:30:00;NORTE;43;0;43;1
2019-09-19 06:00:00;NORTE;21;0;21;1
2019-09-19 06:30:00;NORTE;32;0;32;1
2019-09-19 07:00:00;NORTE;32;0;32;1
2019-09-19 07:30:00;NORTE;34;0;34;1
2019-09-19 08:00:00;NORTE;35;0;35;1
2019-09-19 08:30:00;NORTE;41;0;41;1
2019-09-19 09:00:00;NORTE;30;0;30;1
2019-09-19 09:30:00;NORTE;31;0;31;1
2019-09-19 10:00:00;NORTE;39;0;39;1
2019-09-19 10:30:00;NORTE;38;0;38;1
2019-09-19 11:00:00;NORTE;28;0;28;1
2019-09-19 11:30:00;NORTE;25;0;25;1
2019-09-19 12:00:00;NORTE;31;0;31;1
2019-09-19 12:30:00;NORTE;36;0;36;1
2019-09-19 13:00:00;NORTE;39;0;39;1
2019-09-19 13:30:00;NORTE;27;0;27;1
2019-09-19 14:00:00;NORTE;37;0;37;1
2019-09-19 14:30:00;NORTE;41;0;41;1
2019-09-19 15:00:00;NORTE;29;0;29;1
2019-09-19 15:30:00;NORTE;24;0;24;1
2019-09-19 16:00:00;NORTE;22;0;22;1
2019-09-19 16:30:00;NORTE;33;0;33;1
2019-09-19 17:00:00;NORTE;26;0;26;1
2019-09-19 17:30:00;NORTE;30;0;30;1
2019-09-19 18:00:00;NORTE;35;0;35;1
2019-09-19 18:30:00;NORTE;34;0;34;1
2019-09-19 19:00:00;NORTE;37;0;37;1
2019-09-19 19:30:00;NORTE;30;0;30;1
2019-09-19 20:00:00;NORTE;36;0;36;1
2019-09-19 20:30:00;NORTE;27;0;27;1
2019-09-19 21:00:00;NORTE;19;0;19;1
2019-09-19 21:30:00;NORTE;24;0;24;1
2019-09-19 22:00:00;NORTE;11;0;11;1
2019-09-19 22:30:00;NORTE;12;0;12;1
2019-09-19 23:00:00;NORTE;1;0;1;1
2019-09-19 23:30:00;NORTE;4;0;4;1
2019-09-20 00:00:00;NORTE;3;0;3;1
2019-09-20 00:30:00;NORTE;1;0;1;1
2019-09-20 01:30:00;NORTE;1;0;1;1
2019-09-20 02:00:00;NORTE;5;0;5;1
2019-09-20 02:30:00;NORTE;5;0;5;1
2019-09-20 03:00:00;NORTE;6;0;6;1
2019-09-20 03:30:00;NORTE;8;0;8;1
2019-09-20 04:00:00;NORTE;10;0;10;1
2019-09-20 04:30:00;NORTE;7;0;7;1
2019-09-20 05:00:00;NORTE;24;0;24;1
2019-09-20 05:30:00;NORTE;40;0;40;1
2019-09-20 06:00:00;NORTE;17;0;17;1
2019-09-20 06:30:00;NORTE;28;0;28;1
2019-09-20 07:00:00;NORTE;41;0;41;1
2019-09-20 07:30:00;NORTE;30;0;30;1
2019-09-20 08:00:00;NORTE;33;0;33;1
2019-09-20 08:30:00;NORTE;40;0;40;1
2019-09-20 09:00:00;NORTE;28;0;28;1
2019-09-20 09:30:00;NORTE;30;0;30;1
2019-09-20 10:00:00;NORTE;40;0;40;1
2019-09-20 10:30:00;CONFLICTIVA;7;21;28;2
2019-09-20 11:00:00;SUR;0;41;41;1
2019-09-20 11:30:00;SUR;0;31;31;1
2019-09-20 12:00:00;SUR;0;25;25;1
2019-09-20 12:30:00;SUR;0;31;31;1
2019-09-20 13:00:00;SUR;0;37;37;1
2019-09-20 13:30:00;SUR;0;38;38;1
2019-09-20 14:00:00;SUR;0;39;39;1
2019-09-20 14:30:00;SUR;0;40;40;1
2019-09-20 15:00:00;SUR;0;35;35;1
2019-09-20 15:30:00;SUR;0;24;24;1
2019-09-20 16:00:00;SUR;0;26;26;1
2019-09-20 16:30:00;SUR;0;32;32;1
2019-09-20 17:00:00;SUR;0;31;31;1
2019-09-20 17:30:00;SUR;0;26;26;1
2019-09-20 18:00:00;SUR;0;36;36;1
2019-09-20 18:30:00;SUR;0;29;29;1
2019-09-20 19:00:00;SUR;0;11;11;1
2019-09-20 19:13:00;SUR;0;3;3;1
2019-09-20 19:17:00;SUR;0;5;5;1
2019-09-20 19:30:00;CONFLICTIVA;1;2;3;2
2019-09-20 19:46:00;SUR;0;4;4;1
2019-09-20 20:00:00;SUR;0;4;4;1
2019-09-20 20:07:00;SUR;0;8;8;1
2019-09-20 20:30:00;NORTE;25;1;26;1
2019-09-20 21:00:00;NORTE;29;0;29;1
2019-09-20 21:30:00;NORTE;23;0;23;1
2019-09-20 22:00:00;NORTE;22;0;22;1
2019-09-20 22:30:00;NORTE;17;0;17;1
2019-09-20 23:00:00;NORTE;12;0;12;1
2019-09-20 23:30:00;NORTE;10;0;10;1
2019-09-21 00:00:00;NORTE;3;0;3;1
2019-09-21 01:00:00;NORTE;3;0;3;1
2019-09-21 01:30:00;NORTE;3;0;3;1
2019-09-21 02:00:00;NORTE;5;0;5;1
2019-09-21 02:30:00;NORTE;7;0;7;1
2019-09-21 03:00:00;NORTE;3;0;3;1
2019-09-21 03:30:00;NORTE;9;0;9;1
2019-09-21 04:00:00;NORTE;9;0;9;1
2019-09-21 04:30:00;NORTE;9;0;9;1
2019-09-21 05:00:00;NORTE;29;0;29;1
2019-09-21 05:30:00;NORTE;29;0;29;1
2019-09-21 06:00:00;NORTE;19;0;19;1
2019-09-21 06:30:00;NORTE;22;0;22;1
2019-09-21 07:00:00;NORTE;42;0;42;1
2019-09-21 07:30:00;NORTE;31;0;31;1
2019-09-21 08:00:00;NORTE;38;0;38;1
2019-09-21 08:30:00;NORTE;33;0;33;1
2019-09-21 09:00:00;NORTE;27;0;27;1
2019-09-21 09:30:00;CONFLICTIVA;13;16;29;2
2019-09-21 10:00:00;SUR;0;40;40;1
2019-09-21 10:30:00;SUR;0;33;33;1
2019-09-21 11:00:00;SUR;0;30;30;1
2019-09-21 11:30:00;SUR;0;27;27;1
2019-09-21 12:00:00;SUR;0;28;28;1
2019-09-21 12:30:00;SUR;0;25;25;1
2019-09-21 13:00:00;SUR;0;33;33;1
2019-09-21 13:30:00;SUR;0;33;33;1
2019-09-21 14:00:00;SUR;0;34;34;1
2019-09-21 14:30:00;SUR;0;29;29;1
2019-09-21 15:00:00;SUR;0;34;34;1
2019-09-21 15:30:00;SUR;0;17;17;1
2019-09-21 16:00:00;SUR;0;18;18;1
2019-09-21 16:30:00;SUR;0;30;30;1
2019-09-21 17:00:00;SUR;0;24;24;1
2019-09-21 17:30:00;CONFLICTIVA;13;5;18;2
2019-09-21 18:00:00;NORTE;28;0;28;1
2019-09-21 18:30:00;NORTE;28;0;28;1
2019-09-21 19:00:00;NORTE;25;0;25;1
2019-09-21 19:30:00;NORTE;30;0;30;1
2019-09-21 20:00:00;NORTE;32;0;32;1
2019-09-21 20:30:00;NORTE;13;0;13;1
2019-09-21 21:00:00;NORTE;13;0;13;1
2019-09-21 21:30:00;NORTE;15;0;15;1
2019-09-21 22:00:00;NORTE;13;0;13;1
2019-09-21 22:30:00;NORTE;11;0;11;1
2019-09-21 23:00:00;NORTE;3;0;3;1
2019-09-22 00:00:00;NORTE;2;0;2;1
2019-09-22 00:30:00;NORTE;1;0;1;1
2019-09-22 01:00:00;NORTE;1;0;1;1
2019-09-22 01:30:00;NORTE;2;0;2;1
2019-09-22 02:00:00;CONFLICTIVA;1;1;2;2
2019-09-22 02:30:00;SUR;0;1;1;1
2019-09-22 03:00:00;SUR;0;5;5;1
2019-09-22 03:30:00;SUR;0;5;5;1
2019-09-22 04:00:00;SUR;0;9;9;1
2019-09-22 04:30:00;SUR;0;11;11;1
2019-09-22 05:00:00;CONFLICTIVA;16;3;19;2
2019-09-22 05:30:00;NORTE;29;0;29;1
2019-09-22 06:00:00;NORTE;28;0;28;1
2019-09-22 06:30:00;NORTE;24;0;24;1
2019-09-22 07:00:00;NORTE;35;0;35;1
2019-09-22 07:30:00;NORTE;28;0;28;1
2019-09-22 08:00:00;NORTE;40;0;40;1
2019-09-22 08:30:00;NORTE;38;0;38;1
2019-09-22 09:00:00;NORTE;24;0;24;1
2019-09-22 09:30:00;NORTE;33;0;33;1
2019-09-22 10:00:00;NORTE;34;0;34;1
2019-09-22 10:30:00;NORTE;34;0;34;1
2019-09-22 11:00:00;NORTE;31;0;31;1
2019-09-22 11:30:00;NORTE;31;0;31;1
2019-09-22 12:00:00;NORTE;25;0;25;1
2019-09-22 12:30:00;NORTE;34;0;34;1
2019-09-22 13:00:00;NORTE;36;0;36;1
2019-09-22 13:30:00;NORTE;39;0;39;1
2019-09-22 14:00:00;NORTE;40;0;40;1
2019-09-22 14:30:00;NORTE;37;0;37;1
2019-09-22 15:00:00;NORTE;27;0;27;1
2019-09-22 15:30:00;NORTE;31;0;31;1
2019-09-22 16:00:00;NORTE;12;0;12;1
2019-09-22 16:30:00;NORTE;34;0;34;1
2019-09-22 17:00:00;NORTE;29;0;29;1
2019-09-22 17:30:00;NORTE;25;0;25;1
2019-09-22 18:00:00;NORTE;36;0;36;1
2019-09-22 18:30:00;NORTE;31;0;31;1
2019-09-22 19:00:00;NORTE;30;0;30;1
2019-09-22 19:30:00;NORTE;38;0;38;1
2019-09-22 20:00:00;NORTE;34;0;34;1
2019-09-22 20:30:00;NORTE;27;0;27;1
2019-09-22 21:00:00;NORTE;20;0;20;1
2019-09-22 21:30:00;NORTE;16;0;16;1
2019-09-22 22:00:00;NORTE;15;0;15;1
2019-09-22 22:30:00;NORTE;11;0;11;1
2019-09-22 23:00:00;NORTE;6;0;6;1
2019-09-23 00:00:00;NORTE;4;0;4;1
2019-09-23 00:30:00;NORTE;1;0;1;1
2019-09-23 01:30:00;NORTE;2;0;2;1
2019-09-23 02:00:00;NORTE;3;0;3;1
2019-09-23 02:30:00;NORTE;4;0;4;1
2019-09-23 03:00:00;NORTE;3;0;3;1
2019-09-23 03:30:00;NORTE;6;0;6;1
2019-09-23 04:00:00;NORTE;10;0;10;1
2019-09-23 04:30:00;NORTE;10;0;10;1
2019-09-23 05:00:00;NORTE;23;0;23;1
2019-09-23 05:30:00;NORTE;46;0;46;1
2019-09-23 06:00:00;NORTE;25;0;25;1
2019-09-23 06:30:00;NORTE;30;0;30;1
2019-09-23 07:00:00;NORTE;37;0;37;1
2019-09-23 07:30:00;NORTE;35;0;35;1
2019-09-23 08:00:00;NORTE;37;0;37;1
2019-09-23 08:30:00;NORTE;42;0;42;1
2019-09-23 09:00:00;NORTE;27;0;27;1
2019-09-23 09:30:00;NORTE;33;0;33;1
2019-09-23 10:00:00;NORTE;43;0;43;1
2019-09-23 10:30:00;NORTE;34;0;34;1
2019-09-23 11:00:00;NORTE;37;0;37;1
2019-09-23 11:30:00;NORTE;33;0;33;1
2019-09-23 12:00:00;NORTE;30;0;30;1
2019-09-23 12:30:00;NORTE;32;0;32;1
2019-09-23 13:00:00;CONFLICTIVA;19;11;30;2
2019-09-23 13:30:00;SUR;0;43;43;1
2019-09-23 14:00:00;SUR;0;38;38;1
2019-09-23 14:30:00;SUR;0;29;29;1
2019-09-23 15:00:00;SUR;0;28;28;1
2019-09-23 15:30:00;SUR;0;28;28;1
2019-09-23 16:00:00;SUR;0;22;22;1
2019-09-23 16:30:00;SUR;0;36;36;1
2019-09-23 17:00:00;SUR;0;27;27;1
2019-09-23 17:30:00;SUR;0;32;32;1
2019-09-23 18:00:00;SUR;0;38;38;1
2019-09-23 18:30:00;SUR;2;21;23;1
2019-09-23 19:00:00;NORTE;37;0;37;1
2019-09-23 19:30:00;NORTE;33;0;33;1
2019-09-23 20:00:00;NORTE;31;0;31;1
2019-09-23 20:30:00;NORTE;28;0;28;1
2019-09-23 21:00:00;NORTE;15;0;15;1
2019-09-23 21:30:00;NORTE;11;0;11;1
2019-09-23 22:00:00;NORTE;17;0;17;1
2019-09-23 22:30:00;NORTE;3;0;3;1
2019-09-23 23:00:00;NORTE;2;0;2;1
2019-09-24 00:00:00;NORTE;1;0;1;1
2019-09-24 00:30:00;NORTE;1;0;1;1
2019-09-24 01:00:00;NORTE;1;0;1;1
2019-09-24 01:30:00;NORTE;1;0;1;1
2019-09-24 02:00:00;NORTE;4;0;4;1
2019-09-24 02:30:00;NORTE;5;0;5;1
2019-09-24 03:00:00;NORTE;6;0;6;1
2019-09-24 03:30:00;NORTE;6;0;6;1
2019-09-24 04:00:00;NORTE;15;0;15;1
2019-09-24 04:30:00;NORTE;15;0;15;1
2019-09-24 05:00:00;NORTE;21;0;21;1
2019-09-24 05:30:00;NORTE;39;0;39;1
2019-09-24 06:00:00;NORTE;21;0;21;1
2019-09-24 06:30:00;NORTE;27;0;27;1
2019-09-24 07:00:00;NORTE;31;0;31;1
2019-09-24 07:30:00;NORTE;33;0;33;1
2019-09-24 08:00:00;NORTE;36;0;36;1
2019-09-24 08:30:00;NORTE;35;0;35;1
2019-09-24 09:00:00;NORTE;28;0;28;1
2019-09-24 09:30:00;SUR;2;31;33;1
2019-09-24 10:00:00;SUR;0;32;32;1
2019-09-24 10:30:00;SUR;0;40;40;1
2019-09-24 11:00:00;SUR;0;32;32;1
2019-09-24 11:30:00;SUR;0;25;25;1
2019-09-24 12:00:00;SUR;0;27;27;1
2019-09-24 12:30:00;SUR;0;34;34;1
2019-09-24 13:00:00;SUR;0;36;36;1
2019-09-24 13:30:00;SUR;0;30;30;1
2019-09-24 14:00:00;SUR;0;40;40;1
2019-09-24 14:30:00;SUR;0;37;37;1
2019-09-24 15:00:00;SUR;0;26;26;1
2019-09-24 15:30:00;SUR;0;27;27;1
2019-09-24 16:00:00;SUR;0;22;22;1
2019-09-24 16:30:00;SUR;0;30;30;1
2019-09-24 17:00:00;SUR;0;32;32;1
2019-09-24 17:30:00;SUR;0;31;31;1
2019-09-24 18:00:00;SUR;0;36;36;1
2019-09-24 18:30:00;SUR;0;27;27;1
2019-09-24 19:00:00;CONFLICTIVA;10;12;22;2
2019-09-24 19:30:00;NORTE;37;0;37;1
2019-09-24 20:00:00;NORTE;40;0;40;1
2019-09-24 20:30:00;NORTE;31;0;31;1
2019-09-24 21:00:00;NORTE;26;0;26;1
2019-09-24 21:30:00;NORTE;15;0;15;1
2019-09-24 22:00:00;NORTE;15;0;15;1
2019-09-24 22:30:00;NORTE;10;0;10;1
2019-09-24 23:00:00;NORTE;1;0;1;1
2019-09-24 23:30:00;NORTE;2;0;2;1
2019-09-25 00:00:00;NORTE;1;0;1;1
2019-09-25 00:30:00;NORTE;1;0;1;1
2019-09-25 01:00:00;NORTE;1;0;1;1
2019-09-25 02:00:00;NORTE;4;0;4;1
2019-09-25 02:30:00;NORTE;4;0;4;1
2019-09-25 03:00:00;NORTE;5;0;5;1
2019-09-25 03:30:00;NORTE;9;0;9;1
2019-09-25 04:00:00;NORTE;17;0;17;1
2019-09-25 04:30:00;NORTE;15;0;15;1
2019-09-25 05:00:00;NORTE;26;0;26;1
2019-09-25 05:30:00;NORTE;44;0;44;1
2019-09-25 06:00:00;NORTE;26;0;26;1
2019-09-25 06:30:00;NORTE;29;0;29;1
2019-09-25 07:00:00;NORTE;35;0;35;1
2019-09-25 07:30:00;NORTE;31;0;31;1
2019-09-25 08:00:00;NORTE;36;0;36;1
2019-09-25 08:30:00;NORTE;40;0;40;1
2019-09-25 09:00:00;NORTE;24;0;24;1
2019-09-25 09:30:00;NORTE;33;0;33;1
2019-09-25 10:00:00;NORTE;38;0;38;1
2019-09-25 10:30:00;NORTE;34;0;34;1
2019-09-25 11:00:00;NORTE;34;0;34;1
2019-09-25 11:30:00;NORTE;33;0;33;1
2019-09-25 12:00:00;NORTE;26;0;26;1
2019-09-25 12:30:00;NORTE;34;0;34;1
2019-09-25 13:00:00;NORTE;41;0;41;1
2019-09-25 13:30:00;NORTE;29;0;29;1
2019-09-25 14:00:00;NORTE;35;0;35;1
2019-09-25 14:30:00;NORTE;37;0;37;1
2019-09-25 15:00:00;NORTE;32;0;32;1
2019-09-25 15:30:00;NORTE;26;0;26;1
2019-09-25 16:00:00;NORTE;30;0;30;1
2019-09-25 16:30:00;NORTE;35;0;35;1
2019-09-25 17:00:00;NORTE;28;0;28;1
2019-09-25 17:30:00;NORTE;31;0;31;1
2019-09-25 18:00:00;NORTE;42;0;42;1
2019-09-25 18:30:00;NORTE;29;0;29;1
2019-09-25 19:00:00;NORTE;33;0;33;1
2019-09-25 19:30:00;NORTE;37;0;37;1
2019-09-25 20:00:00;NORTE;36;0;36;1
2019-09-25 20:30:00;NORTE;28;0;28;1
2019-09-25 21:00:00;NORTE;14;0;14;1
2019-09-25 21:30:00;NORTE;18;0;18;1
2019-09-25 22:00:00;NORTE;8;0;8;1
2019-09-25 22:30:00;NORTE;8;0;8;1
2019-09-25 23:00:00;NORTE;2;0;2;1
2019-09-25 23:30:00;NORTE;1;0;1;1
2019-09-26 00:00:00;NORTE;1;0;1;1
2019-09-26 00:30:00;NORTE;1;0;1;1
2019-09-26 01:30:00;NORTE;2;0;2;1
2019-09-26 02:00:00;NORTE;3;0;3;1
2019-09-26 02:30:00;NORTE;3;0;3;1
2019-09-26 03:00:00;NORTE;5;0;5;1
2019-09-26 03:30:00;NORTE;9;0;9;1
2019-09-26 04:00:00;NORTE;15;0;15;1
2019-09-26 04:30:00;NORTE;19;0;19;1
2019-09-26 05:00:00;NORTE;26;0;26;1
2019-09-26 05:30:00;NORTE;40;0;40;1
2019-09-26 06:00:00;NORTE;23;0;23;1
2019-09-26 06:30:00;NORTE;32;0;32;1
2019-09-26 07:00:00;NORTE;40;0;40;1
2019-09-26 07:30:44;NORTE;1;0;1;1
2019-09-26 07:31:34;NORTE;1;0;1;1
2019-09-26 07:32:11;NORTE;1;0;1;1
2019-09-26 07:33:31;NORTE;1;0;1;1
2019-09-26 07:33:43;NORTE;1;0;1;1
2019-09-26 07:34:30;NORTE;1;0;1;1
2019-09-26 07:35:52;NORTE;1;0;1;1
2019-09-26 07:35:56;NORTE;1;0;1;1
2019-09-26 07:37:27;NORTE;1;0;1;1
2019-09-26 07:38:12;NORTE;1;0;1;1
2019-09-26 07:39:31;NORTE;1;0;1;1
2019-09-26 07:39:33;NORTE;1;0;1;1
2019-09-26 07:40:50;NORTE;1;0;1;1
2019-09-26 07:42:20;NORTE;1;0;1;1
2019-09-26 07:43:09;NORTE;2;0;2;1
2019-09-26 07:44:12;NORTE;1;0;1;1
2019-09-26 07:45:26;NORTE;1;0;1;1
2019-09-26 07:46:05;NORTE;1;0;1;1
2019-09-26 07:46:25;NORTE;1;0;1;1
2019-09-26 07:48:15;NORTE;1;0;1;1
2019-09-26 07:50:03;NORTE;1;0;1;1
2019-09-26 07:50:40;NORTE;1;0;1;1
2019-09-26 07:52:08;NORTE;1;0;1;1
2019-09-26 07:53:26;NORTE;1;0;1;1
2019-09-26 07:53:46;NORTE;1;0;1;1
2019-09-26 07:54:17;NORTE;1;0;1;1
2019-09-26 07:55:10;NORTE;1;0;1;1
2019-09-26 07:55:54;NORTE;1;0;1;1
2019-09-26 07:55:56;NORTE;1;0;1;1
2019-09-26 07:57:26;NORTE;1;0;1;1
2019-09-26 07:58:17;NORTE;1;0;1;1
2019-09-26 07:59:38;NORTE;1;0;1;1
2019-09-26 07:59:42;NORTE;1;0;1;1
2019-09-26 08:00:35;NORTE;1;0;1;1
2019-09-26 08:01:40;NORTE;1;0;1;1
2019-09-26 08:01:41;NORTE;1;0;1;1
2019-09-26 08:02:41;NORTE;1;0;1;1
2019-09-26 08:03:47;NORTE;1;0;1;1
2019-09-26 08:03:54;NORTE;1;0;1;1
2019-09-26 08:05:08;NORTE;1;0;1;1
2019-09-26 08:05:44;NORTE;1;0;1;1
2019-09-26 08:05:54;NORTE;1;0;1;1
2019-09-26 08:07:11;NORTE;1;0;1;1
2019-09-26 08:07:15;NORTE;1;0;1;1
2019-09-26 08:08:14;NORTE;1;0;1;1
2019-09-26 08:08:30;NORTE;1;0;1;1
2019-09-26 08:09:36;NORTE;1;0;1;1
2019-09-26 08:10:17;NORTE;1;0;1;1
2019-09-26 08:11:30;NORTE;1;0;1;1
2019-09-26 08:12:38;NORTE;1;0;1;1
2019-09-26 08:13:04;NORTE;1;0;1;1
2019-09-26 08:13:37;NORTE;1;0;1;1
2019-09-26 08:13:42;NORTE;1;0;1;1
2019-09-26 08:14:12;NORTE;1;0;1;1
2019-09-26 08:14:31;NORTE;1;0;1;1
2019-09-26 08:15:47;NORTE;1;0;1;1
2019-09-26 08:16:43;NORTE;1;0;1;1
2019-09-26 08:17:08;NORTE;1;0;1;1
2019-09-26 08:17:27;NORTE;1;0;1;1
2019-09-26 08:18:56;NORTE;1;0;1;1
2019-09-26 08:19:09;NORTE;1;0;1;1
2019-09-26 08:19:56;NORTE;1;0;1;1
2019-09-26 08:20:43;NORTE;1;0;1;1
2019-09-26 08:20:55;NORTE;1;0;1;1
2019-09-26 08:22:48;NORTE;1;0;1;1
2019-09-26 08:23:19;NORTE;1;0;1;1
2019-09-26 08:24:29;NORTE;1;0;1;1
2019-09-26 08:25:28;NORTE;1;0;1;1
2019-09-26 08:27:11;NORTE;1;0;1;1
2019-09-26 08:28:02;NORTE;1;0;1;1
2019-09-26 08:28:24;NORTE;1;0;1;1
2019-09-26 08:29:57;NORTE;1;0;1;1
2019-09-26 08:31:09;NORTE;1;0;1;1
2019-09-26 08:31:55;NORTE;1;0;1;1
2019-09-26 08:31:59;NORTE;1;0;1;1
2019-09-26 08:32:04;NORTE;1;0;1;1
2019-09-26 08:33:21;NORTE;1;0;1;1
2019-09-26 08:33:24;NORTE;1;0;1;1
2019-09-26 08:33:53;NORTE;1;0;1;1
2019-09-26 08:34:45;NORTE;1;0;1;1
2019-09-26 08:35:52;NORTE;1;0;1;1
2019-09-26 08:36:24;NORTE;1;0;1;1
2019-09-26 08:36:52;NORTE;1;0;1;1
2019-09-26 08:38:36;NORTE;1;0;1;1
2019-09-26 08:38:40;NORTE;1;0;1;1
2019-09-26 08:39:30;NORTE;1;0;1;1
2019-09-26 08:41:11;NORTE;1;0;1;1
2019-09-26 08:41:38;NORTE;1;0;1;1
2019-09-26 08:42:01;NORTE;1;0;1;1
2019-09-26 08:42:19;NORTE;1;0;1;1
2019-09-26 08:43:08;NORTE;1;0;1;1
2019-09-26 08:43:22;NORTE;1;0;1;1
2019-09-26 08:44:23;NORTE;1;0;1;1
2019-09-26 08:44:55;NORTE;1;0;1;1
2019-09-26 08:45:21;NORTE;1;0;1;1
2019-09-26 08:46:19;NORTE;1;0;1;1
2019-09-26 08:46:31;NORTE;1;0;1;1
2019-09-26 08:46:34;NORTE;1;0;1;1
2019-09-26 08:47:06;NORTE;1;0;1;1
2019-09-26 08:47:42;NORTE;1;0;1;1
2019-09-26 08:48:02;NORTE;1;0;1;1
2019-09-26 08:48:34;NORTE;1;0;1;1
2019-09-26 08:50:10;NORTE;1;0;1;1
2019-09-26 08:53:42;NORTE;1;0;1;1
2019-09-26 08:56:07;NORTE;1;0;1;1
2019-09-26 08:59:12;NORTE;1;0;1;1
2019-09-26 08:59:34;NORTE;1;0;1;1
2019-09-26 09:01:15;NORTE;1;0;1;1
2019-09-26 09:03:21;NORTE;1;0;1;1
2019-09-26 09:04:11;NORTE;1;0;1;1
2019-09-26 09:05:01;NORTE;1;0;1;1
2019-09-26 09:05:03;NORTE;1;0;1;1
2019-09-26 09:06:14;NORTE;1;0;1;1
2019-09-26 09:06:33;NORTE;1;0;1;1
2019-09-26 09:06:48;NORTE;1;0;1;1
2019-09-26 09:08:24;NORTE;1;0;1;1
2019-09-26 09:09:00;NORTE;1;0;1;1
2019-09-26 09:10:19;NORTE;1;0;1;1
2019-09-26 09:10:35;NORTE;1;0;1;1
2019-09-26 09:12:51;NORTE;1;0;1;1
2019-09-26 09:13:03;NORTE;1;0;1;1
2019-09-26 09:13:18;NORTE;1;0;1;1
2019-09-26 09:14:35;NORTE;1;0;1;1
2019-09-26 09:15:45;NORTE;1;0;1;1
2019-09-26 09:17:08;NORTE;1;0;1;1
2019-09-26 09:18:22;NORTE;1;0;1;1
2019-09-26 09:18:25;NORTE;1;0;1;1
2019-09-26 09:20:00;NORTE;1;0;1;1
2019-09-26 09:21:18;NORTE;1;0;1;1
2019-09-26 09:21:19;NORTE;1;0;1;1
2019-09-26 09:22:26;NORTE;1;0;1;1
2019-09-26 09:23:09;NORTE;1;0;1;1
2019-09-26 09:24:04;NORTE;1;0;1;1
2019-09-26 09:24:09;NORTE;1;0;1;1
2019-09-26 09:25:08;NORTE;1;0;1;1
2019-09-26 09:26:22;NORTE;1;0;1;1
2019-09-26 09:27:10;NORTE;1;0;1;1
2019-09-26 09:27:55;NORTE;1;0;1;1
2019-09-26 09:28:45;NORTE;1;0;1;1
2019-09-26 09:28:58;NORTE;1;0;1;1
2019-09-26 09:29:14;NORTE;1;0;1;1
2019-09-26 09:30:21;NORTE;1;0;1;1
2019-09-26 09:30:57;NORTE;1;0;1;1
2019-09-26 09:33:07;NORTE;1;0;1;1
2019-09-26 09:34:50;NORTE;1;0;1;1
2019-09-26 09:35:27;NORTE;1;0;1;1
2019-09-26 09:36:34;NORTE;1;0;1;1
2019-09-26 09:36:58;NORTE;1;0;1;1
2019-09-26 09:37:22;NORTE;1;0;1;1
2019-09-26 09:39:11;NORTE;1;0;1;1
2019-09-26 09:39:29;NORTE;1;0;1;1
2019-09-26 09:41:03;NORTE;1;0;1;1
2019-09-26 09:41:55;NORTE;1;0;1;1
2019-09-26 09:42:06;NORTE;1;0;1;1
2019-09-26 09:43:30;NORTE;1;0;1;1
2019-09-26 09:44:29;NORTE;1;0;1;1
2019-09-26 09:46:16;NORTE;1;0;1;1
2019-09-26 09:46:27;NORTE;1;0;1;1
2019-09-26 09:47:18;NORTE;1;0;1;1
2019-09-26 09:47:24;NORTE;1;0;1;1
2019-09-26 09:48:22;NORTE;1;0;1;1
2019-09-26 09:48:31;NORTE;1;0;1;1
2019-09-26 09:48:55;NORTE;1;0;1;1
2019-09-26 09:49:32;NORTE;1;0;1;1
2019-09-26 09:51:10;NORTE;1;0;1;1
2019-09-26 09:51:14;NORTE;1;0;1;1
2019-09-26 09:51:33;NORTE;1;0;1;1
2019-09-26 09:52:15;NORTE;1;0;1;1
2019-09-26 09:53:04;NORTE;1;0;1;1
2019-09-26 09:53:20;NORTE;1;0;1;1
2019-09-26 09:53:39;NORTE;1;0;1;1
2019-09-26 09:54:56;NORTE;1;0;1;1
2019-09-26 09:55:26;NORTE;1;0;1;1
2019-09-26 09:56:38;NORTE;1;0;1;1
2019-09-26 09:56:53;NORTE;1;0;1;1
2019-09-26 09:56:57;NORTE;1;0;1;1
2019-09-26 09:58:07;NORTE;1;0;1;1
2019-09-26 09:58:14;NORTE;1;0;1;1
2019-09-26 09:58:35;NORTE;1;0;1;1
2019-09-26 09:59:27;NORTE;1;0;1;1
2019-09-26 10:00:00;NORTE;31;0;31;1
2019-09-26 10:30:00;NORTE;40;0;40;1
2019-09-26 11:00:00;NORTE;30;0;30;1
2019-09-26 11:30:00;NORTE;31;0;31;1
2019-09-26 12:00:00;NORTE;22;0;22;1
2019-09-26 12:30:00;NORTE;40;0;40;1
2019-09-26 13:00:00;NORTE;39;0;39;1
2019-09-26 13:30:00;NORTE;31;0;31;1
2019-09-26 14:00:00;NORTE;41;0;41;1
2019-09-26 14:30:00;NORTE;48;0;48;1
2019-09-26 15:00:00;NORTE;33;0;33;1
2019-09-26 15:30:00;NORTE;20;0;20;1
2019-09-26 16:00:00;NORTE;21;0;21;1
2019-09-26 16:30:00;NORTE;31;0;31;1
2019-09-26 17:00:00;NORTE;27;0;27;1
2019-09-26 17:30:00;NORTE;36;0;36;1
2019-09-26 18:00:00;NORTE;35;0;35;1
2019-09-26 18:30:00;NORTE;30;0;30;1
2019-09-26 19:00:00;NORTE;36;0;36;1
2019-09-26 19:30:00;NORTE;34;0;34;1
2019-09-26 20:00:00;NORTE;35;0;35;1
2019-09-26 20:30:00;NORTE;29;0;29;1
2019-09-26 21:00:00;NORTE;17;0;17;1
2019-09-26 21:30:00;NORTE;17;0;17;1
2019-09-26 22:00:00;NORTE;17;0;17;1
2019-09-26 22:30:00;NORTE;7;0;7;1
2019-09-26 23:00:00;NORTE;2;0;2;1
2019-09-26 23:30:00;NORTE;1;0;1;1
2019-09-27 00:00:00;NORTE;2;0;2;1
2019-09-27 00:30:00;NORTE;1;0;1;1
2019-09-27 01:00:00;NORTE;1;0;1;1
2019-09-27 01:30:00;NORTE;2;0;2;1
2019-09-27 02:00:00;NORTE;2;0;2;1
2019-09-27 02:30:00;NORTE;7;0;7;1
2019-09-27 03:00:00;NORTE;5;0;5;1
2019-09-27 03:30:00;NORTE;6;0;6;1
2019-09-27 04:00:00;NORTE;17;0;17;1
2019-09-27 04:30:00;NORTE;10;0;10;1
2019-09-27 05:00:00;NORTE;27;0;27;1
2019-09-27 05:30:00;NORTE;44;0;44;1
2019-09-27 06:00:00;NORTE;23;0;23;1
2019-09-27 06:30:00;NORTE;25;0;25;1
2019-09-27 07:00:00;NORTE;40;0;40;1
2019-09-27 07:30:00;NORTE;32;0;32;1
2019-09-27 08:00:00;NORTE;34;0;34;1
2019-09-27 08:30:00;NORTE;45;0;45;1
2019-09-27 09:00:00;NORTE;27;0;27;1
2019-09-27 09:30:00;NORTE;39;0;39;1
2019-09-27 10:00:00;NORTE;39;0;39;1
2019-09-27 10:30:00;NORTE;30;0;30;1
2019-09-27 11:00:00;NORTE;35;0;35;1
2019-09-27 11:30:00;NORTE;30;0;30;1
2019-09-27 12:00:00;NORTE;29;0;29;1
2019-09-27 12:30:00;NORTE;33;0;33;1
2019-09-27 13:00:00;NORTE;39;0;39;1
2019-09-27 13:30:00;NORTE;37;0;37;1
2019-09-27 14:00:00;NORTE;42;0;42;1
2019-09-27 14:30:00;CONFLICTIVA;4;34;38;2
2019-09-27 15:00:00;SUR;0;33;33;1
2019-09-27 15:30:00;SUR;0;30;30;1
2019-09-27 16:00:00;SUR;0;20;20;1
2019-09-27 16:30:00;SUR;0;39;39;1
2019-09-27 17:00:00;SUR;0;27;27;1
2019-09-27 17:30:00;SUR;0;28;28;1
2019-09-27 18:00:00;SUR;0;36;36;1
2019-09-27 18:30:00;CONFLICTIVA;20;7;27;2
2019-09-27 19:00:00;NORTE;31;0;31;1
2019-09-27 19:30:00;NORTE;34;0;34;1
2019-09-27 20:00:00;NORTE;30;0;30;1
2019-09-27 20:30:00;NORTE;26;0;26;1
2019-09-27 21:00:00;NORTE;17;0;17;1
2019-09-27 21:30:00;NORTE;19;0;19;1
2019-09-27 22:00:00;NORTE;21;0;21;1
2019-09-27 22:30:00;NORTE;4;0;4;1
2019-09-27 23:00:00;NORTE;1;0;1;1
2019-09-27 23:30:00;NORTE;1;0;1;1
2019-09-28 00:00:00;NORTE;2;0;2;1
2019-09-28 01:00:00;NORTE;1;0;1;1
2019-09-28 02:00:00;NORTE;7;0;7;1
2019-09-28 02:30:00;NORTE;7;0;7;1
2019-09-28 03:00:00;NORTE;4;0;4;1
2019-09-28 03:30:00;NORTE;5;0;5;1
2019-09-28 04:00:00;NORTE;12;0;12;1
2019-09-28 04:30:00;NORTE;9;0;9;1
2019-09-28 05:00:00;NORTE;26;0;26;1
2019-09-28 05:30:00;NORTE;32;0;32;1
2019-09-28 06:00:00;NORTE;23;0;23;1
2019-09-28 06:30:00;NORTE;25;0;25;1
2019-09-28 07:00:00;NORTE;39;0;39;1
2019-09-28 07:30:00;NORTE;32;0;32;1
2019-09-28 08:00:00;NORTE;37;0;37;1
2019-09-28 08:30:00;NORTE;42;0;42;1
2019-09-28 09:00:00;NORTE;31;0;31;1
2019-09-28 09:30:00;NORTE;32;0;32;1
2019-09-28 10:00:00;NORTE;34;0;34;1
2019-09-28 10:30:00;NORTE;41;0;41;1
2019-09-28 11:00:00;NORTE;31;0;31;1
2019-09-28 11:30:00;NORTE;28;1;29;1
2019-09-28 12:00:00;NORTE;26;0;26;1
2019-09-28 12:30:00;NORTE;33;0;33;1
2019-09-28 13:00:00;NORTE;36;0;36;1
2019-09-28 13:30:00;NORTE;34;0;34;1
2019-09-28 14:00:00;NORTE;35;0;35;1
2019-09-28 14:30:00;NORTE;29;0;29;1
2019-09-28 15:00:00;NORTE;21;0;21;1
2019-09-28 15:30:00;NORTE;26;0;26;1
2019-09-28 16:00:00;NORTE;23;0;23;1
2019-09-28 16:30:00;NORTE;23;0;23;1
2019-09-28 17:00:00;NORTE;20;0;20;1
2019-09-28 17:30:00;NORTE;23;0;23;1
2019-09-28 18:00:00;NORTE;34;0;34;1
2019-09-28 18:30:00;NORTE;22;0;22;1
2019-09-28 19:00:00;NORTE;33;0;33;1
2019-09-28 19:30:00;NORTE;22;0;22;1
2019-09-28 20:00:00;NORTE;20;0;20;1
2019-09-28 20:30:00;NORTE;21;1;22;1
2019-09-28 21:00:00;NORTE;15;1;16;1
2019-09-28 21:30:00;NORTE;14;0;14;1
2019-09-28 22:00:00;NORTE;16;0;16;1
2019-09-28 22:30:00;NORTE;8;0;8;1
2019-09-28 23:00:00;NORTE;1;0;1;1
2019-09-28 23:30:00;NORTE;1;0;1;1
2019-09-29 00:00:00;NORTE;2;0;2;1
2019-09-29 01:00:00;NORTE;5;0;5;1
2019-09-29 01:30:00;NORTE;1;0;1;1
2019-09-29 02:00:00;NORTE;2;0;2;1
2019-09-29 02:30:00;NORTE;4;0;4;1
2019-09-29 03:00:00;NORTE;3;0;3;1
2019-09-29 03:30:00;NORTE;9;0;9;1
2019-09-29 04:00:00;NORTE;8;0;8;1
2019-09-29 04:30:00;NORTE;15;0;15;1
2019-09-29 05:00:00;NORTE;21;0;21;1
2019-09-29 05:30:00;NORTE;29;0;29;1
2019-09-29 06:00:00;NORTE;20;0;20;1
2019-09-29 06:30:00;NORTE;25;0;25;1
2019-09-29 07:00:00;NORTE;36;0;36;1
2019-09-29 07:30:00;NORTE;35;0;35;1
2019-09-29 08:00:00;NORTE;32;0;32;1
2019-09-29 08:30:00;NORTE;43;0;43;1
2019-09-29 09:00:00;NORTE;25;0;25;1
2019-09-29 09:30:00;NORTE;36;0;36;1
2019-09-29 10:00:00;NORTE;29;0;29;1
2019-09-29 10:30:00;NORTE;32;0;32;1
2019-09-29 11:00:00;NORTE;34;0;34;1
2019-09-29 11:30:00;NORTE;23;0;23;1
2019-09-29 12:00:00;NORTE;32;0;32;1
2019-09-29 12:30:00;NORTE;37;0;37;1
2019-09-29 13:00:00;NORTE;40;0;40;1
2019-09-29 13:30:00;NORTE;35;0;35;1
2019-09-29 14:00:00;NORTE;40;0;40;1
2019-09-29 14:30:00;NORTE;40;0;40;1
2019-09-29 15:00:00;NORTE;35;0;35;1
2019-09-29 15:30:00;NORTE;18;0;18;1
2019-09-29 16:00:00;NORTE;25;0;25;1
2019-09-29 16:30:00;NORTE;33;0;33;1
2019-09-29 17:00:00;NORTE;30;0;30;1
2019-09-29 17:30:00;NORTE;27;0;27;1
2019-09-29 18:00:00;NORTE;36;0;36;1
2019-09-29 18:30:00;NORTE;27;0;27;1
2019-09-29 19:00:00;NORTE;32;0;32;1
2019-09-29 19:30:00;NORTE;29;0;29;1
2019-09-29 20:00:00;NORTE;35;0;35;1
2019-09-29 20:30:00;NORTE;31;0;31;1
2019-09-29 21:00:00;NORTE;16;0;16;1
2019-09-29 21:30:00;NORTE;20;0;20;1
2019-09-29 22:00:00;NORTE;17;0;17;1
2019-09-29 22:30:00;NORTE;9;0;9;1
2019-09-29 23:00:00;NORTE;2;0;2;1
2019-09-29 23:30:00;NORTE;2;0;2;1
2019-09-30 00:00:00;NORTE;2;0;2;1
2019-09-30 00:30:00;NORTE;2;0;2;1
2019-09-30 01:00:00;NORTE;6;0;6;1
2019-09-30 02:00:00;NORTE;7;0;7;1
2019-09-30 02:30:00;NORTE;4;0;4;1
2019-09-30 03:00:00;NORTE;5;0;5;1
2019-09-30 03:30:00;NORTE;7;0;7;1
2019-09-30 04:00:00;NORTE;8;0;8;1
2019-09-30 04:30:00;NORTE;13;0;13;1
2019-09-30 05:00:00;NORTE;26;0;26;1
2019-09-30 05:30:00;NORTE;41;0;41;1
2019-09-30 06:00:00;NORTE;28;0;28;1
2019-09-30 06:30:00;NORTE;28;0;28;1
2019-09-30 07:00:00;NORTE;43;0;43;1
2019-09-30 07:30:00;NORTE;32;0;32;1
2019-09-30 08:00:00;NORTE;43;1;44;1
2019-09-30 08:30:00;NORTE;42;0;42;1
2019-09-30 09:00:00;NORTE;33;0;33;1
2019-09-30 09:30:00;NORTE;31;0;31;1
2019-09-30 10:00:00;NORTE;38;0;38;1
2019-09-30 10:30:00;NORTE;40;0;40;1
2019-09-30 11:00:00;NORTE;34;0;34;1
2019-09-30 11:30:00;NORTE;32;0;32;1
2019-09-30 12:00:00;NORTE;28;0;28;1
2019-09-30 12:30:00;NORTE;34;0;34;1
2019-09-30 13:00:00;NORTE;46;0;46;1
2019-09-30 13:30:00;NORTE;33;0;33;1
2019-09-30 14:00:00;NORTE;42;0;42;1
2019-09-30 14:30:00;NORTE;36;0;36;1
2019-09-30 15:00:00;NORTE;31;0;31;1
2019-09-30 15:30:00;NORTE;28;0;28;1
2019-09-30 16:00:00;NORTE;26;0;26;1
2019-09-30 16:30:00;NORTE;44;0;44;1
2019-09-30 17:00:00;NORTE;33;0;33;1
2019-09-30 17:30:00;NORTE;29;0;29;1
2019-09-30 18:00:00;NORTE;42;0;42;1
2019-09-30 18:30:00;NORTE;31;0;31;1
2019-09-30 19:00:00;NORTE;26;0;26;1
2019-09-30 19:30:00;NORTE;33;0;33;1
2019-09-30 20:00:00;NORTE;30;0;30;1
2019-09-30 20:30:00;NORTE;29;0;29;1
2019-09-30 21:00:00;NORTE;18;0;18;1
2019-09-30 21:30:00;NORTE;14;0;14;1
2019-09-30 22:00:00;NORTE;16;0;16;1
2019-09-30 22:30:00;NORTE;5;0;5;1
2019-09-30 23:00:00;NORTE;2;0;2;1
2019-10-01 00:00:00;NORTE;1;0;1;1
2019-10-01 01:00:00;NORTE;3;0;3;1
2019-10-01 02:00:00;NORTE;6;0;6;1
2019-10-01 02:30:00;NORTE;6;0;6;1
2019-10-01 03:00:00;NORTE;2;0;2;1
2019-10-01 03:30:00;NORTE;10;0;10;1
2019-10-01 04:00:00;NORTE;12;0;12;1
2019-10-01 04:30:00;NORTE;15;0;15;1
2019-10-01 05:00:00;NORTE;24;0;24;1
2019-10-01 05:30:00;NORTE;42;0;42;1
2019-10-01 06:00:00;NORTE;23;0;23;1
2019-10-01 06:30:00;NORTE;23;0;23;1
2019-10-01 07:00:00;NORTE;34;0;34;1
2019-10-01 07:30:00;NORTE;28;0;28;1
2019-10-01 08:00:00;NORTE;43;0;43;1
2019-10-01 08:30:00;NORTE;41;0;41;1
2019-10-01 09:00:00;NORTE;23;0;23;1
2019-10-01 09:30:00;NORTE;33;0;33;1
2019-10-01 10:00:00;NORTE;45;0;45;1
2019-10-01 10:30:00;NORTE;37;0;37;1
2019-10-01 11:00:00;NORTE;31;0;31;1
2019-10-01 11:30:00;NORTE;33;0;33;1
2019-10-01 12:00:00;NORTE;26;0;26;1
2019-10-01 12:30:00;NORTE;35;0;35;1
2019-10-01 13:00:00;NORTE;39;0;39;1
2019-10-01 13:30:00;NORTE;27;0;27;1
2019-10-01 14:00:00;NORTE;40;0;40;1
2019-10-01 14:30:00;NORTE;30;0;30;1
2019-10-01 15:00:00;NORTE;38;0;38;1
2019-10-01 15:30:00;NORTE;20;0;20;1
2019-10-01 16:00:00;NORTE;21;0;21;1
2019-10-01 16:30:00;NORTE;39;0;39;1
2019-10-01 17:00:00;NORTE;25;0;25;1
2019-10-01 17:30:00;NORTE;30;0;30;1
2019-10-01 18:00:00;NORTE;35;0;35;1
2019-10-01 18:30:00;NORTE;35;0;35;1
2019-10-01 19:00:00;NORTE;29;0;29;1
2019-10-01 19:30:00;NORTE;32;0;32;1
2019-10-01 20:00:00;NORTE;34;0;34;1
2019-10-01 20:30:00;NORTE;36;0;36;1
2019-10-01 21:00:00;NORTE;16;0;16;1
2019-10-01 21:30:00;NORTE;19;0;19;1
2019-10-01 22:00:00;NORTE;15;0;15;1
2019-10-01 22:30:00;NORTE;5;0;5;1
2019-10-01 23:00:00;NORTE;5;0;5;1
2019-10-01 23:30:00;NORTE;1;0;1;1
2019-10-02 00:00:00;NORTE;1;0;1;1
2019-10-02 00:30:00;NORTE;1;0;1;1
2019-10-02 01:30:00;NORTE;4;0;4;1
2019-10-02 02:00:00;NORTE;1;0;1;1
2019-10-02 02:30:00;NORTE;5;0;5;1
2019-10-02 03:00:00;NORTE;4;0;4;1
2019-10-02 03:30:00;NORTE;8;0;8;1
2019-10-02 04:00:00;NORTE;12;0;12;1
2019-10-02 04:30:00;NORTE;13;0;13;1
2019-10-02 05:00:00;NORTE;24;0;24;1
2019-10-02 05:30:00;NORTE;48;0;48;1
2019-10-02 06:00:00;NORTE;22;0;22;1
2019-10-02 06:30:00;NORTE;26;0;26;1
2019-10-02 07:00:00;NORTE;35;0;35;1
2019-10-02 07:30:00;NORTE;25;0;25;1
2019-10-02 08:00:00;NORTE;38;0;38;1
2019-10-02 08:30:00;NORTE;43;0;43;1
2019-10-02 09:00:00;NORTE;24;0;24;1
2019-10-02 09:30:00;NORTE;35;0;35;1
2019-10-02 10:00:00;NORTE;40;0;40;1
2019-10-02 10:30:00;NORTE;35;0;35;1
2019-10-02 11:00:00;NORTE;30;0;30;1
2019-10-02 11:30:00;NORTE;34;0;34;1
2019-10-02 12:00:00;NORTE;24;0;24;1
2019-10-02 12:30:00;NORTE;32;0;32;1
2019-10-02 13:00:00;NORTE;46;0;46;1
2019-10-02 13:30:00;NORTE;30;0;30;1
2019-10-02 14:00:00;NORTE;38;0;38;1
2019-10-02 14:30:00;NORTE;34;0;34;1
2019-10-02 15:00:00;NORTE;34;0;34;1
2019-10-02 15:30:00;NORTE;28;0;28;1
2019-10-02 16:00:00;NORTE;23;0;23;1
2019-10-02 16:30:00;NORTE;35;0;35;1
2019-10-02 17:00:00;NORTE;25;0;25;1
2019-10-02 17:30:00;NORTE;29;0;29;1
2019-10-02 18:00:00;NORTE;40;0;40;1
2019-10-02 18:30:00;NORTE;34;0;34;1
2019-10-02 19:00:00;NORTE;31;0;31;1
2019-10-02 19:30:00;NORTE;33;0;33;1
2019-10-02 20:00:00;NORTE;39;0;39;1
2019-10-02 20:30:00;NORTE;26;0;26;1
2019-10-02 21:00:00;NORTE;19;0;19;1
2019-10-02 21:30:00;NORTE;16;0;16;1
2019-10-02 22:00:00;NORTE;10;0;10;1
2019-10-02 22:30:00;NORTE;2;0;2;1
2019-10-02 23:00:00;NORTE;1;0;1;1
2019-10-03 00:00:00;NORTE;2;0;2;1
2019-10-03 01:00:00;NORTE;1;0;1;1
2019-10-03 01:30:00;NORTE;1;0;1;1
2019-10-03 02:00:00;NORTE;3;0;3;1
2019-10-03 02:30:00;NORTE;6;0;6;1
2019-10-03 03:00:00;NORTE;4;0;4;1
2019-10-03 03:30:00;NORTE;9;0;9;1
2019-10-03 04:00:00;NORTE;11;0;11;1
2019-10-03 04:30:00;NORTE;14;0;14;1
2019-10-03 05:00:00;NORTE;21;0;21;1
2019-10-03 05:30:00;NORTE;43;0;43;1
2019-10-03 06:00:00;NORTE;24;0;24;1
2019-10-03 06:30:00;NORTE;31;0;31;1
2019-10-03 07:00:00;NORTE;36;0;36;1
2019-10-03 07:30:00;NORTE;28;1;29;1
2019-10-03 08:00:00;NORTE;34;0;34;1
2019-10-03 08:30:00;NORTE;38;0;38;1
2019-10-03 09:00:00;NORTE;32;0;32;1
2019-10-03 09:30:00;NORTE;38;0;38;1
2019-10-03 10:00:00;NORTE;34;0;34;1
2019-10-03 10:30:00;NORTE;35;0;35;1
2019-10-03 11:00:00;NORTE;35;0;35;1
2019-10-03 11:30:00;NORTE;29;0;29;1
2019-10-03 12:00:00;NORTE;29;1;30;1
2019-10-03 12:30:00;NORTE;35;0;35;1
2019-10-03 13:00:00;NORTE;39;0;39;1
2019-10-03 13:30:00;NORTE;37;0;37;1
2019-10-03 14:00:00;NORTE;41;0;41;1
2019-10-03 14:30:00;NORTE;32;0;32;1
2019-10-03 15:00:00;NORTE;36;0;36;1
2019-10-03 15:30:00;NORTE;24;0;24;1
2019-10-03 16:00:00;NORTE;20;0;20;1
2019-10-03 16:30:00;NORTE;35;0;35;1
2019-10-03 17:00:00;NORTE;24;0;24;1
2019-10-03 17:30:00;NORTE;33;0;33;1
2019-10-03 18:00:00;NORTE;38;0;38;1
2019-10-03 18:30:00;NORTE;32;0;32;1
2019-10-03 19:00:00;NORTE;36;0;36;1
2019-10-03 19:30:00;NORTE;33;0;33;1
2019-10-03 20:00:00;NORTE;31;0;31;1
2019-10-03 20:30:00;NORTE;27;0;27;1
2019-10-03 21:00:00;NORTE;17;0;17;1
2019-10-03 21:30:00;NORTE;16;0;16;1
2019-10-03 22:00:00;NORTE;13;0;13;1
2019-10-03 22:30:00;NORTE;4;0;4;1
2019-10-03 23:00:00;NORTE;2;0;2;1
2019-10-04 01:00:00;NORTE;4;0;4;1
2019-10-04 01:30:00;NORTE;1;0;1;1
2019-10-04 02:00:00;NORTE;3;0;3;1
2019-10-04 02:30:00;NORTE;6;0;6;1
2019-10-04 03:00:00;NORTE;5;0;5;1
2019-10-04 03:30:00;NORTE;11;0;11;1
2019-10-04 04:00:00;NORTE;12;0;12;1
2019-10-04 04:30:00;NORTE;11;0;11;1
2019-10-04 05:00:00;NORTE;26;0;26;1
2019-10-04 05:30:00;NORTE;35;0;35;1
2019-10-04 06:00:00;NORTE;26;0;26;1
2019-10-04 06:30:00;NORTE;24;0;24;1
2019-10-04 07:00:00;NORTE;41;0;41;1
2019-10-04 07:30:00;NORTE;28;0;28;1
2019-10-04 08:00:00;NORTE;43;0;43;1
2019-10-04 08:30:00;NORTE;39;0;39;1
2019-10-04 09:00:00;NORTE;25;0;25;1
2019-10-04 09:30:00;NORTE;38;0;38;1
2019-10-04 10:00:00;NORTE;40;0;40;1
2019-10-04 10:30:00;NORTE;26;0;26;1
2019-10-04 11:00:00;NORTE;33;0;33;1
2019-10-04 11:30:00;NORTE;29;0;29;1
2019-10-04 12:00:00;CONFLICTIVA;13;15;28;2
2019-10-04 12:30:00;SUR;0;34;34;1
2019-10-04 13:00:00;SUR;0;43;43;1
2019-10-04 13:30:00;SUR;0;37;37;1
2019-10-04 14:00:00;SUR;0;43;43;1
2019-10-04 14:30:00;SUR;0;38;38;1
2019-10-04 15:00:00;SUR;0;32;32;1
2019-10-04 15:30:00;SUR;0;13;13;1
2019-10-04 16:00:00;SUR;0;21;21;1
2019-10-04 16:30:00;SUR;0;33;33;1
2019-10-04 17:00:00;SUR;0;31;31;1
2019-10-04 17:30:00;SUR;0;31;31;1
2019-10-04 18:00:00;SUR;0;38;38;1
2019-10-04 18:30:00;SUR;0;35;35;1
2019-10-04 19:00:00;SUR;0;29;29;1
2019-10-04 19:30:00;SUR;0;28;28;1
2019-10-04 20:00:00;SUR;0;34;34;1
2019-10-04 20:30:00;SUR;0;31;31;1
2019-10-04 21:00:00;SUR;1;16;17;1
2019-10-04 21:30:00;NORTE;21;0;21;1
2019-10-04 22:00:00;NORTE;13;0;13;1
2019-10-04 22:30:00;NORTE;4;0;4;1
2019-10-04 23:00:00;NORTE;2;0;2;1
2019-10-05 00:00:00;NORTE;1;0;1;1
2019-10-05 01:00:00;NORTE;4;0;4;1
2019-10-05 01:30:00;NORTE;2;0;2;1
2019-10-05 02:00:00;NORTE;2;0;2;1
2019-10-05 02:30:00;NORTE;3;0;3;1
2019-10-05 03:00:00;NORTE;6;0;6;1
2019-10-05 03:30:00;NORTE;6;0;6;1
2019-10-05 04:00:00;NORTE;12;0;12;1
2019-10-05 04:30:00;NORTE;10;0;10;1
2019-10-05 05:00:00;NORTE;25;0;25;1
2019-10-05 05:30:00;NORTE;27;0;27;1
2019-10-05 06:00:00;NORTE;22;0;22;1
2019-10-05 06:30:00;NORTE;24;0;24;1
2019-10-05 07:00:00;NORTE;43;0;43;1
2019-10-05 07:30:00;NORTE;33;0;33;1
2019-10-05 08:00:00;NORTE;36;0;36;1
2019-10-05 08:30:00;NORTE;40;0;40;1
2019-10-05 09:00:00;NORTE;26;0;26;1
2019-10-05 09:30:00;NORTE;30;0;30;1
2019-10-05 10:00:00;NORTE;37;0;37;1
2019-10-05 10:30:00;NORTE;39;0;39;1
2019-10-05 11:00:00;NORTE;26;0;26;1
2019-10-05 11:30:00;NORTE;23;0;23;1
2019-10-05 12:00:00;NORTE;26;0;26;1
2019-10-05 12:30:00;NORTE;38;0;38;1
2019-10-05 13:00:00;NORTE;36;0;36;1
2019-10-05 13:30:00;NORTE;29;0;29;1
2019-10-05 14:00:00;NORTE;38;0;38;1
2019-10-05 14:30:00;NORTE;36;0;36;1
2019-10-05 15:00:00;NORTE;25;0;25;1
2019-10-05 15:30:00;NORTE;25;0;25;1
2019-10-05 16:00:00;NORTE;20;0;20;1
2019-10-05 16:30:00;NORTE;32;0;32;1
2019-10-05 17:00:00;NORTE;18;0;18;1
2019-10-05 17:30:00;NORTE;15;0;15;1
2019-10-05 18:00:00;NORTE;37;0;37;1
2019-10-05 18:30:00;NORTE;22;0;22;1
2019-10-05 19:00:00;NORTE;26;0;26;1
2019-10-05 19:30:00;NORTE;32;0;32;1
2019-10-05 20:00:00;NORTE;15;0;15;1
2019-10-05 20:30:00;NORTE;22;0;22;1
2019-10-05 21:00:00;NORTE;8;0;8;1
2019-10-05 21:30:00;NORTE;14;0;14;1
2019-10-05 22:00:00;NORTE;14;0;14;1
2019-10-05 22:30:00;NORTE;5;0;5;1
2019-10-05 23:00:00;NORTE;3;0;3;1
2019-10-05 23:30:00;NORTE;1;0;1;1
2019-10-06 00:00:00;NORTE;1;0;1;1
2019-10-06 00:30:00;NORTE;1;0;1;1
2019-10-06 01:00:00;NORTE;2;0;2;1
2019-10-06 01:30:00;NORTE;2;0;2;1
2019-10-06 02:00:00;NORTE;1;0;1;1
2019-10-06 02:30:00;NORTE;5;0;5;1
2019-10-06 03:00:00;NORTE;3;0;3;1
2019-10-06 03:30:00;NORTE;7;0;7;1
2019-10-06 04:00:00;NORTE;9;0;9;1
2019-10-06 04:30:00;NORTE;11;0;11;1
2019-10-06 05:00:00;NORTE;20;0;20;1
2019-10-06 05:30:00;NORTE;26;0;26;1
2019-10-06 06:00:00;NORTE;19;0;19;1
2019-10-06 06:30:00;NORTE;25;0;25;1
2019-10-06 07:00:00;NORTE;36;0;36;1
2019-10-06 07:30:00;NORTE;32;0;32;1
2019-10-06 08:00:00;NORTE;39;0;39;1
2019-10-06 08:30:00;NORTE;42;0;42;1
2019-10-06 09:00:00;NORTE;21;0;21;1
2019-10-06 09:30:00;NORTE;30;0;30;1
2019-10-06 10:00:00;NORTE;35;0;35;1
2019-10-06 10:30:00;NORTE;33;0;33;1
2019-10-06 11:00:00;NORTE;36;0;36;1
2019-10-06 11:30:00;NORTE;28;0;28;1
2019-10-06 12:00:00;NORTE;28;0;28;1
2019-10-06 12:30:00;NORTE;33;0;33;1
2019-10-06 13:00:00;NORTE;36;0;36;1
2019-10-06 13:30:00;NORTE;37;0;37;1
2019-10-06 14:00:00;NORTE;41;0;41;1
2019-10-06 14:30:00;NORTE;33;0;33;1
2019-10-06 15:00:00;NORTE;34;0;34;1
2019-10-06 15:30:00;NORTE;25;0;25;1
2019-10-06 16:00:00;NORTE;17;0;17;1
2019-10-06 16:30:00;NORTE;36;0;36;1
2019-10-06 17:00:00;NORTE;28;0;28;1
2019-10-06 17:30:00;NORTE;25;0;25;1
2019-10-06 18:00:00;NORTE;36;0;36;1
2019-10-06 18:30:00;NORTE;36;0;36;1
2019-10-06 19:00:00;NORTE;32;0;32;1
2019-10-06 19:30:00;NORTE;32;1;33;1
2019-10-06 20:00:00;NORTE;34;0;34;1
2019-10-06 20:30:00;NORTE;26;0;26;1
2019-10-06 21:00:00;NORTE;18;0;18;1
2019-10-06 21:30:00;NORTE;17;0;17;1
2019-10-06 22:00:00;NORTE;16;0;16;1
2019-10-06 22:30:00;NORTE;4;0;4;1
2019-10-06 23:00:00;NORTE;1;0;1;1
2019-10-06 23:30:00;NORTE;4;0;4;1
2019-10-07 00:00:00;NORTE;1;0;1;1
2019-10-07 01:00:00;NORTE;1;0;1;1
2019-10-07 01:30:00;NORTE;2;0;2;1
2019-10-07 02:00:00;NORTE;4;0;4;1
2019-10-07 02:30:00;NORTE;6;0;6;1
2019-10-07 03:00:00;NORTE;1;0;1;1
2019-10-07 03:30:00;NORTE;6;0;6;1
2019-10-07 04:00:00;NORTE;9;0;9;1
2019-10-07 04:30:00;NORTE;14;0;14;1
2019-10-07 05:00:00;NORTE;23;0;23;1
2019-10-07 05:30:00;NORTE;49;0;49;1
2019-10-07 06:00:00;NORTE;26;0;26;1
2019-10-07 06:30:00;NORTE;33;0;33;1
2019-10-07 07:00:00;NORTE;34;0;34;1
2019-10-07 07:30:00;NORTE;37;0;37;1
2019-10-07 08:00:00;NORTE;44;0;44;1
2019-10-07 08:30:00;NORTE;42;0;42;1
2019-10-07 09:00:00;NORTE;27;0;27;1
2019-10-07 09:30:00;NORTE;37;0;37;1
2019-10-07 10:00:00;NORTE;37;0;37;1
2019-10-07 10:30:00;NORTE;33;0;33;1
2019-10-07 11:00:00;NORTE;40;0;40;1
2019-10-07 11:30:00;NORTE;34;0;34;1
2019-10-07 12:00:00;NORTE;30;0;30;1
2019-10-07 12:30:00;NORTE;34;0;34;1
2019-10-07 13:00:00;NORTE;44;0;44;1
2019-10-07 13:30:00;NORTE;40;0;40;1
2019-10-07 14:00:00;NORTE;40;0;40;1
2019-10-07 14:30:00;NORTE;29;0;29;1
2019-10-07 15:00:00;NORTE;33;0;33;1
2019-10-07 15:30:00;NORTE;25;0;25;1
2019-10-07 16:00:00;NORTE;12;0;12;1
2019-10-07 16:30:00;NORTE;38;0;38;1
2019-10-07 17:00:00;NORTE;34;0;34;1
2019-10-07 17:30:00;NORTE;27;0;27;1
2019-10-07 18:00:00;NORTE;34;0;34;1
2019-10-07 18:30:00;NORTE;37;0;37;1
2019-10-07 19:00:00;NORTE;35;0;35;1
2019-10-07 19:30:00;NORTE;33;0;33;1
2019-10-07 20:00:00;NORTE;28;0;28;1
2019-10-07 20:30:00;NORTE;22;0;22;1
2019-10-07 21:00:00;NORTE;12;0;12;1
2019-10-07 21:30:00;NORTE;19;0;19;1
2019-10-07 22:00:00;NORTE;13;0;13;1
2019-10-07 22:30:00;NORTE;4;0;4;1
2019-10-07 23:00:00;NORTE;3;0;3;1
2019-10-08 00:00:00;NORTE;2;0;2;1
2019-10-08 00:30:00;NORTE;1;0;1;1
2019-10-08 01:00:00;NORTE;1;0;1;1
2019-10-08 01:30:00;NORTE;1;0;1;1
2019-10-08 02:00:00;NORTE;3;0;3;1
2019-10-08 02:30:00;NORTE;4;0;4;1
2019-10-08 03:00:00;NORTE;7;0;7;1
2019-10-08 03:30:00;NORTE;11;0;11;1
2019-10-08 04:00:00;NORTE;8;0;8;1
2019-10-08 04:30:00;NORTE;15;0;15;1
2019-10-08 05:00:00;NORTE;25;0;25;1
2019-10-08 05:30:00;NORTE;44;0;44;1
2019-10-08 06:00:00;NORTE;16;1;17;1
2019-10-08 06:30:00;NORTE;26;0;26;1
2019-10-08 07:00:00;NORTE;34;0;34;1
2019-10-08 07:30:00;NORTE;39;0;39;1
2019-10-08 08:00:00;NORTE;39;0;39;1
2019-10-08 08:30:00;NORTE;37;0;37;1
2019-10-08 09:00:00;NORTE;29;0;29;1
2019-10-08 09:30:00;NORTE;34;0;34;1
2019-10-08 10:00:00;NORTE;42;0;42;1
2019-10-08 10:30:00;NORTE;36;0;36;1
2019-10-08 11:00:00;NORTE;25;0;25;1
2019-10-08 11:30:00;NORTE;34;0;34;1
2019-10-08 12:00:00;NORTE;29;0;29;1
2019-10-08 12:30:00;NORTE;35;0;35;1
2019-10-08 13:00:00;NORTE;46;0;46;1
2019-10-08 13:30:00;NORTE;29;0;29;1
2019-10-08 14:00:00;NORTE;43;0;43;1
2019-10-08 14:30:00;NORTE;34;0;34;1
2019-10-08 15:00:00;NORTE;31;0;31;1
2019-10-08 15:30:00;NORTE;23;0;23;1
2019-10-08 16:00:00;NORTE;24;0;24;1
2019-10-08 16:30:00;NORTE;39;0;39;1
2019-10-08 17:00:00;NORTE;28;0;28;1
2019-10-08 17:30:00;NORTE;26;0;26;1
2019-10-08 18:00:00;NORTE;39;0;39;1
2019-10-08 18:30:00;NORTE;30;0;30;1
2019-10-08 19:00:00;NORTE;36;0;36;1
2019-10-08 19:30:00;NORTE;30;0;30;1
2019-10-08 20:00:00;NORTE;42;0;42;1
2019-10-08 20:30:00;NORTE;24;0;24;1
2019-10-08 21:00:00;NORTE;19;0;19;1
2019-10-08 21:30:00;NORTE;15;0;15;1
2019-10-08 22:00:00;NORTE;10;0;10;1
2019-10-08 22:30:00;NORTE;6;0;6;1
2019-10-08 23:06:19;NORTE;1;0;1;1
2019-10-08 23:08:41;NORTE;1;0;1;1
2019-10-08 23:11:34;NORTE;1;0;1;1
2019-10-08 23:11:57;NORTE;1;0;1;1
2019-10-08 23:23:13;NORTE;1;0;1;1
2019-10-08 23:33:37;NORTE;1;0;1;1
2019-10-08 23:45:31;NORTE;1;0;1;1
2019-10-09 00:16:37;NORTE;1;0;1;1
2019-10-09 01:00:00;NORTE;2;0;2;1
2019-10-09 02:00:00;NORTE;1;0;1;1
2019-10-09 02:30:00;NORTE;4;0;4;1
2019-10-09 03:00:00;NORTE;4;0;4;1
2019-10-09 03:30:00;NORTE;10;0;10;1
2019-10-09 04:00:00;NORTE;16;0;16;1
2019-10-09 04:30:00;NORTE;12;0;12;1
2019-10-09 05:00:00;NORTE;30;1;31;1
2019-10-09 05:30:00;NORTE;46;0;46;1
2019-10-09 06:00:00;NORTE;22;0;22;1
2019-10-09 06:30:00;NORTE;24;0;24;1
2019-10-09 07:00:00;NORTE;41;0;41;1
2019-10-09 07:30:00;NORTE;29;0;29;1
2019-10-09 08:00:00;NORTE;38;0;38;1
2019-10-09 08:30:00;NORTE;50;0;50;1
2019-10-09 09:00:00;NORTE;25;0;25;1
2019-10-09 09:30:00;NORTE;35;0;35;1
2019-10-09 10:00:00;NORTE;33;0;33;1
2019-10-09 10:30:00;NORTE;33;0;33;1
2019-10-09 11:00:00;NORTE;35;0;35;1
2019-10-09 11:30:00;NORTE;35;0;35;1
2019-10-09 12:00:00;NORTE;25;0;25;1
2019-10-09 12:30:00;NORTE;41;0;41;1
2019-10-09 13:00:00;NORTE;43;0;43;1
2019-10-09 13:30:00;NORTE;36;0;36;1
2019-10-09 14:00:00;NORTE;38;0;38;1
2019-10-09 14:30:00;NORTE;32;0;32;1
2019-10-09 15:00:00;NORTE;33;0;33;1
2019-10-09 15:30:27;NORTE;1;0;1;1
2019-10-09 15:31:26;NORTE;1;0;1;1
2019-10-09 15:33:12;NORTE;1;0;1;1
2019-10-09 15:34:01;NORTE;1;0;1;1
2019-10-09 15:34:22;NORTE;1;0;1;1
2019-10-09 15:34:48;NORTE;1;0;1;1
2019-10-09 15:36:06;NORTE;1;0;1;1
2019-10-09 15:36:17;NORTE;1;0;1;1
2019-10-09 15:37:13;NORTE;1;0;1;1
2019-10-09 15:37:26;NORTE;1;0;1;1
2019-10-09 15:38:30;NORTE;1;0;1;1
2019-10-09 15:39:24;NORTE;1;0;1;1
2019-10-09 15:39:37;NORTE;1;0;1;1
2019-10-09 15:40:28;NORTE;1;0;1;1
2019-10-09 15:41:15;NORTE;1;0;1;1
2019-10-09 15:42:01;NORTE;1;0;1;1
2019-10-09 15:43:36;NORTE;1;0;1;1
2019-10-09 15:48:06;NORTE;1;0;1;1
2019-10-09 15:48:14;NORTE;1;0;1;1
2019-10-09 15:49:24;NORTE;1;0;1;1
2019-10-09 15:51:33;NORTE;1;0;1;1
2019-10-09 15:53:15;NORTE;1;0;1;1
2019-10-09 15:53:59;NORTE;1;0;1;1
2019-10-09 15:55:29;NORTE;1;0;1;1
2019-10-09 15:55:37;NORTE;1;0;1;1
2019-10-09 15:57:13;NORTE;1;0;1;1
2019-10-09 15:58:29;NORTE;1;0;1;1
2019-10-09 16:01:14;NORTE;1;0;1;1
2019-10-09 16:02:39;NORTE;1;0;1;1
2019-10-09 16:06:17;NORTE;1;0;1;1
2019-10-09 16:08:03;NORTE;1;0;1;1
2019-10-09 16:10:46;NORTE;1;0;1;1
2019-10-09 16:10:53;NORTE;1;0;1;1
2019-10-09 16:12:09;NORTE;1;0;1;1
2019-10-09 16:13:56;NORTE;1;0;1;1
2019-10-09 16:14:12;NORTE;1;0;1;1
2019-10-09 16:15:38;NORTE;1;0;1;1
2019-10-09 16:15:39;NORTE;1;0;1;1
2019-10-09 16:17:07;NORTE;1;0;1;1
2019-10-09 16:18:17;NORTE;1;0;1;1
2019-10-09 16:19:22;NORTE;1;0;1;1
2019-10-09 16:19:56;NORTE;1;0;1;1
2019-10-09 16:19:57;NORTE;1;0;1;1
2019-10-09 16:21:51;NORTE;1;0;1;1
2019-10-09 16:21:55;NORTE;1;0;1;1
2019-10-09 16:22:20;NORTE;1;0;1;1
2019-10-09 16:24:19;NORTE;1;0;1;1
2019-10-09 16:24:22;NORTE;1;0;1;1
2019-10-09 16:24:47;NORTE;1;0;1;1
2019-10-09 16:25:26;NORTE;1;0;1;1
2019-10-09 16:26:54;NORTE;1;0;1;1
2019-10-09 16:27:01;NORTE;1;0;1;1
2019-10-09 16:27:17;NORTE;1;0;1;1
2019-10-09 16:28:20;NORTE;1;0;1;1
2019-10-09 16:28:50;NORTE;1;0;1;1
2019-10-09 16:28:58;NORTE;1;0;1;1
2019-10-09 16:29:21;NORTE;1;0;1;1
2019-10-09 16:30:12;NORTE;1;0;1;1
2019-10-09 16:30:23;NORTE;1;0;1;1
2019-10-09 16:32:02;NORTE;1;0;1;1
2019-10-09 16:32:29;NORTE;1;0;1;1
2019-10-09 16:32:44;NORTE;1;0;1;1
2019-10-09 16:34:18;NORTE;1;0;1;1
2019-10-09 16:34:38;NORTE;1;0;1;1
2019-10-09 16:34:39;NORTE;1;0;1;1
2019-10-09 16:36:10;NORTE;1;0;1;1
2019-10-09 16:36:53;NORTE;1;0;1;1
2019-10-09 16:37:11;NORTE;1;0;1;1
2019-10-09 16:37:54;NORTE;1;0;1;1
2019-10-09 16:39:05;NORTE;1;0;1;1
2019-10-09 16:39:58;NORTE;1;0;1;1
2019-10-09 16:40:22;NORTE;1;0;1;1
2019-10-09 16:41:38;NORTE;1;0;1;1
2019-10-09 16:43:01;NORTE;1;0;1;1
2019-10-09 16:43:55;NORTE;1;0;1;1
2019-10-09 16:45:09;NORTE;1;0;1;1
2019-10-09 16:45:53;NORTE;1;0;1;1
2019-10-09 16:48:03;NORTE;1;0;1;1
2019-10-09 16:49:15;NORTE;1;0;1;1
2019-10-09 16:50:18;NORTE;1;0;1;1
2019-10-09 16:51:45;NORTE;1;0;1;1
2019-10-09 16:52:20;NORTE;1;0;1;1
2019-10-09 16:54:08;NORTE;1;0;1;1
2019-10-09 16:55:09;NORTE;1;0;1;1
2019-10-09 16:55:59;NORTE;1;0;1;1
2019-10-09 16:58:01;NORTE;1;0;1;1
2019-10-09 16:58:59;NORTE;1;0;1;1
2019-10-09 16:59:28;NORTE;1;0;1;1
2019-10-09 17:00:00;NORTE;26;0;26;1
2019-10-09 17:30:00;NORTE;30;0;30;1
2019-10-09 18:00:00;NORTE;42;0;42;1
2019-10-09 18:30:00;NORTE;27;0;27;1
2019-10-09 19:00:00;NORTE;38;0;38;1
2019-10-09 19:30:00;NORTE;29;0;29;1
2019-10-09 20:00:00;NORTE;38;0;38;1
2019-10-09 20:30:00;NORTE;32;0;32;1
2019-10-09 21:00:00;NORTE;10;0;10;1
2019-10-09 21:30:00;NORTE;14;0;14;1
2019-10-09 22:00:00;NORTE;10;0;10;1
2019-10-09 22:30:00;NORTE;7;0;7;1
2019-10-09 23:00:00;NORTE;1;0;1;1
2019-10-10 00:00:00;NORTE;2;0;2;1
2019-10-10 00:30:00;NORTE;1;0;1;1
2019-10-10 01:00:00;NORTE;1;0;1;1
2019-10-10 01:30:00;NORTE;1;0;1;1
2019-10-10 02:00:00;NORTE;6;0;6;1
2019-10-10 02:30:00;NORTE;4;0;4;1
2019-10-10 03:00:00;NORTE;4;0;4;1
2019-10-10 03:30:00;NORTE;11;0;11;1
2019-10-10 04:00:00;NORTE;13;0;13;1
2019-10-10 04:30:00;NORTE;15;0;15;1
2019-10-10 05:00:00;NORTE;31;0;31;1
2019-10-10 05:30:00;NORTE;46;0;46;1
2019-10-10 06:00:00;NORTE;21;0;21;1
2019-10-10 06:30:00;NORTE;29;0;29;1
2019-10-10 07:00:00;NORTE;37;0;37;1
2019-10-10 07:30:00;NORTE;32;0;32;1
2019-10-10 08:00:00;NORTE;41;0;41;1
2019-10-10 08:30:00;NORTE;42;0;42;1
2019-10-10 09:00:00;NORTE;28;0;28;1
2019-10-10 09:30:00;NORTE;40;0;40;1
2019-10-10 10:00:00;NORTE;37;0;37;1
2019-10-10 10:30:00;NORTE;40;0;40;1
2019-10-10 11:00:00;NORTE;38;0;38;1
2019-10-10 11:30:00;NORTE;25;0;25;1
2019-10-10 12:00:00;NORTE;29;0;29;1
2019-10-10 12:30:00;NORTE;36;0;36;1
2019-10-10 13:00:00;NORTE;44;0;44;1
2019-10-10 13:30:00;NORTE;31;0;31;1
2019-10-10 14:00:00;NORTE;41;0;41;1
2019-10-10 14:30:00;NORTE;41;0;41;1
2019-10-10 15:00:00;NORTE;28;0;28;1
2019-10-10 15:30:00;NORTE;21;0;21;1
2019-10-10 16:00:00;NORTE;24;0;24;1
2019-10-10 16:30:00;NORTE;37;0;37;1
2019-10-10 17:00:00;NORTE;22;0;22;1
2019-10-10 17:30:00;NORTE;32;0;32;1
2019-10-10 18:00:00;NORTE;39;0;39;1
2019-10-10 18:30:00;NORTE;30;0;30;1
2019-10-10 19:00:00;NORTE;31;0;31;1
2019-10-10 19:30:00;NORTE;38;0;38;1
2019-10-10 20:00:00;NORTE;35;0;35;1
2019-10-10 20:30:00;NORTE;28;0;28;1
2019-10-10 21:00:00;NORTE;15;0;15;1
2019-10-10 21:30:00;NORTE;18;0;18;1
2019-10-10 22:00:00;NORTE;15;0;15;1
2019-10-10 22:30:00;NORTE;4;0;4;1
2019-10-10 23:00:00;NORTE;3;0;3;1
2019-10-11 00:00:00;NORTE;1;0;1;1
2019-10-11 00:30:00;NORTE;2;0;2;1
2019-10-11 01:00:00;NORTE;1;0;1;1
2019-10-11 02:00:00;NORTE;4;0;4;1
2019-10-11 02:30:00;NORTE;5;0;5;1
2019-10-11 03:00:00;NORTE;4;0;4;1
2019-10-11 03:30:00;NORTE;8;0;8;1
2019-10-11 04:00:00;NORTE;16;0;16;1
2019-10-11 04:30:00;NORTE;13;0;13;1
2019-10-11 05:00:00;NORTE;25;0;25;1
2019-10-11 05:30:00;NORTE;43;0;43;1
2019-10-11 06:00:00;NORTE;19;0;19;1
2019-10-11 06:30:00;NORTE;23;0;23;1
2019-10-11 07:00:00;NORTE;43;0;43;1
2019-10-11 07:30:00;NORTE;37;0;37;1
2019-10-11 08:00:00;NORTE;41;0;41;1
2019-10-11 08:30:00;NORTE;46;0;46;1
2019-10-11 09:00:00;NORTE;28;0;28;1
2019-10-11 09:30:00;NORTE;39;0;39;1
2019-10-11 10:00:00;NORTE;42;0;42;1
2019-10-11 10:30:00;NORTE;38;0;38;1
2019-10-11 11:00:00;NORTE;34;0;34;1
2019-10-11 11:30:00;NORTE;38;0;38;1
2019-10-11 12:00:00;NORTE;24;0;24;1
2019-10-11 12:30:00;SUR;0;32;32;1
2019-10-11 13:00:00;SUR;0;42;42;1
2019-10-11 13:30:00;SUR;0;39;39;1
2019-10-11 14:00:00;SUR;0;35;35;1
2019-10-11 14:30:00;SUR;0;43;43;1
2019-10-11 15:00:00;SUR;0;38;38;1
2019-10-11 15:30:00;SUR;0;27;27;1
2019-10-11 16:00:00;SUR;0;30;30;1
2019-10-11 16:30:00;SUR;0;36;36;1
2019-10-11 17:00:00;SUR;0;29;29;1
2019-10-11 17:30:00;CONFLICTIVA;2;15;17;2
2019-10-11 18:00:00;NORTE;42;0;42;1
2019-10-11 18:30:00;NORTE;33;0;33;1
2019-10-11 19:00:00;NORTE;34;0;34;1
2019-10-11 19:30:00;NORTE;32;0;32;1
2019-10-11 20:00:00;NORTE;29;0;29;1
2019-10-11 20:30:00;NORTE;37;0;37;1
2019-10-11 21:00:00;NORTE;22;0;22;1
2019-10-11 21:30:00;NORTE;14;0;14;1
2019-10-11 22:00:00;NORTE;16;0;16;1
2019-10-11 22:30:00;NORTE;7;0;7;1
2019-10-11 23:00:00;NORTE;3;0;3;1
2019-10-11 23:30:00;NORTE;1;0;1;1
2019-10-12 00:00:00;NORTE;2;0;2;1
2019-10-12 00:30:00;NORTE;1;0;1;1
2019-10-12 01:00:00;NORTE;2;0;2;1
2019-10-12 01:30:00;NORTE;1;0;1;1
2019-10-12 02:00:00;NORTE;4;0;4;1
2019-10-12 02:30:00;NORTE;2;0;2;1
2019-10-12 03:00:00;NORTE;1;0;1;1
2019-10-12 03:30:00;NORTE;6;0;6;1
2019-10-12 04:00:00;NORTE;12;0;12;1
2019-10-12 04:30:00;NORTE;9;0;9;1
2019-10-12 05:00:00;NORTE;26;0;26;1
2019-10-12 05:30:00;NORTE;30;0;30;1
2019-10-12 06:00:00;NORTE;20;0;20;1
2019-10-12 06:30:00;NORTE;23;0;23;1
2019-10-12 07:00:00;NORTE;38;0;38;1
2019-10-12 07:30:00;NORTE;34;0;34;1
2019-10-12 08:00:00;NORTE;33;0;33;1
2019-10-12 08:30:00;NORTE;37;0;37;1
2019-10-12 09:00:00;NORTE;27;0;27;1
2019-10-12 09:30:00;NORTE;9;0;9;1
2019-10-12 10:00:00;NORTE;53;0;53;1
2019-10-12 10:30:00;NORTE;47;0;47;1
2019-10-12 11:00:00;NORTE;36;0;36;1
2019-10-12 11:30:00;CONFLICTIVA;14;12;26;2
2019-10-12 12:00:00;SUR;0;28;28;1
2019-10-12 12:30:00;SUR;0;35;35;1
2019-10-12 13:00:00;SUR;0;38;38;1
2019-10-12 13:30:00;SUR;0;31;31;1
2019-10-12 14:00:00;SUR;0;38;38;1
2019-10-12 14:30:00;SUR;0;24;24;1
2019-10-12 15:00:00;SUR;0;33;33;1
2019-10-12 15:30:00;SUR;0;21;21;1
2019-10-12 16:00:00;SUR;0;20;20;1
2019-10-12 16:30:00;SUR;0;31;31;1
2019-10-12 17:00:00;SUR;0;23;23;1
2019-10-12 17:30:00;SUR;0;16;16;1
2019-10-12 18:00:00;SUR;0;34;34;1
2019-10-12 18:30:00;SUR;0;20;20;1
2019-10-12 19:00:00;SUR;0;2;2;1
2019-10-12 19:06:00;SUR;0;7;7;1
2019-10-12 19:30:00;SUR;0;15;15;1
2019-10-12 20:00:00;SUR;0;22;22;1
2019-10-12 20:30:00;SUR;0;24;24;1
2019-10-12 21:00:00;SUR;0;14;14;1
2019-10-12 21:30:00;SUR;0;14;14;1
2019-10-12 22:00:00;SUR;0;23;23;1
2019-10-12 22:30:00;CONFLICTIVA;1;6;7;2
2019-10-12 23:00:00;NORTE;4;0;4;1
2019-10-12 23:30:00;NORTE;4;0;4;1
2019-10-13 00:30:00;NORTE;2;0;2;1
2019-10-13 01:00:00;NORTE;1;0;1;1
2019-10-13 01:30:00;NORTE;3;0;3;1
2019-10-13 02:30:00;NORTE;2;0;2;1
2019-10-13 03:00:00;NORTE;2;0;2;1
2019-10-13 03:30:00;NORTE;6;0;6;1
2019-10-13 04:00:00;NORTE;9;0;9;1
2019-10-13 04:30:00;NORTE;17;0;17;1
2019-10-13 05:00:00;NORTE;20;0;20;1
2019-10-13 05:30:00;NORTE;26;0;26;1
2019-10-13 06:00:00;NORTE;11;0;11;1
2019-10-13 06:30:00;NORTE;32;0;32;1
2019-10-13 07:00:00;NORTE;41;0;41;1
2019-10-13 07:30:00;NORTE;30;0;30;1
2019-10-13 08:00:00;NORTE;38;0;38;1
2019-10-13 08:30:00;NORTE;41;0;41;1
2019-10-13 09:00:00;NORTE;25;0;25;1
2019-10-13 09:30:00;SUR;0;33;33;1
2019-10-13 10:00:00;SUR;0;31;31;1
2019-10-13 10:30:00;SUR;0;36;36;1
2019-10-13 11:00:00;SUR;0;32;32;1
2019-10-13 11:30:00;SUR;0;31;31;1
2019-10-13 12:00:00;SUR;0;31;31;1
2019-10-13 12:30:00;SUR;0;34;34;1
2019-10-13 13:00:00;SUR;0;34;34;1
2019-10-13 13:30:00;SUR;0;33;33;1
2019-10-13 14:00:00;SUR;0;43;43;1
2019-10-13 14:30:00;SUR;0;39;39;1
2019-10-13 15:00:00;SUR;0;36;36;1
2019-10-13 15:30:00;SUR;0;25;25;1
2019-10-13 16:00:00;SUR;0;19;19;1
2019-10-13 16:30:00;SUR;0;37;37;1
2019-10-13 17:00:00;SUR;0;21;21;1
2019-10-13 17:30:00;SUR;0;22;22;1
2019-10-13 18:00:00;NORTE;45;0;45;1
2019-10-13 18:30:00;NORTE;33;0;33;1
2019-10-13 19:00:00;NORTE;34;0;34;1
2019-10-13 19:30:00;NORTE;33;0;33;1
2019-10-13 20:00:00;NORTE;35;0;35;1
2019-10-13 20:30:00;NORTE;31;0;31;1
2019-10-13 21:00:00;NORTE;15;0;15;1
2019-10-13 21:30:00;NORTE;18;0;18;1
2019-10-13 22:00:00;NORTE;19;0;19;1
2019-10-13 22:30:00;NORTE;5;0;5;1
2019-10-13 23:00:00;NORTE;3;0;3;1
2019-10-13 23:30:00;NORTE;2;0;2;1
2019-10-14 00:00:00;NORTE;2;0;2;1
2019-10-14 01:00:00;NORTE;3;0;3;1
2019-10-14 01:30:00;NORTE;3;0;3;1
2019-10-14 02:00:00;NORTE;2;0;2;1
2019-10-14 02:30:00;NORTE;6;0;6;1
2019-10-14 03:00:00;NORTE;2;0;2;1
2019-10-14 03:30:00;NORTE;10;0;10;1
2019-10-14 04:00:00;NORTE;5;0;5;1
2019-10-14 04:30:00;NORTE;13;0;13;1
2019-10-14 05:00:00;SUR;0;25;25;1
2019-10-14 05:30:00;SUR;0;40;40;1
2019-10-14 06:00:00;SUR;0;26;26;1
2019-10-14 06:30:00;SUR;0;29;29;1
2019-10-14 07:00:00;SUR;0;37;37;1
2019-10-14 07:30:00;SUR;0;31;31;1
2019-10-14 08:00:00;SUR;0;32;32;1
2019-10-14 08:30:00;SUR;0;42;42;1
2019-10-14 09:00:00;SUR;0;33;33;1
2019-10-14 09:30:00;SUR;0;39;39;1
2019-10-14 10:00:00;SUR;0;41;41;1
2019-10-14 10:30:00;SUR;0;30;30;1
2019-10-14 11:00:00;SUR;0;27;27;1
2019-10-14 11:30:00;SUR;0;32;32;1
2019-10-14 12:00:00;SUR;0;26;26;1
2019-10-14 12:30:00;SUR;0;30;30;1
2019-10-14 13:00:00;SUR;0;41;41;1
2019-10-14 13:30:00;SUR;0;42;42;1
2019-10-14 14:00:00;SUR;0;41;41;1
2019-10-14 14:30:00;SUR;0;33;33;1
2019-10-14 15:00:00;SUR;0;30;30;1
2019-10-14 15:30:00;SUR;0;32;32;1
2019-10-14 16:00:00;SUR;0;10;10;1
2019-10-14 16:15:00;SUR;0;5;5;1
2019-10-14 16:30:00;SUR;0;19;19;1
2019-10-14 16:47:00;SUR;0;18;18;1
2019-10-14 17:00:00;CONFLICTIVA;19;6;25;2
2019-10-14 17:30:00;NORTE;31;0;31;1
2019-10-14 18:00:00;NORTE;40;0;40;1
2019-10-14 18:30:00;NORTE;33;0;33;1
2019-10-14 19:00:00;NORTE;32;0;32;1
2019-10-14 19:30:00;NORTE;36;0;36;1
2019-10-14 20:00:00;NORTE;31;0;31;1
2019-10-14 20:30:00;NORTE;23;0;23;1
2019-10-14 21:00:00;NORTE;17;0;17;1
2019-10-14 21:30:00;NORTE;18;0;18;1
2019-10-14 22:00:00;NORTE;19;0;19;1
2019-10-14 22:30:00;NORTE;9;0;9;1
2019-10-14 23:00:00;NORTE;3;0;3;1
2019-10-14 23:30:00;NORTE;1;0;1;1
2019-10-15 00:00:00;NORTE;2;0;2;1
2019-10-15 01:00:00;NORTE;2;0;2;1
2019-10-15 01:30:00;NORTE;1;0;1;1
2019-10-15 02:00:00;NORTE;7;0;7;1
2019-10-15 02:30:00;NORTE;3;0;3;1
2019-10-15 03:00:00;NORTE;3;0;3;1
2019-10-15 03:30:00;NORTE;12;0;12;1
2019-10-15 04:00:00;NORTE;11;0;11;1
2019-10-15 04:30:00;NORTE;14;0;14;1
2019-10-15 05:00:00;NORTE;21;0;21;1
2019-10-15 05:30:00;NORTE;47;0;47;1
2019-10-15 06:00:00;NORTE;24;0;24;1
2019-10-15 06:30:00;NORTE;27;0;27;1
2019-10-15 07:00:00;NORTE;35;0;35;1
2019-10-15 07:30:00;NORTE;31;0;31;1
2019-10-15 08:00:00;NORTE;38;0;38;1
2019-10-15 08:30:00;NORTE;44;0;44;1
2019-10-15 09:00:00;NORTE;27;0;27;1
2019-10-15 09:30:00;NORTE;41;0;41;1
2019-10-15 10:00:00;NORTE;39;0;39;1
2019-10-15 10:30:00;NORTE;32;0;32;1
2019-10-15 11:00:00;NORTE;21;2;23;1
2019-10-15 11:30:00;SUR;0;38;38;1
2019-10-15 12:00:00;SUR;0;23;23;1
2019-10-15 12:30:00;SUR;0;34;34;1
2019-10-15 13:00:00;SUR;0;36;36;1
2019-10-15 13:30:00;SUR;0;35;35;1
2019-10-15 14:00:00;SUR;0;38;38;1
2019-10-15 14:30:00;SUR;0;35;35;1
2019-10-15 15:00:00;SUR;0;31;31;1
2019-10-15 15:30:00;SUR;0;26;26;1
2019-10-15 16:00:00;SUR;0;27;27;1
2019-10-15 16:30:00;SUR;0;30;30;1
2019-10-15 17:00:00;CONFLICTIVA;5;20;25;2
2019-10-15 17:30:00;NORTE;41;0;41;1
2019-10-15 18:00:00;NORTE;36;0;36;1
2019-10-15 18:30:00;NORTE;33;0;33;1
2019-10-15 19:00:00;NORTE;37;0;37;1
2019-10-15 19:30:00;NORTE;32;0;32;1
2019-10-15 20:00:00;NORTE;28;0;28;1
2019-10-15 20:30:00;NORTE;28;0;28;1
2019-10-15 21:00:00;NORTE;18;0;18;1
2019-10-15 21:30:00;NORTE;12;0;12;1
2019-10-15 22:00:00;NORTE;16;0;16;1
2019-10-15 22:30:00;NORTE;5;0;5;1
2019-10-15 23:00:00;NORTE;5;0;5;1
2019-10-15 23:30:00;NORTE;3;0;3;1
2019-10-16 00:30:00;NORTE;1;0;1;1
2019-10-16 01:00:00;NORTE;1;0;1;1
2019-10-16 01:30:00;NORTE;1;0;1;1
2019-10-16 02:00:00;NORTE;1;0;1;1
2019-10-16 02:30:00;NORTE;5;0;5;1
2019-10-16 03:00:00;NORTE;4;0;4;1
2019-10-16 03:30:00;NORTE;9;0;9;1
2019-10-16 04:00:00;NORTE;13;0;13;1
2019-10-16 04:30:00;NORTE;13;0;13;1
2019-10-16 05:00:00;NORTE;25;0;25;1
2019-10-16 05:30:00;NORTE;42;0;42;1
2019-10-16 06:00:00;NORTE;23;0;23;1
2019-10-16 06:30:00;NORTE;28;0;28;1
2019-10-16 07:00:00;NORTE;35;0;35;1
2019-10-16 07:30:00;NORTE;32;0;32;1
2019-10-16 08:00:00;NORTE;28;0;28;1
2019-10-16 08:30:00;NORTE;41;0;41;1
2019-10-16 09:00:00;NORTE;29;0;29;1
2019-10-16 09:30:00;NORTE;32;0;32;1
2019-10-16 10:00:00;NORTE;37;0;37;1
2019-10-16 10:30:00;NORTE;26;0;26;1
2019-10-16 11:00:00;NORTE;31;0;31;1
2019-10-16 11:30:00;NORTE;31;0;31;1
2019-10-16 12:00:00;NORTE;33;0;33;1
2019-10-16 12:30:00;NORTE;39;0;39;1
2019-10-16 13:00:00;NORTE;35;0;35;1
2019-10-16 13:30:00;CONFLICTIVA;13;17;30;2
2019-10-16 14:00:00;SUR;0;39;39;1
2019-10-16 14:30:00;SUR;0;39;39;1
2019-10-16 15:00:00;SUR;0;32;32;1
2019-10-16 15:30:00;SUR;0;25;25;1
2019-10-16 16:00:00;SUR;0;26;26;1
2019-10-16 16:30:00;SUR;0;29;29;1
2019-10-16 17:00:00;SUR;0;29;29;1
2019-10-16 17:30:00;SUR;0;27;27;1
2019-10-16 18:00:00;SUR;0;44;44;1
2019-10-16 18:30:00;CONFLICTIVA;4;23;27;2
2019-10-16 19:00:00;NORTE;38;0;38;1
2019-10-16 19:30:00;NORTE;40;0;40;1
2019-10-16 20:00:00;NORTE;35;0;35;1
2019-10-16 20:30:00;NORTE;31;0;31;1
2019-10-16 21:00:00;NORTE;16;0;16;1
2019-10-16 21:30:00;NORTE;17;0;17;1
2019-10-16 22:00:00;NORTE;11;0;11;1
2019-10-16 22:30:00;NORTE;3;0;3;1
2019-10-16 23:00:00;NORTE;2;0;2;1
2019-10-16 23:30:00;NORTE;1;0;1;1
2019-10-17 00:00:00;NORTE;3;0;3;1
2019-10-17 01:00:00;NORTE;3;0;3;1
2019-10-17 02:00:00;NORTE;4;0;4;1
2019-10-17 02:30:00;NORTE;4;0;4;1
2019-10-17 03:00:00;NORTE;6;0;6;1
2019-10-17 03:30:00;NORTE;10;0;10;1
2019-10-17 04:00:00;NORTE;15;0;15;1
2019-10-17 04:30:00;NORTE;14;0;14;1
2019-10-17 05:00:00;NORTE;16;0;16;1
2019-10-17 05:30:00;NORTE;45;0;45;1
2019-10-17 06:00:00;NORTE;22;0;22;1
2019-10-17 06:30:00;NORTE;31;0;31;1
2019-10-17 07:00:00;NORTE;31;0;31;1
2019-10-17 07:30:00;NORTE;36;0;36;1
2019-10-17 08:00:00;NORTE;40;0;40;1
2019-10-17 08:30:00;NORTE;40;0;40;1
2019-10-17 09:00:00;NORTE;30;0;30;1
2019-10-17 09:30:00;NORTE;39;0;39;1
2019-10-17 10:00:00;NORTE;33;0;33;1
2019-10-17 10:30:00;NORTE;35;0;35;1
2019-10-17 11:00:00;NORTE;40;0;40;1
2019-10-17 11:30:00;NORTE;31;0;31;1
2019-10-17 12:00:00;NORTE;31;0;31;1
2019-10-17 12:30:00;NORTE;35;0;35;1
2019-10-17 13:00:00;NORTE;43;0;43;1
2019-10-17 13:30:00;NORTE;34;0;34;1
2019-10-17 14:00:00;NORTE;41;0;41;1
2019-10-17 14:30:00;NORTE;36;0;36;1
2019-10-17 15:00:00;NORTE;33;0;33;1
2019-10-17 15:30:00;NORTE;26;0;26;1
2019-10-17 16:00:00;NORTE;24;0;24;1
2019-10-17 16:30:00;NORTE;36;0;36;1
2019-10-17 17:00:00;NORTE;24;0;24;1
2019-10-17 17:30:00;NORTE;31;0;31;1
2019-10-17 18:00:00;NORTE;37;0;37;1
2019-10-17 18:30:00;NORTE;32;0;32;1
2019-10-17 19:00:00;NORTE;32;0;32;1
2019-10-17 19:30:00;NORTE;36;0;36;1
2019-10-17 20:00:00;NORTE;40;0;40;1
2019-10-17 20:30:00;NORTE;28;0;28;1
2019-10-17 21:00:00;NORTE;16;0;16;1
2019-10-17 21:30:00;NORTE;21;0;21;1
2019-10-17 22:00:00;NORTE;15;0;15;1
2019-10-17 22:30:00;NORTE;2;0;2;1
2019-10-17 23:00:00;NORTE;4;0;4;1
2019-10-17 23:30:00;NORTE;3;0;3;1
2019-10-18 00:00:00;NORTE;1;0;1;1
2019-10-18 00:30:00;NORTE;1;0;1;1
2019-10-18 01:00:00;NORTE;2;0;2;1
2019-10-18 02:00:00;NORTE;5;0;5;1
2019-10-18 02:30:00;NORTE;3;0;3;1
2019-10-18 03:00:00;NORTE;5;0;5;1
2019-10-18 03:30:00;NORTE;8;0;8;1
2019-10-18 04:00:00;NORTE;15;0;15;1
2019-10-18 04:30:00;NORTE;15;0;15;1
2019-10-18 05:00:00;NORTE;24;0;24;1
2019-10-18 05:30:00;NORTE;39;0;39;1
2019-10-18 06:00:00;NORTE;23;0;23;1
2019-10-18 06:30:00;NORTE;20;0;20;1
2019-10-18 07:00:00;SUR;0;37;37;1
2019-10-18 07:30:00;SUR;0;37;37;1
2019-10-18 08:00:00;SUR;0;40;40;1
2019-10-18 08:30:00;SUR;0;45;45;1
2019-10-18 09:00:00;SUR;0;31;31;1
2019-10-18 09:30:00;SUR;0;34;34;1
2019-10-18 10:00:00;SUR;0;39;39;1
2019-10-18 10:30:00;SUR;0;37;37;1
2019-10-18 11:00:00;SUR;0;31;31;1
2019-10-18 11:30:00;SUR;0;29;29;1
2019-10-18 12:00:00;SUR;1;29;30;1
2019-10-18 12:30:00;SUR;0;37;37;1
2019-10-18 13:00:00;SUR;0;41;41;1
2019-10-18 13:30:00;SUR;0;36;36;1
2019-10-18 14:00:00;SUR;0;39;39;1
2019-10-18 14:30:00;SUR;0;41;41;1
2019-10-18 15:00:00;SUR;0;30;30;1
2019-10-18 15:30:00;SUR;0;30;30;1
2019-10-18 16:00:00;SUR;0;19;19;1
2019-10-18 16:30:00;SUR;0;33;33;1
2019-10-18 17:00:00;SUR;0;29;29;1
2019-10-18 17:30:00;SUR;0;29;29;1
2019-10-18 18:00:00;SUR;0;39;39;1
2019-10-18 18:30:00;SUR;0;30;30;1
2019-10-18 19:00:00;SUR;0;30;30;1
2019-10-18 19:30:00;SUR;0;29;29;1
2019-10-18 20:00:00;SUR;0;35;35;1
2019-10-18 20:30:00;SUR;0;29;29;1
2019-10-18 21:00:00;SUR;0;17;17;1
2019-10-18 21:30:00;SUR;0;21;21;1
2019-10-18 22:00:00;SUR;0;17;17;1
2019-10-18 22:30:00;SUR;0;5;5;1
2019-10-18 23:00:00;SUR;0;3;3;1
2019-10-18 23:30:00;SUR;0;2;2;1
2019-10-19 00:00:00;SUR;0;4;4;1
2019-10-19 00:30:00;SUR;0;1;1;1
2019-10-19 01:00:00;NORTE;1;0;1;1
2019-10-19 01:30:00;NORTE;3;0;3;1
2019-10-19 02:00:00;NORTE;6;0;6;1
2019-10-19 02:30:00;NORTE;4;0;4;1
2019-10-19 03:00:00;NORTE;2;0;2;1
2019-10-19 03:30:00;NORTE;6;0;6;1
2019-10-19 04:00:00;NORTE;7;0;7;1
2019-10-19 04:30:00;CONFLICTIVA;4;5;9;2
2019-10-19 05:00:00;SUR;0;25;25;1
2019-10-19 05:30:00;SUR;0;27;27;1
2019-10-19 06:00:00;SUR;0;28;28;1
2019-10-19 06:30:00;SUR;0;23;23;1
2019-10-19 07:00:00;SUR;0;40;40;1
2019-10-19 07:30:00;SUR;0;29;29;1
2019-10-19 08:00:00;SUR;0;35;35;1
2019-10-19 08:30:00;SUR;0;36;36;1
2019-10-19 09:00:00;SUR;0;35;35;1
2019-10-19 09:30:00;SUR;0;34;34;1
2019-10-19 10:00:00;SUR;0;40;40;1
2019-10-19 10:30:00;SUR;0;34;34;1
2019-10-19 11:00:00;SUR;0;35;35;1
2019-10-19 11:30:00;SUR;0;24;24;1
2019-10-19 12:00:00;SUR;0;24;24;1
2019-10-19 12:30:00;SUR;0;33;33;1
2019-10-19 13:00:00;SUR;0;39;39;1
2019-10-19 13:30:00;SUR;0;32;32;1
2019-10-19 14:00:00;SUR;0;30;30;1
2019-10-19 14:30:00;SUR;0;36;36;1
2019-10-19 15:00:00;SUR;0;29;29;1
2019-10-19 15:30:00;SUR;0;20;20;1
2019-10-19 16:00:00;SUR;0;25;25;1
2019-10-19 16:30:00;SUR;0;26;26;1
2019-10-19 17:00:00;SUR;0;25;25;1
2019-10-19 17:30:00;SUR;0;19;19;1
2019-10-19 18:00:00;SUR;0;34;34;1
2019-10-19 18:30:00;SUR;0;25;25;1
2019-10-19 19:00:00;SUR;0;28;28;1
2019-10-19 19:30:00;SUR;0;14;14;1
2019-10-19 19:43:00;SUR;0;10;10;1
2019-10-19 20:00:00;SUR;0;15;15;1
2019-10-19 20:21:00;SUR;0;8;8;1
2019-10-19 20:30:00;SUR;0;18;18;1
2019-10-19 21:00:00;SUR;0;11;11;1
2019-10-19 21:30:00;SUR;0;8;8;1
2019-10-19 22:00:00;SUR;0;14;14;1
2019-10-19 22:30:00;SUR;0;3;3;1
2019-10-19 23:00:00;SUR;0;5;5;1
2019-10-19 23:30:00;SUR;0;1;1;1
2019-10-20 00:00:00;SUR;0;2;2;1
2019-10-20 00:30:00;SUR;0;2;2;1
2019-10-20 01:00:00;SUR;0;2;2;1
2019-10-20 01:30:00;SUR;0;3;3;1
2019-10-20 02:00:00;SUR;0;1;1;1
2019-10-20 02:30:00;SUR;0;4;4;1
2019-10-20 03:00:00;SUR;0;3;3;1
2019-10-20 03:30:00;SUR;0;3;3;1
2019-10-20 04:00:00;SUR;0;8;8;1
2019-10-20 04:30:00;SUR;0;11;11;1
2019-10-20 05:00:00;SUR;0;18;18;1
2019-10-20 05:30:00;SUR;0;23;23;1
2019-10-20 06:00:00;SUR;0;19;19;1
2019-10-20 06:30:00;SUR;0;26;26;1
2019-10-20 07:00:00;SUR;0;36;36;1
2019-10-20 07:30:00;SUR;0;30;30;1
2019-10-20 08:00:00;SUR;0;36;36;1
2019-10-20 08:30:00;SUR;0;43;43;1
2019-10-20 09:00:00;SUR;0;23;23;1
2019-10-20 09:30:00;SUR;0;33;33;1
2019-10-20 10:00:00;SUR;0;35;35;1
2019-10-20 10:30:00;SUR;0;34;34;1
2019-10-20 11:00:00;SUR;0;30;30;1
2019-10-20 11:30:00;SUR;0;34;34;1
2019-10-20 12:00:00;SUR;0;28;28;1
2019-10-20 12:30:00;SUR;0;29;29;1
2019-10-20 13:00:00;NORTE;39;1;40;1
2019-10-20 13:30:00;NORTE;39;0;39;1
2019-10-20 14:00:00;NORTE;35;0;35;1
2019-10-20 14:30:00;NORTE;38;0;38;1
2019-10-20 15:00:00;NORTE;33;0;33;1
2019-10-20 15:30:00;NORTE;31;0;31;1
2019-10-20 16:00:00;NORTE;19;0;19;1
2019-10-20 16:30:00;NORTE;25;0;25;1
2019-10-20 17:00:00;NORTE;28;0;28;1
2019-10-20 17:30:00;NORTE;22;0;22;1
2019-10-20 18:00:00;NORTE;37;0;37;1
2019-10-20 18:30:00;NORTE;41;0;41;1
2019-10-20 19:00:00;NORTE;27;0;27;1
2019-10-20 19:30:00;NORTE;33;0;33;1
2019-10-20 20:00:00;NORTE;41;0;41;1
2019-10-20 20:30:00;NORTE;32;0;32;1
2019-10-20 21:00:00;NORTE;22;0;22;1
2019-10-20 21:30:00;NORTE;17;0;17;1
2019-10-20 22:00:00;NORTE;18;0;18;1
2019-10-20 22:30:00;NORTE;7;0;7;1
2019-10-20 23:00:00;NORTE;4;0;4;1
2019-10-20 23:30:00;NORTE;3;0;3;1
2019-10-21 00:00:00;NORTE;2;0;2;1
2019-10-21 00:30:00;NORTE;1;0;1;1
2019-10-21 01:30:00;NORTE;1;0;1;1
2019-10-21 02:00:00;NORTE;5;0;5;1
2019-10-21 02:30:00;NORTE;5;0;5;1
2019-10-21 03:00:00;NORTE;2;0;2;1
2019-10-21 03:30:00;NORTE;4;0;4;1
2019-10-21 04:00:00;NORTE;9;0;9;1
2019-10-21 04:30:00;NORTE;12;0;12;1
2019-10-21 05:00:00;NORTE;22;0;22;1
2019-10-21 05:30:00;NORTE;45;0;45;1
2019-10-21 06:00:00;NORTE;26;0;26;1
2019-10-21 06:30:00;NORTE;28;0;28;1
2019-10-21 07:00:00;NORTE;42;0;42;1
2019-10-21 07:30:00;NORTE;36;0;36;1
2019-10-21 08:00:00;NORTE;38;0;38;1
2019-10-21 08:30:00;NORTE;47;0;47;1
2019-10-21 09:00:00;NORTE;31;0;31;1
2019-10-21 09:30:00;NORTE;33;0;33;1
2019-10-21 10:00:00;NORTE;39;0;39;1
2019-10-21 10:30:00;NORTE;33;0;33;1
2019-10-21 11:00:00;NORTE;41;0;41;1
2019-10-21 11:30:00;NORTE;30;0;30;1
2019-10-21 12:00:00;NORTE;25;0;25;1
2019-10-21 12:30:00;NORTE;36;0;36;1
2019-10-21 13:00:00;NORTE;42;0;42;1
2019-10-21 13:30:00;NORTE;47;0;47;1
2019-10-21 14:00:00;NORTE;39;0;39;1
2019-10-21 14:30:00;NORTE;36;0;36;1
2019-10-21 15:00:00;NORTE;33;0;33;1
2019-10-21 15:30:00;NORTE;22;0;22;1
2019-10-21 16:00:00;NORTE;26;0;26;1
2019-10-21 16:30:00;NORTE;38;0;38;1
2019-10-21 17:00:00;NORTE;24;0;24;1
2019-10-21 17:30:00;NORTE;25;0;25;1
2019-10-21 18:00:00;NORTE;39;0;39;1
2019-10-21 18:30:00;NORTE;39;0;39;1
2019-10-21 19:00:00;NORTE;34;0;34;1
2019-10-21 19:30:00;NORTE;31;0;31;1
2019-10-21 20:00:00;NORTE;35;0;35;1
2019-10-21 20:30:00;NORTE;24;0;24;1
2019-10-21 21:00:00;NORTE;15;0;15;1
2019-10-21 21:30:00;NORTE;14;0;14;1
2019-10-21 22:00:00;NORTE;20;0;20;1
2019-10-21 22:30:00;NORTE;4;0;4;1
2019-10-21 23:00:00;NORTE;1;0;1;1
2019-10-21 23:30:00;NORTE;3;0;3;1
2019-10-22 00:00:00;NORTE;1;0;1;1
2019-10-22 01:00:00;NORTE;1;0;1;1
2019-10-22 01:30:00;NORTE;2;0;2;1
2019-10-22 02:00:00;NORTE;4;0;4;1
2019-10-22 02:30:00;NORTE;7;0;7;1
2019-10-22 03:00:00;NORTE;3;0;3;1
2019-10-22 03:30:00;NORTE;8;0;8;1
2019-10-22 04:00:00;NORTE;12;0;12;1
2019-10-22 04:30:00;NORTE;17;0;17;1
2019-10-22 05:00:00;NORTE;23;0;23;1
2019-10-22 05:30:00;NORTE;39;0;39;1
2019-10-22 06:00:00;NORTE;20;0;20;1
2019-10-22 06:30:00;NORTE;23;0;23;1
2019-10-22 07:00:00;NORTE;42;0;42;1
2019-10-22 07:30:00;NORTE;39;0;39;1
2019-10-22 08:00:00;NORTE;34;0;34;1
2019-10-22 08:30:00;NORTE;35;0;35;1
2019-10-22 09:00:00;NORTE;28;0;28;1
2019-10-22 09:30:00;NORTE;35;1;36;1
2019-10-22 10:00:00;NORTE;42;0;42;1
2019-10-22 10:30:00;NORTE;35;0;35;1
2019-10-22 11:00:00;NORTE;35;0;35;1
2019-10-22 11:30:00;NORTE;30;0;30;1
2019-10-22 12:00:00;NORTE;24;0;24;1
2019-10-22 12:30:00;NORTE;42;0;42;1
2019-10-22 13:00:00;NORTE;42;0;42;1
2019-10-22 13:30:00;NORTE;27;0;27;1
2019-10-22 14:00:00;NORTE;44;0;44;1
2019-10-22 14:30:00;NORTE;35;0;35;1
2019-10-22 15:00:00;NORTE;30;0;30;1
2019-10-22 15:30:00;NORTE;26;0;26;1
2019-10-22 16:00:00;NORTE;27;0;27;1
2019-10-22 16:30:00;NORTE;33;0;33;1
2019-10-22 17:00:00;NORTE;31;0;31;1
2019-10-22 17:30:00;NORTE;31;0;31;1
2019-10-22 18:00:00;NORTE;31;0;31;1
2019-10-22 18:30:00;NORTE;34;0;34;1
2019-10-22 19:00:00;NORTE;30;0;30;1
2019-10-22 19:30:00;NORTE;30;1;31;1
2019-10-22 20:00:00;NORTE;33;0;33;1
2019-10-22 20:30:00;NORTE;31;0;31;1
2019-10-22 21:00:00;NORTE;17;0;17;1
2019-10-22 21:30:00;NORTE;16;0;16;1
2019-10-22 22:00:00;NORTE;10;0;10;1
2019-10-22 22:30:00;NORTE;13;0;13;1
2019-10-22 23:00:00;NORTE;6;0;6;1
2019-10-22 23:30:00;NORTE;1;0;1;1
2019-10-23 00:00:00;NORTE;1;0;1;1
2019-10-23 00:30:00;NORTE;1;0;1;1
2019-10-23 01:00:00;NORTE;4;0;4;1
2019-10-23 01:30:00;NORTE;3;0;3;1
2019-10-23 02:00:00;NORTE;3;0;3;1
2019-10-23 02:30:00;NORTE;2;0;2;1
2019-10-23 03:00:00;NORTE;7;0;7;1
2019-10-23 03:30:00;NORTE;8;0;8;1
2019-10-23 04:00:00;NORTE;12;0;12;1
2019-10-23 04:30:00;NORTE;10;0;10;1
2019-10-23 05:00:00;NORTE;22;0;22;1
2019-10-23 05:30:00;NORTE;48;0;48;1
2019-10-23 06:00:00;NORTE;23;0;23;1
2019-10-23 06:30:00;NORTE;25;0;25;1
2019-10-23 07:00:00;NORTE;39;0;39;1
2019-10-23 07:30:00;NORTE;31;0;31;1
2019-10-23 08:00:00;NORTE;40;0;40;1
2019-10-23 08:30:00;NORTE;38;0;38;1
2019-10-23 09:00:00;NORTE;23;0;23;1
2019-10-23 09:30:00;NORTE;34;0;34;1
2019-10-23 10:00:00;NORTE;41;0;41;1
2019-10-23 10:30:00;NORTE;32;0;32;1
2019-10-23 11:00:00;NORTE;36;1;37;1
2019-10-23 11:30:00;NORTE;33;0;33;1
2019-10-23 12:00:00;NORTE;25;0;25;1
2019-10-23 12:30:00;NORTE;33;0;33;1
2019-10-23 13:00:00;NORTE;38;0;38;1
2019-10-23 13:30:00;NORTE;40;0;40;1
2019-10-23 14:00:00;NORTE;37;0;37;1
2019-10-23 14:30:00;NORTE;40;0;40;1
2019-10-23 15:00:00;NORTE;21;0;21;1
2019-10-23 15:30:00;NORTE;18;0;18;1
2019-10-23 16:00:00;NORTE;27;0;27;1
2019-10-23 16:30:00;NORTE;34;0;34;1
2019-10-23 17:00:00;NORTE;30;0;30;1
2019-10-23 17:30:00;NORTE;25;0;25;1
2019-10-23 18:00:00;NORTE;40;0;40;1
2019-10-23 18:30:00;NORTE;34;0;34;1
2019-10-23 19:00:00;NORTE;31;0;31;1
2019-10-23 19:30:00;NORTE;36;0;36;1
2019-10-23 20:00:00;NORTE;38;0;38;1
2019-10-23 20:30:00;NORTE;25;0;25;1
2019-10-23 21:00:00;NORTE;20;0;20;1
2019-10-23 21:30:00;NORTE;14;0;14;1
2019-10-23 22:00:00;NORTE;15;0;15;1
2019-10-23 22:30:00;NORTE;3;0;3;1
2019-10-23 23:00:00;NORTE;3;0;3;1
2019-10-24 00:00:00;NORTE;1;0;1;1
2019-10-24 00:30:00;NORTE;2;0;2;1
2019-10-24 01:00:00;NORTE;1;0;1;1
2019-10-24 01:30:00;NORTE;1;0;1;1
2019-10-24 02:00:00;NORTE;3;0;3;1
2019-10-24 02:30:00;NORTE;3;0;3;1
2019-10-24 02:50:00;NORTE;1;0;1;1
2019-10-24 03:12:00;NORTE;1;0;1;1
2019-10-24 03:20:00;NORTE;4;0;4;1
2019-10-24 03:30:00;NORTE;7;0;7;1
2019-10-24 04:00:00;NORTE;12;0;12;1
2019-10-24 04:30:00;NORTE;13;0;13;1
2019-10-24 05:00:00;NORTE;25;0;25;1
2019-10-24 05:30:00;NORTE;41;0;41;1
2019-10-24 06:00:00;NORTE;25;0;25;1
2019-10-24 06:30:00;NORTE;26;0;26;1
2019-10-24 07:00:00;NORTE;38;0;38;1
2019-10-24 07:30:00;NORTE;28;0;28;1
2019-10-24 08:00:00;NORTE;34;0;34;1
2019-10-24 08:30:00;NORTE;38;0;38;1
2019-10-24 09:00:00;NORTE;32;0;32;1
2019-10-24 09:30:00;NORTE;37;0;37;1
2019-10-24 10:00:00;NORTE;37;0;37;1
2019-10-24 10:30:00;NORTE;39;0;39;1
2019-10-24 11:00:00;NORTE;40;0;40;1
2019-10-24 11:30:00;NORTE;29;0;29;1
2019-10-24 12:00:00;NORTE;29;0;29;1
2019-10-24 12:30:00;NORTE;35;0;35;1
2019-10-24 13:00:00;NORTE;45;0;45;1
2019-10-24 13:30:00;NORTE;31;0;31;1
2019-10-24 14:00:00;NORTE;38;0;38;1
2019-10-24 14:30:00;NORTE;42;0;42;1
2019-10-24 15:00:00;NORTE;33;0;33;1
2019-10-24 15:30:00;NORTE;22;0;22;1
2019-10-24 16:00:00;NORTE;26;0;26;1
2019-10-24 16:30:00;NORTE;34;0;34;1
2019-10-24 17:00:00;NORTE;29;0;29;1
2019-10-24 17:30:00;NORTE;29;0;29;1
2019-10-24 18:00:00;NORTE;43;0;43;1
2019-10-24 18:30:00;NORTE;36;0;36;1
2019-10-24 19:00:00;NORTE;21;0;21;1
2019-10-24 19:30:00;NORTE;36;0;36;1
2019-10-24 20:00:00;NORTE;35;0;35;1
2019-10-24 20:30:00;NORTE;28;0;28;1
2019-10-24 21:00:00;NORTE;14;0;14;1
2019-10-24 21:30:00;NORTE;19;0;19;1
2019-10-24 22:00:00;NORTE;13;0;13;1
2019-10-24 22:30:00;NORTE;3;0;3;1
2019-10-24 23:00:00;NORTE;1;0;1;1
2019-10-24 23:30:00;NORTE;2;0;2;1
2019-10-25 00:00:00;NORTE;1;0;1;1
2019-10-25 00:30:00;NORTE;2;0;2;1
2019-10-25 01:00:00;NORTE;2;0;2;1
2019-10-25 02:00:00;NORTE;2;0;2;1
2019-10-25 02:30:00;NORTE;5;0;5;1
2019-10-25 03:00:00;NORTE;6;0;6;1
2019-10-25 03:30:00;NORTE;8;0;8;1
2019-10-25 04:00:00;NORTE;10;0;10;1
2019-10-25 04:30:00;NORTE;13;0;13;1
2019-10-25 05:00:00;NORTE;27;0;27;1
2019-10-25 05:30:00;NORTE;41;0;41;1
2019-10-25 06:00:00;NORTE;20;0;20;1
2019-10-25 06:30:00;NORTE;29;0;29;1
2019-10-25 07:00:00;NORTE;34;0;34;1
2019-10-25 07:30:00;NORTE;36;0;36;1
2019-10-25 08:00:00;NORTE;36;0;36;1
2019-10-25 08:30:00;NORTE;45;0;45;1
2019-10-25 09:00:00;NORTE;21;0;21;1
2019-10-25 09:30:00;NORTE;31;0;31;1
2019-10-25 10:00:00;NORTE;43;0;43;1
2019-10-25 10:30:00;NORTE;35;0;35;1
2019-10-25 11:00:00;NORTE;36;0;36;1
2019-10-25 11:30:00;NORTE;26;0;26;1
2019-10-25 12:00:00;NORTE;28;0;28;1
2019-10-25 12:30:00;NORTE;42;0;42;1
2019-10-25 13:00:00;NORTE;35;0;35;1
2019-10-25 13:30:00;NORTE;43;0;43;1
2019-10-25 14:00:00;NORTE;45;0;45;1
2019-10-25 14:30:00;NORTE;33;0;33;1
2019-10-25 15:00:00;NORTE;35;0;35;1
2019-10-25 15:30:00;NORTE;24;0;24;1
2019-10-25 16:00:00;NORTE;25;0;25;1
2019-10-25 16:30:00;NORTE;33;0;33;1
2019-10-25 17:00:00;NORTE;24;0;24;1
2019-10-25 17:30:00;NORTE;29;0;29;1
2019-10-25 18:00:00;NORTE;34;0;34;1
2019-10-25 18:30:00;NORTE;24;0;24;1
2019-10-25 19:00:00;NORTE;38;0;38;1
2019-10-25 19:30:00;NORTE;30;0;30;1
2019-10-25 20:00:00;NORTE;34;0;34;1
2019-10-25 20:30:00;NORTE;28;0;28;1
2019-10-25 21:00:00;NORTE;18;0;18;1
2019-10-25 21:30:00;NORTE;16;0;16;1
2019-10-25 22:00:00;NORTE;12;0;12;1
2019-10-25 22:30:00;NORTE;5;0;5;1
2019-10-25 23:00:00;NORTE;1;0;1;1
2019-10-25 23:30:00;NORTE;2;0;2;1
2019-10-26 00:30:00;NORTE;4;0;4;1
2019-10-26 01:00:00;NORTE;1;0;1;1
2019-10-26 01:30:00;NORTE;2;0;2;1
2019-10-26 02:00:00;NORTE;4;0;4;1
2019-10-26 02:30:00;NORTE;4;0;4;1
2019-10-26 03:00:00;NORTE;3;0;3;1
2019-10-26 03:30:00;NORTE;6;0;6;1
2019-10-26 04:00:00;NORTE;9;0;9;1
2019-10-26 04:30:00;NORTE;14;0;14;1
2019-10-26 05:00:00;NORTE;25;0;25;1
2019-10-26 05:30:00;NORTE;29;0;29;1
2019-10-26 06:00:00;NORTE;18;0;18;1
2019-10-26 06:30:00;NORTE;23;0;23;1
2019-10-26 07:00:00;NORTE;37;0;37;1
2019-10-26 07:30:00;NORTE;31;0;31;1
2019-10-26 08:00:00;NORTE;37;0;37;1
2019-10-26 08:30:00;NORTE;36;0;36;1
2019-10-26 09:00:00;NORTE;32;0;32;1
2019-10-26 09:30:00;NORTE;31;1;32;1
2019-10-26 10:00:00;NORTE;40;0;40;1
2019-10-26 10:30:00;NORTE;35;0;35;1
2019-10-26 11:00:00;NORTE;29;0;29;1
2019-10-26 11:30:00;NORTE;24;0;24;1
2019-10-26 12:00:00;NORTE;32;0;32;1
2019-10-26 12:30:00;NORTE;33;0;33;1
2019-10-26 13:00:00;NORTE;36;0;36;1
2019-10-26 13:30:00;NORTE;30;0;30;1
2019-10-26 14:00:00;NORTE;36;0;36;1
2019-10-26 14:30:00;NORTE;24;0;24;1
2019-10-26 15:00:00;NORTE;29;0;29;1
2019-10-26 15:30:00;NORTE;24;0;24;1
2019-10-26 16:00:00;NORTE;22;0;22;1
2019-10-26 16:30:00;NORTE;34;0;34;1
2019-10-26 17:00:00;NORTE;20;0;20;1
2019-10-26 17:30:00;NORTE;19;0;19;1
2019-10-26 18:00:00;NORTE;31;0;31;1
2019-10-26 18:30:00;NORTE;31;0;31;1
2019-10-26 19:00:00;NORTE;23;0;23;1
2019-10-26 19:30:00;NORTE;29;0;29;1
2019-10-26 20:00:00;NORTE;16;0;16;1
2019-10-26 20:30:00;NORTE;17;0;17;1
2019-10-26 21:00:00;CONFLICTIVA;7;1;8;2
2019-10-26 21:30:00;NORTE;11;0;11;1
2019-10-26 22:00:00;NORTE;13;0;13;1
2019-10-26 22:30:00;NORTE;4;0;4;1
2019-10-26 23:10:52;NORTE;1;0;1;1
2019-10-26 23:14:48;NORTE;1;0;1;1
2019-10-26 23:18:34;NORTE;1;0;1;1
2019-10-26 23:20:37;NORTE;1;0;1;1
2019-10-26 23:29:39;NORTE;1;0;1;1
2019-10-26 23:30:00;NORTE;1;0;1;1
2019-10-27 01:00:00;NORTE;1;0;1;1
2019-10-27 01:30:00;NORTE;3;0;3;1
2019-10-27 02:00:00;NORTE;2;0;2;1
2019-10-27 03:00:00;NORTE;6;0;6;1
2019-10-27 03:30:00;NORTE;9;0;9;1
2019-10-27 04:00:00;NORTE;3;0;3;1
2019-10-27 04:30:00;NORTE;2;0;2;1
2019-10-27 05:00:00;NORTE;7;0;7;1
2019-10-27 05:30:00;NORTE;13;0;13;1
2019-10-27 06:00:00;NORTE;18;0;18;1
2019-10-27 06:30:00;NORTE;25;0;25;1
2019-10-27 07:00:00;NORTE;21;0;21;1
2019-10-27 07:30:00;NORTE;25;0;25;1
2019-10-27 08:00:00;NORTE;31;0;31;1
2019-10-27 08:30:00;NORTE;32;0;32;1
2019-10-27 09:00:00;NORTE;36;0;36;1
2019-10-27 09:30:00;NORTE;33;0;33;1
2019-10-27 10:00:00;NORTE;25;0;25;1
2019-10-27 10:30:00;NORTE;37;0;37;1
2019-10-27 11:00:00;NORTE;42;0;42;1
2019-10-27 11:30:00;NORTE;36;0;36;1
2019-10-27 12:00:00;NORTE;33;0;33;1
2019-10-27 12:30:00;NORTE;35;0;35;1
2019-10-27 13:00:00;NORTE;33;0;33;1
2019-10-27 13:30:00;NORTE;31;0;31;1
2019-10-27 14:00:00;NORTE;37;0;37;1
2019-10-27 14:30:00;NORTE;37;0;37;1
2019-10-27 15:00:00;NORTE;31;0;31;1
2019-10-27 15:30:00;NORTE;36;0;36;1
2019-10-27 16:00:00;NORTE;26;0;26;1
2019-10-27 16:30:00;NORTE;24;0;24;1
2019-10-27 17:00:00;NORTE;19;0;19;1
2019-10-27 17:30:00;NORTE;37;0;37;1
2019-10-27 18:00:00;NORTE;27;0;27;1
2019-10-27 18:30:00;NORTE;29;0;29;1
2019-10-27 19:00:00;NORTE;40;0;40;1
2019-10-27 19:30:00;NORTE;33;0;33;1
2019-10-27 20:00:00;NORTE;30;0;30;1
2019-10-27 20:30:00;NORTE;35;0;35;1
2019-10-27 21:00:00;NORTE;28;0;28;1
2019-10-27 21:30:00;NORTE;32;0;32;1
2019-10-27 22:00:00;NORTE;15;0;15;1
2019-10-27 22:30:00;NORTE;11;0;11;1
2019-10-27 23:00:00;NORTE;16;0;16;1
2019-10-27 23:30:00;NORTE;4;0;4;1
2019-10-28 00:00:00;NORTE;1;0;1;1
2019-10-28 00:30:00;NORTE;2;0;2;1
2019-10-28 01:00:00;NORTE;1;0;1;1
2019-10-28 01:30:00;NORTE;1;0;1;1
2019-10-28 02:00:00;NORTE;2;0;2;1
2019-10-28 02:30:00;NORTE;2;0;2;1
2019-10-28 03:00:00;NORTE;5;0;5;1
2019-10-28 03:30:00;NORTE;5;0;5;1
2019-10-28 04:00:00;NORTE;1;0;1;1
2019-10-28 04:30:00;NORTE;5;0;5;1
2019-10-28 05:00:00;NORTE;9;0;9;1
2019-10-28 05:30:00;NORTE;19;0;19;1
2019-10-28 06:00:00;NORTE;30;0;30;1
2019-10-28 06:30:00;NORTE;41;0;41;1
2019-10-28 07:00:00;NORTE;23;0;23;1
2019-10-28 07:30:00;NORTE;25;0;25;1
2019-10-28 08:00:00;NORTE;33;0;33;1
2019-10-28 08:30:00;NORTE;34;0;34;1
2019-10-28 09:00:00;NORTE;35;0;35;1
2019-10-28 09:30:00;NORTE;40;0;40;1
2019-10-28 10:00:00;NORTE;31;0;31;1
2019-10-28 10:30:00;NORTE;37;0;37;1
2019-10-28 11:00:00;NORTE;43;0;43;1
2019-10-28 11:30:00;NORTE;33;0;33;1
2019-10-28 12:00:00;NORTE;34;0;34;1
2019-10-28 12:30:00;NORTE;31;0;31;1
2019-10-28 13:00:00;NORTE;26;0;26;1
2019-10-28 13:30:00;NORTE;30;0;30;1
2019-10-28 14:00:00;NORTE;39;0;39;1
2019-10-28 14:30:00;NORTE;35;0;35;1
2019-10-28 15:00:00;NORTE;37;0;37;1
2019-10-28 15:30:00;NORTE;32;0;32;1
2019-10-28 16:00:00;NORTE;33;0;33;1
2019-10-28 16:30:00;NORTE;17;0;17;1
2019-10-28 17:00:00;NORTE;24;0;24;1
2019-10-28 17:30:00;NORTE;32;0;32;1
2019-10-28 18:00:00;NORTE;28;0;28;1
2019-10-28 18:30:00;NORTE;27;0;27;1
2019-10-28 19:00:00;NORTE;38;0;38;1
2019-10-28 19:30:00;NORTE;37;0;37;1
2019-10-28 20:00:00;NORTE;26;0;26;1
2019-10-28 20:30:00;NORTE;32;0;32;1
2019-10-28 21:00:00;NORTE;33;0;33;1
2019-10-28 21:30:00;NORTE;21;0;21;1
2019-10-28 22:00:00;NORTE;15;0;15;1
2019-10-28 22:30:00;NORTE;7;0;7;1
2019-10-28 23:00:00;NORTE;13;0;13;1
2019-10-28 23:30:00;NORTE;1;0;1;1
2019-10-29 00:00:00;NORTE;3;0;3;1
2019-10-29 00:30:00;NORTE;1;0;1;1
2019-10-29 01:30:00;NORTE;1;0;1;1
2019-10-29 02:00:00;NORTE;1;0;1;1
2019-10-29 02:30:00;NORTE;2;0;2;1
2019-10-29 03:00:00;NORTE;5;0;5;1
2019-10-29 03:30:00;NORTE;2;0;2;1
2019-10-29 04:00:00;NORTE;6;0;6;1
2019-10-29 04:30:00;NORTE;11;0;11;1
2019-10-29 05:00:00;NORTE;11;0;11;1
2019-10-29 05:30:00;NORTE;16;0;16;1
2019-10-29 06:00:00;NORTE;30;0;30;1
2019-10-29 06:30:00;NORTE;36;0;36;1
2019-10-29 07:00:00;NORTE;30;0;30;1
2019-10-29 07:30:00;NORTE;24;0;24;1
2019-10-29 08:00:00;NORTE;36;0;36;1
2019-10-29 08:30:00;NORTE;30;0;30;1
2019-10-29 09:00:00;NORTE;36;0;36;1
2019-10-29 09:30:00;NORTE;41;0;41;1
2019-10-29 10:00:00;NORTE;28;0;28;1
2019-10-29 10:30:00;NORTE;33;0;33;1
2019-10-29 11:00:00;NORTE;39;0;39;1
2019-10-29 11:30:00;NORTE;37;0;37;1
2019-10-29 12:00:00;NORTE;31;0;31;1
2019-10-29 12:30:00;NORTE;29;0;29;1
2019-10-29 13:00:00;NORTE;26;0;26;1
2019-10-29 13:30:00;NORTE;38;0;38;1
2019-10-29 14:00:00;NORTE;39;0;39;1
2019-10-29 14:30:00;NORTE;34;0;34;1
2019-10-29 15:00:00;NORTE;40;0;40;1
2019-10-29 15:30:00;NORTE;35;0;35;1
2019-10-29 16:00:00;NORTE;34;0;34;1
2019-10-29 16:30:00;NORTE;22;0;22;1
2019-10-29 17:00:00;NORTE;21;0;21;1
2019-10-29 17:30:00;NORTE;28;0;28;1
2019-10-29 18:00:00;NORTE;25;0;25;1
2019-10-29 18:30:00;NORTE;29;0;29;1
2019-10-29 19:00:00;NORTE;39;0;39;1
2019-10-29 19:30:00;NORTE;23;0;23;1
2019-10-29 20:00:00;NORTE;26;0;26;1
2019-10-29 20:30:00;NORTE;29;0;29;1
2019-10-29 21:00:00;NORTE;33;0;33;1
2019-10-29 21:30:00;NORTE;25;0;25;1
2019-10-29 22:00:00;NORTE;16;0;16;1
2019-10-29 22:30:00;NORTE;7;0;7;1
2019-10-29 23:00:00;NORTE;11;0;11;1
2019-10-29 23:30:00;NORTE;6;0;6;1
2019-10-30 00:00:00;NORTE;1;0;1;1
2019-10-30 00:30:00;NORTE;2;0;2;1
2019-10-30 01:00:00;NORTE;1;0;1;1
2019-10-30 02:00:00;NORTE;1;0;1;1
2019-10-30 02:30:00;NORTE;1;0;1;1
2019-10-30 03:00:00;NORTE;2;0;2;1
2019-10-30 03:30:00;NORTE;4;0;4;1
2019-10-30 04:00:00;NORTE;6;0;6;1
2019-10-30 04:30:00;NORTE;8;0;8;1
2019-10-30 05:00:00;NORTE;13;0;13;1
2019-10-30 05:30:00;NORTE;17;0;17;1
2019-10-30 06:00:00;NORTE;25;0;25;1
2019-10-30 06:30:00;NORTE;37;0;37;1
2019-10-30 07:00:00;NORTE;32;0;32;1
2019-10-30 07:30:00;NORTE;24;0;24;1
2019-10-30 08:00:00;NORTE;38;0;38;1
2019-10-30 08:30:00;NORTE;34;0;34;1
2019-10-30 09:00:00;NORTE;37;0;37;1
2019-10-30 09:30:00;NORTE;31;0;31;1
2019-10-30 10:00:00;NORTE;25;0;25;1
2019-10-30 10:30:00;NORTE;39;0;39;1
2019-10-30 11:00:00;NORTE;43;0;43;1
2019-10-30 11:30:00;NORTE;28;0;28;1
2019-10-30 12:00:00;NORTE;30;0;30;1
2019-10-30 12:30:00;NORTE;30;0;30;1
2019-10-30 13:00:00;NORTE;27;0;27;1
2019-10-30 13:30:00;NORTE;40;0;40;1
2019-10-30 14:00:00;NORTE;38;0;38;1
2019-10-30 14:30:00;NORTE;36;0;36;1
2019-10-30 15:00:00;NORTE;37;0;37;1
2019-10-30 15:30:00;NORTE;33;0;33;1
2019-10-30 16:00:00;NORTE;32;0;32;1
2019-10-30 16:30:00;NORTE;16;0;16;1
2019-10-30 17:00:00;NORTE;28;0;28;1
2019-10-30 17:30:00;NORTE;35;0;35;1
2019-10-30 18:00:00;NORTE;21;0;21;1
2019-10-30 18:30:00;NORTE;30;0;30;1
2019-10-30 19:00:00;NORTE;38;0;38;1
2019-10-30 19:30:00;NORTE;32;0;32;1
2019-10-30 20:00:00;NORTE;31;0;31;1
2019-10-30 20:30:00;NORTE;33;0;33;1
2019-10-30 21:00:00;NORTE;32;0;32;1
2019-10-30 21:30:00;NORTE;29;0;29;1
2019-10-30 22:00:00;NORTE;15;0;15;1
2019-10-30 22:30:00;NORTE;11;0;11;1
2019-10-30 23:00:00;NORTE;13;0;13;1
2019-10-30 23:30:00;NORTE;5;0;5;1
2019-10-31 00:00:00;NORTE;2;0;2;1
2019-10-31 00:30:00;NORTE;1;0;1;1
2019-10-31 01:00:00;NORTE;2;0;2;1
2019-10-31 01:30:00;NORTE;2;0;2;1
2019-10-31 02:00:00;NORTE;1;0;1;1
2019-10-31 02:30:00;NORTE;2;0;2;1
2019-10-31 03:00:00;NORTE;3;0;3;1
2019-10-31 03:30:00;NORTE;4;0;4;1
2019-10-31 04:00:00;NORTE;6;0;6;1
2019-10-31 04:30:00;NORTE;9;0;9;1
2019-10-31 05:00:00;NORTE;13;0;13;1
2019-10-31 05:30:00;NORTE;15;0;15;1
2019-10-31 06:00:00;NORTE;28;0;28;1
2019-10-31 06:30:00;NORTE;39;0;39;1
2019-10-31 07:00:00;NORTE;25;1;26;1
2019-10-31 07:30:00;NORTE;23;0;23;1
2019-10-31 08:00:00;NORTE;36;0;36;1
2019-10-31 08:30:00;NORTE;37;0;37;1
2019-10-31 09:00:00;NORTE;40;0;40;1
2019-10-31 09:30:00;NORTE;34;0;34;1
2019-10-31 10:00:00;NORTE;27;0;27;1
2019-10-31 10:30:00;NORTE;35;0;35;1
2019-10-31 11:00:00;NORTE;41;0;41;1
2019-10-31 11:30:00;NORTE;35;0;35;1
2019-10-31 12:00:00;NORTE;35;0;35;1
2019-10-31 12:30:00;NORTE;34;0;34;1
2019-10-31 13:00:00;NORTE;31;0;31;1
2019-10-31 13:30:00;NORTE;35;0;35;1
2019-10-31 14:00:00;NORTE;40;0;40;1
2019-10-31 14:30:00;NORTE;33;0;33;1
2019-10-31 15:00:00;NORTE;42;0;42;1
2019-10-31 15:30:00;NORTE;35;0;35;1
2019-10-31 16:00:00;NORTE;26;0;26;1
2019-10-31 16:30:00;NORTE;23;0;23;1
2019-10-31 17:00:00;NORTE;24;0;24;1
2019-10-31 17:30:00;NORTE;34;0;34;1
2019-10-31 18:00:00;NORTE;27;0;27;1
2019-10-31 18:30:00;NORTE;34;0;34;1
2019-10-31 19:00:00;NORTE;41;0;41;1
2019-10-31 19:30:00;NORTE;36;0;36;1
2019-10-31 20:00:00;NORTE;31;0;31;1
2019-10-31 20:30:00;NORTE;32;0;32;1
2019-10-31 21:00:00;NORTE;29;0;29;1
2019-10-31 21:30:00;NORTE;30;0;30;1
2019-10-31 22:00:00;NORTE;14;0;14;1
2019-10-31 22:30:00;NORTE;9;0;9;1
2019-10-31 23:00:00;NORTE;16;0;16;1
2019-10-31 23:30:00;NORTE;3;0;3;1
2019-11-01 00:00:00;NORTE;4;0;4;1
2019-11-01 01:00:00;NORTE;1;0;1;1
2019-11-01 01:30:00;NORTE;1;0;1;1
2019-11-01 02:00:00;NORTE;2;0;2;1
2019-11-01 02:30:00;NORTE;1;0;1;1
2019-11-01 03:00:00;NORTE;2;0;2;1
2019-11-01 03:30:00;NORTE;5;0;5;1
2019-11-01 04:00:00;NORTE;10;0;10;1
2019-11-01 04:30:00;NORTE;7;0;7;1
2019-11-01 05:00:00;NORTE;10;0;10;1
2019-11-01 05:30:00;SUR;0;14;14;1
2019-11-01 06:00:00;SUR;0;24;24;1
2019-11-01 06:30:00;SUR;0;28;28;1
2019-11-01 07:00:00;SUR;0;23;23;1
2019-11-01 07:30:00;SUR;0;26;26;1
2019-11-01 08:00:00;SUR;0;37;37;1
2019-11-01 08:30:00;SUR;0;33;33;1
2019-11-01 09:00:00;SUR;0;36;36;1
2019-11-01 09:30:00;SUR;0;33;33;1
2019-11-01 10:00:00;SUR;0;27;27;1
2019-11-01 10:30:00;SUR;0;39;39;1
2019-11-01 11:00:00;SUR;0;35;35;1
2019-11-01 11:30:00;SUR;0;31;31;1
2019-11-01 12:00:00;SUR;0;33;33;1
2019-11-01 12:30:00;SUR;0;30;30;1
2019-11-01 13:00:00;SUR;0;33;33;1
2019-11-01 13:30:00;SUR;0;30;30;1
2019-11-01 14:00:00;SUR;0;41;41;1
2019-11-01 14:30:00;SUR;0;32;32;1
2019-11-01 15:00:00;SUR;0;37;37;1
2019-11-01 15:30:00;SUR;0;39;39;1
2019-11-01 16:00:00;SUR;0;27;27;1
2019-11-01 16:30:00;SUR;0;18;18;1
2019-11-01 17:00:00;SUR;0;22;22;1
2019-11-01 17:30:00;SUR;0;36;36;1
2019-11-01 18:00:00;SUR;0;29;29;1
2019-11-01 18:30:00;SUR;0;30;30;1
2019-11-01 19:00:00;SUR;0;39;39;1
2019-11-01 19:30:00;SUR;0;30;30;1
2019-11-01 20:00:00;SUR;0;24;24;1
2019-11-01 20:30:00;SUR;0;27;27;1
2019-11-01 21:00:00;SUR;0;29;29;1
2019-11-01 21:30:00;SUR;0;17;17;1
2019-11-01 22:00:00;SUR;0;15;15;1
2019-11-01 22:30:00;SUR;0;10;10;1
2019-11-01 23:00:00;SUR;0;15;15;1
2019-11-01 23:30:00;SUR;0;4;4;1
2019-11-02 00:00:00;SUR;0;2;2;1
2019-11-02 02:00:00;SUR;0;1;1;1
2019-11-02 02:30:00;SUR;0;1;1;1
2019-11-02 03:00:00;SUR;0;3;3;1
2019-11-02 03:30:00;SUR;0;3;3;1
2019-11-02 04:00:00;SUR;0;6;6;1
2019-11-02 04:30:00;SUR;0;4;4;1
2019-11-02 05:00:00;SUR;0;12;12;1
2019-11-02 05:30:00;SUR;0;15;15;1
2019-11-02 06:00:00;SUR;0;24;24;1
2019-11-02 06:30:00;SUR;0;26;26;1
2019-11-02 07:00:00;SUR;0;16;16;1
2019-11-02 07:30:00;SUR;0;23;23;1
2019-11-02 08:00:00;SUR;0;34;34;1
2019-11-02 08:30:00;SUR;0;26;26;1
2019-11-02 09:00:00;SUR;0;42;42;1
2019-11-02 09:30:00;SUR;0;32;32;1
2019-11-02 10:00:00;SUR;0;25;25;1
2019-11-02 10:30:00;SUR;0;33;33;1
2019-11-02 11:00:00;SUR;0;32;32;1
2019-11-02 11:30:00;SUR;0;36;36;1
2019-11-02 12:00:00;SUR;0;29;29;1
2019-11-02 12:30:00;SUR;0;29;29;1
2019-11-02 13:00:00;SUR;0;27;27;1
2019-11-02 13:30:00;SUR;0;28;28;1
2019-11-02 14:00:00;SUR;0;38;38;1
2019-11-02 14:30:00;SUR;0;28;28;1
2019-11-02 15:00:00;SUR;0;24;24;1
2019-11-02 15:30:00;SUR;0;21;21;1
2019-11-02 16:00:00;SUR;0;26;26;1
2019-11-02 16:30:00;SUR;0;26;26;1
2019-11-02 17:00:00;SUR;0;23;23;1
2019-11-02 17:30:00;SUR;0;23;23;1
2019-11-02 18:00:00;SUR;0;23;23;1
2019-11-02 18:30:00;SUR;0;20;20;1
2019-11-02 19:00:00;SUR;0;31;31;1
2019-11-02 19:30:00;SUR;0;16;16;1
2019-11-02 20:00:00;SUR;0;23;23;1
2019-11-02 20:30:00;SUR;0;20;20;1
2019-11-02 21:00:00;SUR;0;13;13;1
2019-11-02 21:30:00;SUR;0;17;17;1
2019-11-02 22:00:00;SUR;0;9;9;1
2019-11-02 22:30:00;SUR;0;9;9;1
2019-11-02 23:00:00;SUR;0;13;13;1
2019-11-02 23:30:00;SUR;0;3;3;1
2019-11-03 00:00:00;SUR;0;3;3;1
2019-11-03 01:00:00;SUR;0;2;2;1
2019-11-03 01:30:00;SUR;0;2;2;1
2019-11-03 02:30:00;SUR;0;2;2;1
2019-11-03 03:00:00;SUR;0;4;4;1
2019-11-03 03:30:00;SUR;0;3;3;1
2019-11-03 04:00:00;SUR;0;5;5;1
2019-11-03 04:30:00;SUR;0;5;5;1
2019-11-03 05:00:00;SUR;0;7;7;1
2019-11-03 05:30:00;SUR;0;16;16;1
2019-11-03 06:00:00;SUR;0;16;16;1
2019-11-03 06:30:00;SUR;0;21;21;1
2019-11-03 07:00:00;SUR;0;20;20;1
2019-11-03 07:30:00;SUR;0;20;20;1
2019-11-03 08:00:00;SUR;0;28;28;1
2019-11-03 08:30:00;NORTE;29;0;29;1
2019-11-03 09:00:00;NORTE;35;0;35;1
2019-11-03 09:30:00;NORTE;33;0;33;1
2019-11-03 10:00:00;NORTE;35;0;35;1
2019-11-03 10:30:00;NORTE;39;0;39;1
2019-11-03 11:00:00;NORTE;35;0;35;1
2019-11-03 11:30:00;NORTE;39;0;39;1
2019-11-03 12:00:00;NORTE;33;0;33;1
2019-11-03 12:30:00;NORTE;33;0;33;1
2019-11-03 13:00:00;NORTE;30;0;30;1
2019-11-03 13:30:00;NORTE;32;0;32;1
2019-11-03 14:00:00;NORTE;37;0;37;1
2019-11-03 14:30:00;NORTE;37;0;37;1
2019-11-03 15:00:00;NORTE;39;0;39;1
2019-11-03 15:30:00;NORTE;28;0;28;1
2019-11-03 16:00:00;NORTE;38;0;38;1
2019-11-03 16:30:00;NORTE;19;0;19;1
2019-11-03 17:00:00;NORTE;19;0;19;1
2019-11-03 17:30:00;NORTE;32;0;32;1
2019-11-03 18:00:00;NORTE;34;0;34;1
2019-11-03 18:30:00;NORTE;30;0;30;1
2019-11-03 19:00:00;NORTE;38;0;38;1
2019-11-03 19:30:00;NORTE;30;0;30;1
2019-11-03 20:00:00;NORTE;32;0;32;1
2019-11-03 20:30:00;NORTE;28;0;28;1
2019-11-03 21:00:00;NORTE;29;0;29;1
2019-11-03 21:30:00;NORTE;29;0;29;1
2019-11-03 22:00:00;NORTE;19;0;19;1
2019-11-03 22:30:00;CONFLICTIVA;11;2;13;2
2019-11-03 23:00:00;SUR;0;15;15;1
2019-11-03 23:30:00;SUR;0;4;4;1
2019-11-04 00:00:00;SUR;0;5;5;1
2019-11-04 00:30:00;SUR;0;2;2;1
2019-11-04 01:00:00;SUR;0;2;2;1
2019-11-04 01:30:00;SUR;0;1;1;1
2019-11-04 02:00:00;SUR;0;1;1;1
2019-11-04 02:30:00;SUR;0;1;1;1
2019-11-04 03:00:00;SUR;0;3;3;1
2019-11-04 03:30:00;SUR;0;7;7;1
2019-11-04 04:00:00;SUR;0;3;3;1
2019-11-04 04:30:00;SUR;0;6;6;1
2019-11-04 05:00:00;SUR;0;6;6;1
2019-11-04 05:30:00;SUR;0;14;14;1
2019-11-04 06:00:00;SUR;0;25;25;1
2019-11-04 06:30:00;SUR;0;41;41;1
2019-11-04 07:00:00;SUR;0;20;20;1
2019-11-04 07:30:00;SUR;0;23;23;1
2019-11-04 08:00:00;SUR;0;34;34;1
2019-11-04 08:30:00;SUR;0;32;32;1
2019-11-04 09:00:00;SUR;0;33;33;1
2019-11-04 09:30:00;SUR;0;40;40;1
2019-11-04 10:00:00;SUR;0;43;43;1
2019-11-04 10:30:00;SUR;0;36;36;1
2019-11-04 11:00:00;SUR;0;35;35;1
2019-11-04 11:30:00;SUR;0;36;36;1
2019-11-04 12:00:00;SUR;0;38;38;1
2019-11-04 12:30:00;SUR;0;31;31;1
2019-11-04 13:00:00;SUR;0;26;26;1
2019-11-04 13:30:00;SUR;0;31;31;1
2019-11-04 14:00:00;SUR;0;38;38;1
2019-11-04 14:30:00;SUR;0;40;40;1
2019-11-04 15:00:00;SUR;0;37;37;1
2019-11-04 15:30:00;SUR;0;35;35;1
2019-11-04 16:00:00;SUR;0;31;31;1
2019-11-04 16:30:00;SUR;0;20;20;1
2019-11-04 17:00:00;SUR;0;21;21;1
2019-11-04 17:30:00;SUR;0;30;30;1
2019-11-04 18:00:00;SUR;0;28;28;1
2019-11-04 18:30:00;SUR;0;26;26;1
2019-11-04 19:00:00;SUR;0;41;41;1
2019-11-04 19:30:00;SUR;0;36;36;1
2019-11-04 20:00:00;SUR;0;30;30;1
2019-11-04 20:30:00;SUR;0;31;31;1
2019-11-04 21:00:00;SUR;0;13;13;1
2019-11-04 21:16:00;SUR;0;12;12;1
2019-11-04 21:30:00;CONFLICTIVA;17;7;24;2
2019-11-04 22:00:00;NORTE;18;0;18;1
2019-11-04 22:30:00;NORTE;14;0;14;1
2019-11-04 23:00:00;NORTE;15;0;15;1
2019-11-04 23:30:00;NORTE;6;0;6;1
2019-11-05 00:00:00;NORTE;2;0;2;1
2019-11-05 00:30:00;NORTE;2;0;2;1
2019-11-05 01:00:00;NORTE;2;0;2;1
2019-11-05 02:00:00;NORTE;1;0;1;1
2019-11-05 02:30:00;NORTE;2;0;2;1
2019-11-05 03:00:00;NORTE;3;0;3;1
2019-11-05 03:30:00;NORTE;6;0;6;1
2019-11-05 04:00:00;NORTE;5;0;5;1
2019-11-05 04:30:00;NORTE;10;0;10;1
2019-11-05 05:00:00;NORTE;7;0;7;1
2019-11-05 05:30:00;NORTE;16;0;16;1
2019-11-05 06:00:00;NORTE;26;0;26;1
2019-11-05 06:30:00;NORTE;42;0;42;1
2019-11-05 07:00:00;NORTE;25;0;25;1
2019-11-05 07:30:00;NORTE;26;0;26;1
2019-11-05 08:00:00;NORTE;34;0;34;1
2019-11-05 08:30:00;NORTE;32;0;32;1
2019-11-05 09:00:00;NORTE;38;0;38;1
2019-11-05 09:30:00;NORTE;34;0;34;1
2019-11-05 10:00:00;CONFLICTIVA;5;26;31;2
2019-11-05 10:30:00;SUR;0;29;29;1
2019-11-05 11:00:00;SUR;0;34;34;1
2019-11-05 11:30:00;SUR;0;38;38;1
2019-11-05 12:00:00;SUR;0;28;28;1
2019-11-05 12:30:00;SUR;0;26;26;1
2019-11-05 13:00:00;NORTE;34;0;34;1
2019-11-05 13:30:00;NORTE;34;0;34;1
2019-11-05 14:00:00;NORTE;36;0;36;1
2019-11-05 14:30:00;NORTE;30;0;30;1
2019-11-05 15:00:00;NORTE;21;0;21;1
2019-11-05 15:30:00;NORTE;26;0;26;1
2019-11-05 16:00:00;NORTE;28;0;28;1
2019-11-05 16:30:00;NORTE;35;0;35;1
2019-11-05 17:00:00;NORTE;34;0;34;1
2019-11-05 17:30:00;NORTE;34;0;34;1
2019-11-05 18:00:00;NORTE;33;0;33;1
2019-11-05 18:30:00;NORTE;23;0;23;1
2019-11-05 19:00:00;NORTE;37;0;37;1
2019-11-05 19:30:00;NORTE;29;0;29;1
2019-11-05 20:00:00;NORTE;25;0;25;1
2019-11-05 20:30:00;NORTE;28;0;28;1
2019-11-05 21:00:00;NORTE;28;0;28;1
2019-11-05 21:30:00;NORTE;27;0;27;1
2019-11-05 22:00:00;NORTE;18;0;18;1
2019-11-05 22:30:00;NORTE;8;0;8;1
2019-11-05 23:00:00;NORTE;13;0;13;1
2019-11-05 23:30:00;NORTE;5;0;5;1
2019-11-06 00:00:00;NORTE;1;0;1;1
2019-11-06 00:30:00;NORTE;1;0;1;1
2019-11-06 01:00:00;NORTE;2;0;2;1
2019-11-06 01:30:00;NORTE;1;0;1;1
2019-11-06 02:00:00;NORTE;1;0;1;1
2019-11-06 03:00:00;NORTE;3;0;3;1
2019-11-06 03:30:00;NORTE;2;0;2;1
2019-11-06 04:00:00;NORTE;7;0;7;1
2019-11-06 04:30:00;NORTE;6;0;6;1
2019-11-06 05:00:00;NORTE;13;0;13;1
2019-11-06 05:30:00;NORTE;18;0;18;1
2019-11-06 06:00:00;NORTE;26;0;26;1
2019-11-06 06:30:00;NORTE;35;0;35;1
2019-11-06 07:00:00;NORTE;25;0;25;1
2019-11-06 07:30:00;NORTE;27;0;27;1
2019-11-06 08:00:00;NORTE;31;0;31;1
2019-11-06 08:30:00;NORTE;34;0;34;1
2019-11-06 09:00:00;NORTE;39;0;39;1
2019-11-06 09:30:00;NORTE;32;0;32;1
2019-11-06 10:00:00;NORTE;26;0;26;1
2019-11-06 10:30:00;NORTE;33;0;33;1
2019-11-06 11:00:00;NORTE;39;0;39;1
2019-11-06 11:30:00;NORTE;29;0;29;1
2019-11-06 12:00:00;NORTE;31;0;31;1
2019-11-06 12:30:00;NORTE;33;0;33;1
2019-11-06 13:00:00;NORTE;23;0;23;1
2019-11-06 13:30:00;NORTE;38;0;38;1
2019-11-06 14:00:00;NORTE;32;0;32;1
2019-11-06 14:30:00;NORTE;30;0;30;1
2019-11-06 15:00:00;NORTE;41;0;41;1
2019-11-06 15:30:00;NORTE;35;0;35;1
2019-11-06 16:00:00;NORTE;32;0;32;1
2019-11-06 16:30:00;NORTE;19;0;19;1
2019-11-06 17:00:00;NORTE;26;0;26;1
2019-11-06 17:30:00;NORTE;33;0;33;1
2019-11-06 18:00:00;NORTE;26;0;26;1
2019-11-06 18:30:00;NORTE;27;0;27;1
2019-11-06 19:00:00;NORTE;38;0;38;1
2019-11-06 19:30:00;NORTE;24;0;24;1
2019-11-06 20:00:00;NORTE;27;0;27;1
2019-11-06 20:30:00;NORTE;32;0;32;1
2019-11-06 21:00:00;NORTE;26;0;26;1
2019-11-06 21:30:00;NORTE;26;0;26;1
2019-11-06 22:00:00;SUR;0;15;15;1
2019-11-06 22:30:00;SUR;0;6;6;1
2019-11-06 23:00:00;SUR;0;12;12;1
2019-11-06 23:30:00;SUR;0;5;5;1
2019-11-07 00:00:00;SUR;0;4;4;1
2019-11-07 00:30:00;SUR;0;2;2;1
2019-11-07 01:00:00;SUR;0;3;3;1
2019-11-07 01:30:00;SUR;0;1;1;1
2019-11-07 02:00:00;SUR;0;2;2;1
2019-11-07 02:30:00;SUR;0;3;3;1
2019-11-07 03:00:00;SUR;0;1;1;1
2019-11-07 03:07:00;SUR;0;3;3;1
2019-11-07 03:30:00;SUR;0;4;4;1
2019-11-07 04:00:00;SUR;0;3;3;1
2019-11-07 04:30:00;SUR;0;10;10;1
2019-11-07 05:00:00;SUR;0;9;9;1
2019-11-07 05:30:00;SUR;0;17;17;1
2019-11-07 06:00:00;SUR;0;27;27;1
2019-11-07 06:30:00;SUR;0;33;33;1
2019-11-07 07:00:00;SUR;0;23;23;1
2019-11-07 07:30:00;SUR;0;22;22;1
2019-11-07 08:00:00;SUR;1;34;35;1
2019-11-07 08:30:00;NORTE;32;0;32;1
2019-11-07 09:00:00;NORTE;37;0;37;1
2019-11-07 09:30:00;NORTE;38;0;38;1
2019-11-07 10:00:00;NORTE;26;0;26;1
2019-11-07 10:30:00;NORTE;33;0;33;1
2019-11-07 11:00:00;NORTE;34;0;34;1
2019-11-07 11:30:00;NORTE;37;0;37;1
2019-11-07 12:00:00;NORTE;33;0;33;1
2019-11-07 12:30:00;NORTE;25;0;25;1
2019-11-07 13:00:00;NORTE;22;0;22;1
2019-11-07 13:30:00;NORTE;37;0;37;1
2019-11-07 14:00:00;NORTE;35;0;35;1
2019-11-07 14:30:00;NORTE;32;0;32;1
2019-11-07 15:00:00;NORTE;34;0;34;1
2019-11-07 15:30:00;NORTE;29;0;29;1
2019-11-07 16:00:00;NORTE;30;0;30;1
2019-11-07 16:30:00;NORTE;17;0;17;1
2019-11-07 17:00:00;NORTE;23;0;23;1
2019-11-07 17:30:00;NORTE;35;0;35;1
2019-11-07 18:00:00;NORTE;25;0;25;1
2019-11-07 18:30:00;NORTE;29;0;29;1
2019-11-07 19:00:00;NORTE;41;0;41;1
2019-11-07 19:30:00;NORTE;36;0;36;1
2019-11-07 20:00:00;NORTE;29;0;29;1
2019-11-07 20:30:00;NORTE;28;0;28;1
2019-11-07 21:00:00;NORTE;26;0;26;1
2019-11-07 21:30:00;NORTE;30;0;30;1
2019-11-07 22:00:00;NORTE;18;0;18;1
2019-11-07 22:30:00;NORTE;9;0;9;1
2019-11-07 23:00:00;NORTE;10;0;10;1
2019-11-07 23:30:00;NORTE;6;0;6;1
2019-11-08 00:00:00;NORTE;2;0;2;1
2019-11-08 01:00:00;NORTE;5;0;5;1
2019-11-08 02:00:00;NORTE;1;0;1;1
2019-11-08 02:30:00;NORTE;1;0;1;1
2019-11-08 03:00:00;NORTE;4;0;4;1
2019-11-08 03:30:00;NORTE;7;0;7;1
2019-11-08 04:00:00;NORTE;5;0;5;1
2019-11-08 04:30:00;NORTE;10;0;10;1
2019-11-08 05:00:00;NORTE;9;0;9;1
2019-11-08 05:30:00;NORTE;19;0;19;1
2019-11-08 06:00:00;NORTE;23;0;23;1
2019-11-08 06:30:00;NORTE;33;0;33;1
2019-11-08 07:00:00;NORTE;32;0;32;1
2019-11-08 07:30:00;NORTE;24;0;24;1
2019-11-08 08:00:00;NORTE;35;0;35;1
2019-11-08 08:30:00;NORTE;30;0;30;1
2019-11-08 09:00:00;NORTE;36;0;36;1
2019-11-08 09:30:00;NORTE;41;0;41;1
2019-11-08 10:00:00;NORTE;29;0;29;1
2019-11-08 10:30:00;NORTE;39;0;39;1
2019-11-08 11:00:00;NORTE;37;0;37;1
2019-11-08 11:30:00;NORTE;26;0;26;1
2019-11-08 12:00:00;NORTE;30;0;30;1
2019-11-08 12:30:00;NORTE;35;0;35;1
2019-11-08 13:00:00;NORTE;28;0;28;1
2019-11-08 13:30:00;NORTE;36;0;36;1
2019-11-08 14:00:00;NORTE;34;0;34;1
2019-11-08 14:30:00;NORTE;44;0;44;1
2019-11-08 15:00:00;NORTE;38;0;38;1
2019-11-08 15:30:00;NORTE;35;0;35;1
2019-11-08 16:00:00;NORTE;30;0;30;1
2019-11-08 16:30:00;NORTE;21;0;21;1
2019-11-08 17:00:00;NORTE;31;0;31;1
2019-11-08 17:30:00;NORTE;35;0;35;1
2019-11-08 18:00:00;NORTE;30;0;30;1
2019-11-08 18:30:00;NORTE;31;0;31;1
2019-11-08 19:00:00;NORTE;40;0;40;1
2019-11-08 19:30:00;NORTE;31;0;31;1
2019-11-08 20:00:00;NORTE;30;0;30;1
2019-11-08 20:30:00;NORTE;22;0;22;1
2019-11-08 21:00:00;NORTE;34;0;34;1
2019-11-08 21:30:00;NORTE;31;0;31;1
2019-11-08 22:00:00;NORTE;14;0;14;1
2019-11-08 22:30:00;NORTE;9;0;9;1
2019-11-08 23:00:00;NORTE;14;0;14;1
2019-11-08 23:30:00;NORTE;4;0;4;1
2019-11-09 00:00:00;NORTE;1;0;1;1
2019-11-09 00:30:00;NORTE;1;0;1;1
2019-11-09 02:00:00;NORTE;1;0;1;1
2019-11-09 02:30:00;NORTE;1;0;1;1
2019-11-09 03:00:00;NORTE;3;0;3;1
2019-11-09 03:30:00;NORTE;7;0;7;1
2019-11-09 04:00:00;NORTE;1;0;1;1
2019-11-09 04:30:00;NORTE;4;0;4;1
2019-11-09 05:00:00;NORTE;13;0;13;1
2019-11-09 05:30:00;NORTE;17;0;17;1
2019-11-09 06:00:00;NORTE;21;0;21;1
2019-11-09 06:30:00;NORTE;27;0;27;1
2019-11-09 07:00:00;NORTE;20;0;20;1
2019-11-09 07:30:00;NORTE;26;0;26;1
2019-11-09 08:00:00;NORTE;34;0;34;1
2019-11-09 08:30:00;NORTE;26;0;26;1
2019-11-09 09:00:00;NORTE;43;0;43;1
2019-11-09 09:30:00;NORTE;33;0;33;1
2019-11-09 10:00:00;NORTE;33;0;33;1
2019-11-09 10:30:00;NORTE;44;0;44;1
2019-11-09 11:00:00;NORTE;33;0;33;1
2019-11-09 11:30:00;NORTE;30;0;30;1
2019-11-09 12:00:00;NORTE;29;0;29;1
2019-11-09 12:30:00;NORTE;29;0;29;1
2019-11-09 13:00:00;NORTE;25;1;26;1
2019-11-09 13:30:00;NORTE;26;0;26;1
2019-11-09 14:00:00;NORTE;32;0;32;1
2019-11-09 14:30:00;NORTE;26;0;26;1
2019-11-09 15:00:00;NORTE;37;0;37;1
2019-11-09 15:30:00;NORTE;28;0;28;1
2019-11-09 16:00:00;NORTE;22;0;22;1
2019-11-09 16:30:00;NORTE;10;1;11;1
2019-11-09 17:00:00;SUR;0;22;22;1
2019-11-09 17:30:00;SUR;0;31;31;1
2019-11-09 18:00:00;SUR;0;9;9;1
2019-11-09 18:14:00;CONFLICTIVA;4;4;8;2
2019-11-09 18:30:00;NORTE;19;0;19;1
2019-11-09 19:00:00;NORTE;31;0;31;1
2019-11-09 19:30:00;NORTE;20;0;20;1
2019-11-09 20:00:00;NORTE;5;0;5;1
2019-11-09 20:10:00;NORTE;12;0;12;1
2019-11-09 20:30:00;NORTE;25;0;25;1
2019-11-09 21:00:00;NORTE;14;0;14;1
2019-11-09 21:30:00;NORTE;17;0;17;1
2019-11-09 22:00:00;NORTE;9;0;9;1
2019-11-09 22:30:00;NORTE;5;0;5;1
2019-11-09 23:00:00;NORTE;11;0;11;1
2019-11-09 23:30:00;NORTE;3;0;3;1
2019-11-10 00:00:00;NORTE;1;0;1;1
2019-11-10 00:30:00;NORTE;2;0;2;1
2019-11-10 01:30:00;NORTE;1;0;1;1
2019-11-10 02:00:00;NORTE;1;0;1;1
2019-11-10 02:30:00;NORTE;3;0;3;1
2019-11-10 03:00:00;NORTE;1;0;1;1
2019-11-10 03:30:00;NORTE;1;0;1;1
2019-11-10 04:00:00;NORTE;7;0;7;1
2019-11-10 04:30:00;NORTE;4;0;4;1
2019-11-10 05:00:00;NORTE;6;0;6;1
2019-11-10 05:30:00;NORTE;10;0;10;1
2019-11-10 06:00:00;NORTE;22;0;22;1
2019-11-10 06:30:00;NORTE;22;0;22;1
2019-11-10 07:00:00;NORTE;19;0;19;1
2019-11-10 07:30:00;NORTE;28;0;28;1
2019-11-10 08:00:00;NORTE;32;0;32;1
2019-11-10 08:30:00;NORTE;29;0;29;1
2019-11-10 09:00:00;NORTE;34;0;34;1
2019-11-10 09:30:00;NORTE;31;0;31;1
2019-11-10 10:00:00;NORTE;29;0;29;1
2019-11-10 10:30:00;NORTE;38;0;38;1
2019-11-10 11:00:00;NORTE;28;0;28;1
2019-11-10 11:30:00;NORTE;42;0;42;1
2019-11-10 12:00:00;NORTE;31;0;31;1
2019-11-10 12:30:00;NORTE;37;0;37;1
2019-11-10 13:00:00;NORTE;31;0;31;1
2019-11-10 13:30:00;NORTE;34;0;34;1
2019-11-10 14:00:00;NORTE;43;0;43;1
2019-11-10 14:30:00;NORTE;31;0;31;1
2019-11-10 15:00:00;NORTE;31;0;31;1
2019-11-10 15:30:00;NORTE;29;0;29;1
2019-11-10 16:00:00;NORTE;33;0;33;1
2019-11-10 16:30:00;NORTE;18;0;18;1
2019-11-10 17:00:00;NORTE;28;0;28;1
2019-11-10 17:30:00;NORTE;35;0;35;1
2019-11-10 18:00:00;NORTE;32;0;32;1
2019-11-10 18:30:00;NORTE;27;0;27;1
2019-11-10 19:00:00;NORTE;34;0;34;1
2019-11-10 19:30:00;NORTE;31;0;31;1
2019-11-10 20:00:00;NORTE;28;0;28;1
2019-11-10 20:30:00;NORTE;25;0;25;1
2019-11-10 21:00:00;NORTE;31;0;31;1
2019-11-10 21:30:00;NORTE;26;0;26;1
2019-11-10 22:00:00;NORTE;13;0;13;1
2019-11-10 22:30:00;NORTE;11;0;11;1
2019-11-10 23:00:00;NORTE;16;0;16;1
2019-11-10 23:30:00;NORTE;5;0;5;1
2019-11-11 00:30:00;NORTE;2;0;2;1
2019-11-11 01:00:00;NORTE;1;0;1;1
2019-11-11 01:30:00;NORTE;1;0;1;1
2019-11-11 02:00:00;NORTE;1;0;1;1
2019-11-11 02:30:00;NORTE;1;0;1;1
2019-11-11 03:00:00;NORTE;4;0;4;1
2019-11-11 03:30:00;NORTE;6;0;6;1
2019-11-11 04:00:00;NORTE;6;0;6;1
2019-11-11 04:30:00;NORTE;3;0;3;1
2019-11-11 05:00:00;NORTE;6;0;6;1
2019-11-11 05:30:00;NORTE;18;0;18;1
2019-11-11 06:00:00;NORTE;27;0;27;1
2019-11-11 06:30:00;NORTE;36;0;36;1
2019-11-11 07:00:00;NORTE;24;0;24;1
2019-11-11 07:30:00;NORTE;30;0;30;1
2019-11-11 08:00:00;NORTE;38;0;38;1
2019-11-11 08:30:00;NORTE;30;0;30;1
2019-11-11 09:00:00;NORTE;34;0;34;1
2019-11-11 09:30:00;NORTE;41;0;41;1
2019-11-11 10:00:00;NORTE;32;0;32;1
2019-11-11 10:30:00;NORTE;35;0;35;1
2019-11-11 11:00:00;NORTE;36;1;37;1
2019-11-11 11:30:00;NORTE;34;0;34;1
2019-11-11 12:00:00;NORTE;26;0;26;1
2019-11-11 12:30:00;NORTE;33;0;33;1
2019-11-11 13:00:00;NORTE;28;0;28;1
2019-11-11 13:30:00;NORTE;30;0;30;1
2019-11-11 14:00:00;NORTE;35;0;35;1
2019-11-11 14:30:00;NORTE;37;0;37;1
2019-11-11 15:00:00;NORTE;38;0;38;1
2019-11-11 15:30:00;NORTE;28;0;28;1
2019-11-11 16:00:00;NORTE;27;0;27;1
2019-11-11 16:30:00;NORTE;21;0;21;1
2019-11-11 17:00:00;NORTE;23;0;23;1
2019-11-11 17:30:00;NORTE;36;0;36;1
2019-11-11 18:00:00;NORTE;23;0;23;1
2019-11-11 18:30:00;NORTE;28;0;28;1
2019-11-11 19:00:00;NORTE;38;0;38;1
2019-11-11 19:30:00;NORTE;30;0;30;1
2019-11-11 20:00:00;NORTE;24;0;24;1
2019-11-11 20:30:00;NORTE;29;0;29;1
2019-11-11 21:00:00;NORTE;34;0;34;1
2019-11-11 21:30:00;NORTE;27;0;27;1
2019-11-11 22:00:00;NORTE;10;0;10;1
2019-11-11 22:30:00;NORTE;11;0;11;1
2019-11-11 23:00:00;NORTE;13;0;13;1
2019-11-11 23:30:00;NORTE;4;0;4;1
2019-11-12 00:00:00;NORTE;3;0;3;1
2019-11-12 00:30:00;NORTE;1;0;1;1
2019-11-12 02:00:00;NORTE;2;0;2;1
2019-11-12 03:00:00;NORTE;7;0;7;1
2019-11-12 03:30:00;NORTE;4;0;4;1
2019-11-12 04:00:00;NORTE;9;0;9;1
2019-11-12 04:30:00;NORTE;10;0;10;1
2019-11-12 05:00:00;NORTE;8;0;8;1
2019-11-12 05:30:00;NORTE;13;0;13;1
2019-11-12 06:00:00;NORTE;23;0;23;1
2019-11-12 06:30:00;NORTE;37;0;37;1
2019-11-12 07:00:00;NORTE;23;0;23;1
2019-11-12 07:30:00;NORTE;29;0;29;1
2019-11-12 08:00:00;NORTE;32;0;32;1
2019-11-12 08:30:00;NORTE;28;0;28;1
2019-11-12 09:00:00;NORTE;37;0;37;1
2019-11-12 09:30:00;NORTE;31;0;31;1
2019-11-12 10:00:00;NORTE;31;0;31;1
2019-11-12 10:30:00;NORTE;31;0;31;1
2019-11-12 11:00:00;NORTE;29;0;29;1
2019-11-12 11:30:00;NORTE;28;0;28;1
2019-11-12 12:00:00;NORTE;35;0;35;1
2019-11-12 12:30:00;NORTE;25;0;25;1
2019-11-12 13:00:00;NORTE;27;0;27;1
2019-11-12 13:30:00;NORTE;32;0;32;1
2019-11-12 14:00:00;NORTE;25;0;25;1
2019-11-12 14:30:00;NORTE;36;0;36;1
2019-11-12 15:00:00;NORTE;35;0;35;1
2019-11-12 15:30:00;NORTE;27;0;27;1
2019-11-12 16:00:00;NORTE;34;0;34;1
2019-11-12 16:30:00;NORTE;15;0;15;1
2019-11-12 17:00:00;NORTE;21;0;21;1
2019-11-12 17:30:00;NORTE;41;0;41;1
2019-11-12 18:00:00;NORTE;26;0;26;1
2019-11-12 18:30:00;CONFLICTIVA;7;15;22;2
2019-11-12 19:00:00;SUR;0;33;33;1
2019-11-12 19:30:00;SUR;0;30;30;1
2019-11-12 20:00:00;SUR;0;16;16;1
2019-11-12 20:30:00;SUR;0;26;26;1
2019-11-12 21:00:00;SUR;0;26;26;1
2019-11-12 21:30:00;SUR;0;24;24;1
2019-11-12 22:00:00;SUR;0;15;15;1
2019-11-12 22:30:00;SUR;0;7;7;1
2019-11-12 23:00:00;SUR;0;11;11;1
2019-11-12 23:30:00;SUR;0;4;4;1
2019-11-13 00:00:00;SUR;0;2;2;1
2019-11-13 01:00:00;SUR;0;1;1;1
2019-11-13 02:00:00;SUR;0;1;1;1
2019-11-13 03:00:00;SUR;0;5;5;1
2019-11-13 03:30:00;SUR;0;5;5;1
2019-11-13 04:00:00;SUR;0;5;5;1
2019-11-13 04:30:00;SUR;0;8;8;1
2019-11-13 05:00:16;SUR;0;1;1;1
2019-11-13 05:00:45;SUR;0;1;1;1
2019-11-13 05:04:22;SUR;0;1;1;1
2019-11-13 05:05:41;SUR;0;1;1;1
2019-11-13 05:07:51;SUR;0;1;1;1
2019-11-13 05:11:01;SUR;0;1;1;1
2019-11-13 05:11:12;SUR;0;1;1;1
2019-11-13 05:17:51;SUR;0;1;1;1
2019-11-13 05:23:02;SUR;0;1;1;1
2019-11-13 05:27:49;SUR;0;1;1;1
2019-11-13 05:32:06;SUR;0;1;1;1
2019-11-13 05:33:28;SUR;0;1;1;1
2019-11-13 05:36:24;SUR;0;1;1;1
2019-11-13 05:36:32;SUR;0;1;1;1
2019-11-13 05:38:15;SUR;0;1;1;1
2019-11-13 05:40:18;SUR;0;1;1;1
2019-11-13 05:41:47;SUR;0;1;1;1
2019-11-13 05:43:31;SUR;0;1;1;1
2019-11-13 05:45:55;SUR;0;1;1;1
2019-11-13 05:50:50;SUR;0;1;1;1
2019-11-13 05:51:57;SUR;0;1;1;1
2019-11-13 05:54:15;SUR;0;1;1;1
2019-11-13 05:56:24;SUR;0;1;1;1
2019-11-13 06:00:09;SUR;0;1;1;1
2019-11-13 06:00:31;SUR;0;1;1;1
2019-11-13 06:02:34;SUR;0;1;1;1
2019-11-13 06:04:04;SUR;0;1;1;1
2019-11-13 06:06:49;SUR;0;1;1;1
2019-11-13 06:06:57;SUR;0;1;1;1
2019-11-13 06:11:07;SUR;0;1;1;1
2019-11-13 06:11:51;SUR;0;1;1;1
2019-11-13 06:12:37;SUR;0;1;1;1
2019-11-13 06:14:08;SUR;0;1;1;1
2019-11-13 06:16:44;SUR;0;1;1;1
2019-11-13 06:17:35;SUR;0;1;1;1
2019-11-13 06:19:13;SUR;0;1;1;1
2019-11-13 06:20:29;SUR;0;1;1;1
2019-11-13 06:22:24;SUR;0;1;1;1
2019-11-13 06:22:38;SUR;0;1;1;1
2019-11-13 06:24:56;SUR;0;1;1;1
2019-11-13 06:25:03;SUR;0;1;1;1
2019-11-13 06:26:34;SUR;0;1;1;1
2019-11-13 06:27:33;SUR;0;1;1;1
2019-11-13 06:27:41;SUR;0;1;1;1
2019-11-13 06:28:48;SUR;0;1;1;1
2019-11-13 06:29:01;SUR;0;1;1;1
2019-11-13 06:30:08;SUR;0;2;2;1
2019-11-13 06:31:23;SUR;0;1;1;1
2019-11-13 06:32:19;SUR;0;1;1;1
2019-11-13 06:33:29;SUR;0;1;1;1
2019-11-13 06:33:54;SUR;0;1;1;1
2019-11-13 06:35:19;SUR;0;1;1;1
2019-11-13 06:35:20;SUR;0;1;1;1
2019-11-13 06:38:12;SUR;0;1;1;1
2019-11-13 06:38:34;SUR;0;1;1;1
2019-11-13 06:39:45;SUR;0;1;1;1
2019-11-13 06:41:57;SUR;0;1;1;1
2019-11-13 06:42:57;SUR;0;1;1;1
2019-11-13 06:44:28;SUR;0;1;1;1
2019-11-13 06:45:31;SUR;0;1;1;1
2019-11-13 06:46:46;SUR;0;1;1;1
2019-11-13 06:46:50;SUR;0;1;1;1
2019-11-13 06:47:22;SUR;0;1;1;1
2019-11-13 06:47:55;SUR;0;1;1;1
2019-11-13 06:48:55;SUR;0;1;1;1
2019-11-13 06:49:40;SUR;0;1;1;1
2019-11-13 06:50:37;SUR;0;1;1;1
2019-11-13 06:50:43;SUR;0;1;1;1
2019-11-13 06:51:55;SUR;0;1;1;1
2019-11-13 06:52:52;SUR;0;1;1;1
2019-11-13 06:54:00;SUR;0;1;1;1
2019-11-13 06:54:41;SUR;0;1;1;1
2019-11-13 06:54:43;SUR;0;1;1;1
2019-11-13 06:55:40;SUR;0;1;1;1
2019-11-13 06:55:55;SUR;0;1;1;1
2019-11-13 06:56:52;SUR;0;1;1;1
2019-11-13 06:58:17;SUR;0;1;1;1
2019-11-13 06:59:08;SUR;0;1;1;1
2019-11-13 07:00:20;SUR;0;1;1;1
2019-11-13 07:01:18;SUR;0;1;1;1
2019-11-13 07:02:17;SUR;0;1;1;1
2019-11-13 07:03:14;SUR;0;1;1;1
2019-11-13 07:04:18;SUR;0;1;1;1
2019-11-13 07:04:22;SUR;0;1;1;1
2019-11-13 07:05:32;SUR;0;1;1;1
2019-11-13 07:06:22;SUR;0;1;1;1
2019-11-13 07:07:08;SUR;0;1;1;1
2019-11-13 07:07:54;SUR;0;1;1;1
2019-11-13 07:09:18;SUR;0;1;1;1
2019-11-13 07:13:39;SUR;0;1;1;1
2019-11-13 07:14:02;SUR;0;1;1;1
2019-11-13 07:14:33;SUR;0;1;1;1
2019-11-13 07:16:29;SUR;0;1;1;1
2019-11-13 07:17:14;SUR;0;1;1;1
2019-11-13 07:17:36;SUR;0;1;1;1
2019-11-13 07:20:05;SUR;0;1;1;1
2019-11-13 07:20:10;SUR;0;1;1;1
2019-11-13 07:21:40;SUR;0;1;1;1
2019-11-13 07:21:51;SUR;0;1;1;1
2019-11-13 07:22:22;SUR;0;1;1;1
2019-11-13 07:23:38;SUR;0;1;1;1
2019-11-13 07:24:59;SUR;0;1;1;1
2019-11-13 07:25:08;SUR;0;1;1;1
2019-11-13 07:28:29;SUR;0;1;1;1
2019-11-13 07:28:44;SUR;0;1;1;1
2019-11-13 07:30:15;SUR;0;1;1;1
2019-11-13 07:32:40;SUR;0;1;1;1
2019-11-13 07:34:00;SUR;0;1;1;1
2019-11-13 07:35:19;SUR;0;1;1;1
2019-11-13 07:35:41;SUR;0;1;1;1
2019-11-13 07:39:29;SUR;0;1;1;1
2019-11-13 07:40:31;SUR;0;1;1;1
2019-11-13 07:43:19;SUR;0;1;1;1
2019-11-13 07:43:58;SUR;0;1;1;1
2019-11-13 07:45:25;SUR;0;1;1;1
2019-11-13 07:45:40;SUR;0;1;1;1
2019-11-13 07:46:49;SUR;0;1;1;1
2019-11-13 07:48:48;SUR;0;1;1;1
2019-11-13 07:51:08;SUR;0;1;1;1
2019-11-13 07:51:13;SUR;0;1;1;1
2019-11-13 07:52:23;SUR;0;1;1;1
2019-11-13 07:54:07;SUR;0;1;1;1
2019-11-13 07:54:14;SUR;0;1;1;1
2019-11-13 07:55:00;SUR;0;1;1;1
2019-11-13 07:56:16;SUR;0;1;1;1
2019-11-13 07:57:07;SUR;0;1;1;1
2019-11-13 07:58:24;SUR;0;1;1;1
2019-11-13 07:58:27;SUR;0;1;1;1
2019-11-13 07:59:24;SUR;0;1;1;1
2019-11-13 08:00:23;SUR;0;1;1;1
2019-11-13 08:01:30;SUR;0;1;1;1
2019-11-13 08:02:11;SUR;0;1;1;1
2019-11-13 08:03:36;SUR;0;1;1;1
2019-11-13 08:04:01;SUR;0;1;1;1
2019-11-13 08:04:17;SUR;0;1;1;1
2019-11-13 08:05:28;SUR;0;1;1;1
2019-11-13 08:06:23;SUR;0;1;1;1
2019-11-13 08:06:50;SUR;0;1;1;1
2019-11-13 08:08:27;SUR;0;1;1;1
2019-11-13 08:08:51;SUR;0;1;1;1
2019-11-13 08:09:57;SUR;0;1;1;1
2019-11-13 08:10:50;SUR;0;1;1;1
2019-11-13 08:10:52;SUR;0;1;1;1
2019-11-13 08:11:01;SUR;0;1;1;1
2019-11-13 08:11:46;SUR;0;1;1;1
2019-11-13 08:13:00;SUR;0;1;1;1
2019-11-13 08:13:03;SUR;0;1;1;1
2019-11-13 08:14:05;SUR;0;1;1;1
2019-11-13 08:14:07;SUR;0;1;1;1
2019-11-13 08:15:42;SUR;0;1;1;1
2019-11-13 08:16:30;SUR;0;1;1;1
2019-11-13 08:19:33;SUR;0;1;1;1
2019-11-13 08:21:09;SUR;0;1;1;1
2019-11-13 08:23:22;SUR;0;1;1;1
2019-11-13 08:25:52;SUR;0;1;1;1
2019-11-13 08:29:02;NORTE;1;0;1;1
2019-11-13 08:30:48;NORTE;1;0;1;1
2019-11-13 08:31:08;NORTE;1;0;1;1
2019-11-13 08:32:18;NORTE;1;0;1;1
2019-11-13 08:33:41;NORTE;1;0;1;1
2019-11-13 08:35:03;NORTE;1;0;1;1
2019-11-13 08:35:08;NORTE;1;0;1;1
2019-11-13 08:35:22;NORTE;1;0;1;1
2019-11-13 08:36:57;NORTE;1;0;1;1
2019-11-13 08:37:35;NORTE;1;0;1;1
2019-11-13 08:38:12;NORTE;1;0;1;1
2019-11-13 08:39:57;NORTE;1;0;1;1
2019-11-13 08:40:02;NORTE;1;0;1;1
2019-11-13 08:42:07;NORTE;1;0;1;1
2019-11-13 08:43:27;NORTE;1;0;1;1
2019-11-13 08:43:36;NORTE;1;0;1;1
2019-11-13 08:44:05;NORTE;1;0;1;1
2019-11-13 08:45:02;NORTE;1;0;1;1
2019-11-13 08:45:59;NORTE;1;0;1;1
2019-11-13 08:46:22;NORTE;1;0;1;1
2019-11-13 08:47:28;NORTE;1;0;1;1
2019-11-13 08:47:47;NORTE;1;0;1;1
2019-11-13 08:48:31;NORTE;1;0;1;1
2019-11-13 08:48:59;NORTE;1;0;1;1
2019-11-13 08:49:29;NORTE;1;0;1;1
2019-11-13 08:50:19;NORTE;1;0;1;1
2019-11-13 08:50:35;NORTE;1;0;1;1
2019-11-13 08:51:40;NORTE;1;0;1;1
2019-11-13 08:53:17;NORTE;1;0;1;1
2019-11-13 08:53:30;NORTE;1;0;1;1
2019-11-13 08:53:34;NORTE;1;0;1;1
2019-11-13 08:54:56;NORTE;1;0;1;1
2019-11-13 08:55:56;NORTE;1;0;1;1
2019-11-13 08:56:40;NORTE;1;0;1;1
2019-11-13 08:56:57;NORTE;1;0;1;1
2019-11-13 08:59:37;NORTE;1;0;1;1
2019-11-13 08:59:59;NORTE;1;0;1;1
2019-11-13 09:00:45;NORTE;1;0;1;1
2019-11-13 09:00:53;NORTE;1;0;1;1
2019-11-13 09:02:02;NORTE;1;0;1;1
2019-11-13 09:03:01;NORTE;1;0;1;1
2019-11-13 09:03:06;NORTE;1;0;1;1
2019-11-13 09:03:25;NORTE;1;0;1;1
2019-11-13 09:05:30;NORTE;1;0;1;1
2019-11-13 09:07:01;NORTE;1;0;1;1
2019-11-13 09:09:53;NORTE;1;0;1;1
2019-11-13 09:10:21;NORTE;1;0;1;1
2019-11-13 09:11:15;NORTE;1;0;1;1
2019-11-13 09:12:23;NORTE;1;0;1;1
2019-11-13 09:13:46;NORTE;1;0;1;1
2019-11-13 09:13:54;NORTE;1;0;1;1
2019-11-13 09:15:22;NORTE;1;0;1;1
2019-11-13 09:15:34;NORTE;1;0;1;1
2019-11-13 09:16:35;NORTE;1;0;1;1
2019-11-13 09:17:41;NORTE;1;0;1;1
2019-11-13 09:18:32;NORTE;1;0;1;1
2019-11-13 09:19:46;NORTE;1;0;1;1
2019-11-13 09:19:53;NORTE;1;0;1;1
2019-11-13 09:21:03;NORTE;1;0;1;1
2019-11-13 09:21:40;NORTE;1;0;1;1
2019-11-13 09:21:46;NORTE;1;0;1;1
2019-11-13 09:23:21;NORTE;1;0;1;1
2019-11-13 09:23:44;NORTE;1;0;1;1
2019-11-13 09:25:09;NORTE;2;0;2;1
2019-11-13 09:25:26;NORTE;1;0;1;1
2019-11-13 09:26:28;NORTE;1;0;1;1
2019-11-13 09:26:37;NORTE;1;0;1;1
2019-11-13 09:27:26;NORTE;1;0;1;1
2019-11-13 09:27:44;NORTE;1;0;1;1
2019-11-13 09:28:52;NORTE;1;0;1;1
2019-11-13 09:28:57;NORTE;1;0;1;1
2019-11-13 09:30:13;NORTE;1;0;1;1
2019-11-13 09:30:32;NORTE;1;0;1;1
2019-11-13 09:30:41;NORTE;1;0;1;1
2019-11-13 09:31:06;NORTE;1;0;1;1
2019-11-13 09:31:30;NORTE;1;0;1;1
2019-11-13 09:32:56;NORTE;1;0;1;1
2019-11-13 09:33:56;NORTE;1;0;1;1
2019-11-13 09:33:57;NORTE;1;0;1;1
2019-11-13 09:34:31;NORTE;1;0;1;1
2019-11-13 09:35:56;NORTE;1;0;1;1
2019-11-13 09:39:45;NORTE;1;0;1;1
2019-11-13 09:41:04;NORTE;1;0;1;1
2019-11-13 09:42:27;NORTE;1;0;1;1
2019-11-13 09:43:03;NORTE;1;0;1;1
2019-11-13 09:43:09;NORTE;1;0;1;1
2019-11-13 09:44:47;NORTE;1;0;1;1
2019-11-13 09:44:48;NORTE;1;0;1;1
2019-11-13 09:44:56;NORTE;1;0;1;1
2019-11-13 09:47:15;NORTE;1;0;1;1
2019-11-13 09:47:40;NORTE;1;0;1;1
2019-11-13 09:48:44;NORTE;1;0;1;1
2019-11-13 09:50:12;NORTE;1;0;1;1
2019-11-13 09:51:18;NORTE;1;0;1;1
2019-11-13 09:52:37;NORTE;1;0;1;1
2019-11-13 09:54:33;NORTE;1;0;1;1
2019-11-13 09:55:17;NORTE;1;0;1;1
2019-11-13 09:56:27;NORTE;1;0;1;1
2019-11-13 09:56:58;NORTE;1;0;1;1
2019-11-13 09:57:23;NORTE;1;0;1;1
2019-11-13 09:58:08;NORTE;1;0;1;1
2019-11-13 09:58:21;NORTE;1;0;1;1
2019-11-13 09:58:59;NORTE;1;0;1;1
2019-11-13 09:59:12;NORTE;1;0;1;1
2019-11-13 10:01:34;NORTE;1;0;1;1
2019-11-13 10:01:36;NORTE;1;0;1;1
2019-11-13 10:01:58;NORTE;1;0;1;1
2019-11-13 10:02:01;NORTE;1;0;1;1
2019-11-13 10:03:31;NORTE;1;0;1;1
2019-11-13 10:03:42;NORTE;1;0;1;1
2019-11-13 10:04:22;NORTE;1;0;1;1
2019-11-13 10:07:15;NORTE;1;0;1;1
2019-11-13 10:09:45;NORTE;1;0;1;1
2019-11-13 10:10:59;NORTE;1;0;1;1
2019-11-13 10:11:29;NORTE;1;0;1;1
2019-11-13 10:13:47;NORTE;1;0;1;1
2019-11-13 10:13:51;NORTE;1;0;1;1
2019-11-13 10:15:29;NORTE;1;0;1;1
2019-11-13 10:17:11;NORTE;1;0;1;1
2019-11-13 10:18:19;NORTE;1;0;1;1
2019-11-13 10:18:58;NORTE;1;0;1;1
2019-11-13 10:19:48;NORTE;1;0;1;1
2019-11-13 10:21:53;NORTE;1;0;1;1
2019-11-13 10:22:57;NORTE;1;0;1;1
2019-11-13 10:24:22;NORTE;1;0;1;1
2019-11-13 10:25:25;NORTE;1;0;1;1
2019-11-13 10:26:56;NORTE;1;0;1;1
2019-11-13 10:27:39;NORTE;1;0;1;1
2019-11-13 10:29:20;NORTE;1;0;1;1
2019-11-13 10:29:56;NORTE;1;0;1;1
2019-11-13 10:32:35;NORTE;1;0;1;1
2019-11-13 10:32:55;NORTE;1;0;1;1
2019-11-13 10:33:59;NORTE;1;0;1;1
2019-11-13 10:34:43;NORTE;1;0;1;1
2019-11-13 10:36:27;NORTE;1;0;1;1
2019-11-13 10:36:28;NORTE;1;0;1;1
2019-11-13 10:36:41;NORTE;1;0;1;1
2019-11-13 10:37:37;NORTE;1;0;1;1
2019-11-13 10:38:34;NORTE;1;0;1;1
2019-11-13 10:38:48;NORTE;1;0;1;1
2019-11-13 10:39:52;NORTE;1;0;1;1
2019-11-13 10:40:54;NORTE;1;0;1;1
2019-11-13 10:41:01;NORTE;1;0;1;1
2019-11-13 10:42:15;NORTE;1;0;1;1
2019-11-13 10:42:31;NORTE;1;0;1;1
2019-11-13 10:44:04;NORTE;2;0;2;1
2019-11-13 10:47:06;NORTE;1;0;1;1
2019-11-13 10:47:13;NORTE;1;0;1;1
2019-11-13 10:47:53;NORTE;1;0;1;1
2019-11-13 10:49:03;NORTE;1;0;1;1
2019-11-13 10:51:10;NORTE;1;0;1;1
2019-11-13 10:51:16;NORTE;1;0;1;1
2019-11-13 10:51:32;NORTE;1;0;1;1
2019-11-13 10:52:28;NORTE;1;0;1;1
2019-11-13 10:52:52;NORTE;1;0;1;1
2019-11-13 10:54:36;NORTE;1;0;1;1
2019-11-13 10:56:55;NORTE;1;0;1;1
2019-11-13 10:58:37;NORTE;1;0;1;1
2019-11-13 10:58:48;NORTE;1;0;1;1
2019-11-13 11:00:55;NORTE;2;0;2;1
2019-11-13 11:01:26;NORTE;1;0;1;1
2019-11-13 11:01:53;NORTE;1;0;1;1
2019-11-13 11:02:54;NORTE;1;0;1;1
2019-11-13 11:03:20;NORTE;1;0;1;1
2019-11-13 11:03:40;NORTE;1;0;1;1
2019-11-13 11:05:05;NORTE;1;0;1;1
2019-11-13 11:05:55;NORTE;1;0;1;1
2019-11-13 11:06:10;NORTE;1;0;1;1
2019-11-13 11:07:30;NORTE;1;0;1;1
2019-11-13 11:08:02;NORTE;1;0;1;1
2019-11-13 11:09:02;NORTE;1;0;1;1
2019-11-13 11:09:35;NORTE;1;0;1;1
2019-11-13 11:10:28;NORTE;1;0;1;1
2019-11-13 11:10:50;NORTE;1;0;1;1
2019-11-13 11:11:34;NORTE;1;0;1;1
2019-11-13 11:12:07;NORTE;1;0;1;1
2019-11-13 11:12:17;NORTE;1;0;1;1
2019-11-13 11:13:46;NORTE;1;0;1;1
2019-11-13 11:14:08;NORTE;1;0;1;1
2019-11-13 11:14:16;NORTE;1;0;1;1
2019-11-13 11:15:11;NORTE;1;0;1;1
2019-11-13 11:15:45;NORTE;1;0;1;1
2019-11-13 11:16:33;NORTE;1;0;1;1
2019-11-13 11:16:52;NORTE;1;0;1;1
2019-11-13 11:17:51;NORTE;1;0;1;1
2019-11-13 11:17:52;NORTE;1;0;1;1
2019-11-13 11:19:26;NORTE;1;0;1;1
2019-11-13 11:19:28;NORTE;1;0;1;1
2019-11-13 11:20:27;NORTE;1;0;1;1
2019-11-13 11:21:03;NORTE;1;0;1;1
2019-11-13 11:21:30;NORTE;1;0;1;1
2019-11-13 11:22:53;NORTE;1;0;1;1
2019-11-13 11:24:21;NORTE;1;0;1;1
2019-11-13 11:24:32;NORTE;1;0;1;1
2019-11-13 11:27:19;NORTE;1;0;1;1
2019-11-13 11:30:35;NORTE;1;0;1;1
2019-11-13 11:33:14;NORTE;1;0;1;1
2019-11-13 11:34:05;NORTE;1;0;1;1
2019-11-13 11:34:24;NORTE;1;0;1;1
2019-11-13 11:35:41;NORTE;1;0;1;1
2019-11-13 11:35:43;NORTE;1;0;1;1
2019-11-13 11:37:14;NORTE;1;0;1;1
2019-11-13 11:37:25;NORTE;1;0;1;1
2019-11-13 11:37:55;NORTE;1;0;1;1
2019-11-13 11:40:01;NORTE;1;0;1;1
2019-11-13 11:40:11;NORTE;1;0;1;1
2019-11-13 11:41:57;NORTE;1;0;1;1
2019-11-13 11:42:18;NORTE;1;0;1;1
2019-11-13 11:42:53;NORTE;1;0;1;1
2019-11-13 11:43:06;NORTE;1;0;1;1
2019-11-13 11:43:49;NORTE;1;0;1;1
2019-11-13 11:43:55;NORTE;1;0;1;1
2019-11-13 11:44:36;NORTE;1;0;1;1
2019-11-13 11:44:47;NORTE;1;0;1;1
2019-11-13 11:46:40;NORTE;1;0;1;1
2019-11-13 11:48:03;NORTE;1;0;1;1
2019-11-13 11:49:16;NORTE;1;0;1;1
2019-11-13 11:50:43;NORTE;1;0;1;1
2019-11-13 11:51:48;NORTE;1;0;1;1
2019-11-13 11:52:17;NORTE;1;0;1;1
2019-11-13 11:52:44;NORTE;1;0;1;1
2019-11-13 11:53:38;NORTE;1;0;1;1
2019-11-13 11:55:39;NORTE;1;0;1;1
2019-11-13 11:57:09;NORTE;1;0;1;1
2019-11-13 11:58:25;NORTE;1;0;1;1
2019-11-13 11:59:35;NORTE;1;0;1;1
2019-11-13 12:00:00;NORTE;20;0;20;1
2019-11-13 12:30:00;NORTE;30;0;30;1
2019-11-13 13:00:00;NORTE;24;0;24;1
2019-11-13 13:30:00;NORTE;36;0;36;1
2019-11-13 14:00:00;NORTE;35;0;35;1
2019-11-13 14:30:00;NORTE;29;0;29;1
2019-11-13 15:00:00;NORTE;34;0;34;1
2019-11-13 15:30:00;NORTE;30;0;30;1
2019-11-13 16:00:00;NORTE;24;0;24;1
2019-11-13 16:30:00;NORTE;21;0;21;1
2019-11-13 17:00:00;NORTE;16;0;16;1
2019-11-13 17:30:00;NORTE;36;0;36;1
2019-11-13 18:00:00;NORTE;21;0;21;1
2019-11-13 18:30:00;NORTE;25;0;25;1
2019-11-13 19:00:00;NORTE;34;0;34;1
2019-11-13 19:30:00;NORTE;24;0;24;1
2019-11-13 20:00:00;NORTE;27;0;27;1
2019-11-13 20:30:00;NORTE;29;0;29;1
2019-11-13 21:00:00;NORTE;29;0;29;1
2019-11-13 21:30:00;NORTE;24;0;24;1
2019-11-13 22:00:00;NORTE;10;0;10;1
2019-11-13 22:30:00;NORTE;9;0;9;1
2019-11-13 23:00:00;NORTE;11;0;11;1
2019-11-13 23:30:00;NORTE;4;0;4;1
2019-11-14 00:00:00;NORTE;2;0;2;1
2019-11-14 00:30:00;NORTE;2;0;2;1
2019-11-14 01:00:00;NORTE;2;0;2;1
2019-11-14 01:30:00;NORTE;1;0;1;1
2019-11-14 02:30:00;NORTE;1;0;1;1
2019-11-14 03:00:00;NORTE;7;0;7;1
2019-11-14 03:30:00;NORTE;2;0;2;1
2019-11-14 04:11:10;SUR;0;1;1;1
2019-11-14 04:16:24;SUR;0;1;1;1
2019-11-14 04:29:32;SUR;0;1;1;1
2019-11-14 04:31:22;SUR;0;1;1;1
2019-11-14 04:33:04;SUR;0;1;1;1
2019-11-14 04:34:59;SUR;0;1;1;1
2019-11-14 04:36:12;SUR;0;1;1;1
2019-11-14 04:40:00;SUR;0;1;1;1
2019-11-14 04:42:00;SUR;0;1;1;1
2019-11-14 04:43:59;SUR;0;1;1;1
2019-11-14 04:49:48;SUR;0;1;1;1
2019-11-14 05:00:00;SUR;0;12;12;1
2019-11-14 05:30:00;SUR;0;15;15;1
2019-11-14 06:00:00;CONFLICTIVA;3;16;19;2
2019-11-14 06:30:00;NORTE;34;0;34;1
2019-11-14 07:00:00;NORTE;31;0;31;1
2019-11-14 07:30:00;NORTE;23;0;23;1
2019-11-14 08:00:00;NORTE;36;0;36;1
2019-11-14 08:30:00;NORTE;27;0;27;1
2019-11-14 09:00:00;NORTE;34;0;34;1
2019-11-14 09:30:00;NORTE;37;0;37;1
2019-11-14 10:00:00;NORTE;26;0;26;1
2019-11-14 10:30:00;NORTE;28;0;28;1
2019-11-14 11:00:00;NORTE;41;0;41;1
2019-11-14 11:30:00;NORTE;39;0;39;1
2019-11-14 12:00:00;NORTE;27;0;27;1
2019-11-14 12:30:00;NORTE;32;0;32;1
2019-11-14 13:00:00;NORTE;22;0;22;1
2019-11-14 13:30:00;NORTE;33;0;33;1
2019-11-14 14:00:00;NORTE;33;0;33;1
2019-11-14 14:30:00;NORTE;29;0;29;1
2019-11-14 15:00:00;NORTE;37;0;37;1
2019-11-14 15:30:00;NORTE;20;0;20;1
2019-11-14 15:46:00;NORTE;12;0;12;1
2019-11-14 16:00:00;NORTE;29;0;29;1
2019-11-14 16:30:00;NORTE;23;0;23;1
2019-11-14 17:00:00;NORTE;20;0;20;1
2019-11-14 17:30:00;NORTE;35;0;35;1
2019-11-14 18:00:00;NORTE;32;0;32;1
2019-11-14 18:30:00;NORTE;29;0;29;1
2019-11-14 19:00:00;NORTE;40;0;40;1
2019-11-14 19:30:00;NORTE;35;0;35;1
2019-11-14 20:00:00;NORTE;36;0;36;1
2019-11-14 20:30:00;NORTE;31;0;31;1
2019-11-14 21:00:00;NORTE;26;0;26;1
2019-11-14 21:30:00;NORTE;28;0;28;1
2019-11-14 22:00:00;NORTE;14;0;14;1
2019-11-14 22:30:00;NORTE;11;0;11;1
2019-11-14 23:00:00;NORTE;14;0;14;1
2019-11-14 23:30:00;NORTE;5;0;5;1
2019-11-15 00:00:00;NORTE;1;0;1;1
2019-11-15 00:30:00;NORTE;1;0;1;1
2019-11-15 01:00:00;NORTE;2;0;2;1
2019-11-15 02:00:00;NORTE;2;0;2;1
2019-11-15 02:30:00;NORTE;1;0;1;1
2019-11-15 03:00:00;NORTE;7;0;7;1
2019-11-15 03:30:00;NORTE;6;0;6;1
2019-11-15 04:00:00;NORTE;5;0;5;1
2019-11-15 04:30:00;NORTE;11;0;11;1
2019-11-15 05:00:00;CONFLICTIVA;9;1;10;2
2019-11-15 05:30:00;NORTE;13;0;13;1
2019-11-15 06:00:00;NORTE;27;0;27;1
2019-11-15 06:30:00;NORTE;39;0;39;1
2019-11-15 07:00:00;NORTE;24;0;24;1
2019-11-15 07:30:00;NORTE;22;0;22;1
2019-11-15 08:00:00;NORTE;35;0;35;1
2019-11-15 08:30:00;NORTE;36;0;36;1
2019-11-15 09:00:00;NORTE;33;0;33;1
2019-11-15 09:30:00;NORTE;39;0;39;1
2019-11-15 10:00:00;NORTE;31;0;31;1
2019-11-15 10:30:00;NORTE;38;0;38;1
2019-11-15 11:00:00;NORTE;33;0;33;1
2019-11-15 11:30:00;NORTE;33;0;33;1
2019-11-15 12:00:00;NORTE;27;0;27;1
2019-11-15 12:30:00;NORTE;28;0;28;1
2019-11-15 13:00:00;NORTE;34;0;34;1
2019-11-15 13:30:00;NORTE;30;0;30;1
2019-11-15 14:00:00;NORTE;40;0;40;1
2019-11-15 14:30:00;NORTE;32;0;32;1
2019-11-15 15:00:00;NORTE;37;0;37;1
2019-11-15 15:30:00;NORTE;30;0;30;1
2019-11-15 16:00:00;NORTE;33;0;33;1
2019-11-15 16:30:00;NORTE;30;0;30;1
2019-11-15 17:00:00;NORTE;22;0;22;1
2019-11-15 17:30:00;NORTE;40;0;40;1
2019-11-15 18:00:00;NORTE;23;0;23;1
2019-11-15 18:30:00;NORTE;29;0;29;1
2019-11-15 19:00:00;NORTE;36;0;36;1
2019-11-15 19:30:00;NORTE;31;0;31;1
2019-11-15 20:00:00;NORTE;29;0;29;1
2019-11-15 20:30:00;NORTE;34;0;34;1
2019-11-15 21:00:00;NORTE;30;0;30;1
2019-11-15 21:30:00;NORTE;25;0;25;1
2019-11-15 22:00:00;NORTE;19;0;19;1
2019-11-15 22:30:00;NORTE;13;0;13;1
2019-11-15 23:00:00;NORTE;12;0;12;1
2019-11-15 23:30:00;NORTE;6;0;6;1
2019-11-16 00:00:00;NORTE;4;0;4;1
2019-11-16 00:30:00;NORTE;2;0;2;1
2019-11-16 01:00:00;NORTE;1;0;1;1
2019-11-16 02:30:00;NORTE;2;0;2;1
2019-11-16 03:00:00;NORTE;4;0;4;1
2019-11-16 03:30:00;NORTE;6;0;6;1
2019-11-16 04:00:00;NORTE;2;0;2;1
2019-11-16 04:30:00;NORTE;4;0;4;1
2019-11-16 05:00:00;NORTE;9;0;9;1
2019-11-16 05:30:00;NORTE;18;0;18;1
2019-11-16 06:00:00;NORTE;20;0;20;1
2019-11-16 06:30:00;NORTE;31;0;31;1
2019-11-16 07:00:00;NORTE;18;0;18;1
2019-11-16 07:30:00;NORTE;24;0;24;1
2019-11-16 08:00:00;NORTE;38;0;38;1
2019-11-16 08:30:00;NORTE;28;0;28;1
2019-11-16 09:00:00;NORTE;35;0;35;1
2019-11-16 09:30:00;NORTE;35;0;35;1
2019-11-16 10:00:00;NORTE;27;0;27;1
2019-11-16 10:30:00;NORTE;41;0;41;1
2019-11-16 11:00:00;NORTE;28;0;28;1
2019-11-16 11:30:00;NORTE;36;0;36;1
2019-11-16 12:00:00;NORTE;30;0;30;1
2019-11-16 12:30:00;NORTE;29;0;29;1
2019-11-16 13:00:00;NORTE;23;0;23;1
2019-11-16 13:30:00;NORTE;29;0;29;1
2019-11-16 14:00:00;NORTE;36;0;36;1
2019-11-16 14:30:00;NORTE;27;0;27;1
2019-11-16 15:00:00;NORTE;38;0;38;1
2019-11-16 15:30:00;NORTE;23;0;23;1
2019-11-16 16:00:00;NORTE;23;0;23;1
2019-11-16 16:30:00;NORTE;10;0;10;1
2019-11-16 17:00:00;NORTE;21;0;21;1
2019-11-16 17:30:00;NORTE;31;0;31;1
2019-11-16 18:00:00;NORTE;16;0;16;1
2019-11-16 18:30:00;NORTE;16;0;16;1
2019-11-16 19:00:00;NORTE;33;0;33;1
2019-11-16 19:30:00;NORTE;18;0;18;1
2019-11-16 20:00:00;NORTE;21;0;21;1
2019-11-16 20:30:00;NORTE;22;0;22;1
2019-11-16 21:00:00;NORTE;20;0;20;1
2019-11-16 21:30:00;NORTE;13;0;13;1
2019-11-16 22:00:00;NORTE;9;0;9;1
2019-11-16 22:30:00;NORTE;3;0;3;1
2019-11-16 23:00:00;NORTE;12;0;12;1
2019-11-16 23:30:00;NORTE;6;0;6;1
2019-11-17 00:00:00;NORTE;1;0;1;1
2019-11-17 00:30:00;NORTE;2;0;2;1
2019-11-17 01:00:00;NORTE;1;0;1;1
2019-11-17 01:30:00;NORTE;2;0;2;1
2019-11-17 02:00:00;NORTE;1;0;1;1
2019-11-17 02:30:00;NORTE;1;0;1;1
2019-11-17 03:00:00;NORTE;2;0;2;1
2019-11-17 03:30:00;NORTE;1;0;1;1
2019-11-17 04:00:00;NORTE;4;0;4;1
2019-11-17 04:30:00;NORTE;2;0;2;1
2019-11-17 05:00:00;NORTE;7;0;7;1
2019-11-17 05:30:00;NORTE;16;0;16;1
2019-11-17 06:00:00;NORTE;20;0;20;1
2019-11-17 06:30:00;NORTE;21;0;21;1
2019-11-17 07:00:00;NORTE;19;0;19;1
2019-11-17 07:30:00;NORTE;26;0;26;1
2019-11-17 08:00:00;NORTE;32;0;32;1
2019-11-17 08:30:00;NORTE;28;0;28;1
2019-11-17 09:00:00;CONFLICTIVA;25;3;28;2
2019-11-17 09:30:00;SUR;0;46;46;1
2019-11-17 10:00:00;SUR;0;29;29;1
2019-11-17 10:30:00;SUR;0;31;31;1
2019-11-17 11:00:00;SUR;0;37;37;1
2019-11-17 11:30:00;SUR;0;38;38;1
2019-11-17 12:00:00;SUR;0;29;29;1
2019-11-17 12:30:00;SUR;0;33;33;1
2019-11-17 13:00:00;SUR;0;27;27;1
2019-11-17 13:30:00;SUR;0;35;35;1
2019-11-17 14:00:00;SUR;0;42;42;1
2019-11-17 14:30:00;SUR;0;39;39;1
2019-11-17 15:00:00;SUR;0;20;20;1
2019-11-17 15:14:00;SUR;0;22;22;1
2019-11-17 15:30:00;SUR;0;35;35;1
2019-11-17 16:00:00;SUR;0;25;25;1
2019-11-17 16:30:00;SUR;0;16;16;1
2019-11-17 17:00:00;SUR;0;26;26;1
2019-11-17 17:30:00;SUR;0;6;6;1
2019-11-17 17:38:00;SUR;0;22;22;1
2019-11-17 18:00:00;SUR;0;23;23;1
2019-11-17 18:30:00;SUR;0;11;11;1
2019-11-17 18:42:00;SUR;0;21;21;1
2019-11-17 19:00:00;SUR;0;46;46;1
2019-11-17 19:30:00;SUR;0;27;27;1
2019-11-17 20:00:00;NORTE;24;2;26;1
2019-11-17 20:30:00;NORTE;36;0;36;1
2019-11-17 21:00:00;NORTE;28;0;28;1
2019-11-17 21:30:00;NORTE;30;0;30;1
2019-11-17 22:00:00;NORTE;15;0;15;1
2019-11-17 22:30:00;NORTE;13;0;13;1
2019-11-17 23:00:00;NORTE;16;0;16;1
2019-11-17 23:30:00;NORTE;3;0;3;1
2019-11-18 00:00:00;NORTE;2;0;2;1
2019-11-18 01:00:00;NORTE;1;0;1;1
2019-11-18 02:30:00;NORTE;1;0;1;1
2019-11-18 03:00:00;NORTE;7;0;7;1
2019-11-18 03:30:00;NORTE;3;0;3;1
2019-11-18 04:00:00;NORTE;1;0;1;1
2019-11-18 04:30:00;NORTE;3;0;3;1
2019-11-18 05:00:00;NORTE;9;0;9;1
2019-11-18 05:30:00;NORTE;17;0;17;1
2019-11-18 06:00:00;NORTE;20;0;20;1
2019-11-18 06:30:00;NORTE;43;0;43;1
2019-11-18 07:00:00;NORTE;26;0;26;1
2019-11-18 07:30:00;NORTE;28;0;28;1
2019-11-18 08:00:00;NORTE;37;0;37;1
2019-11-18 08:30:00;NORTE;28;0;28;1
2019-11-18 09:00:00;NORTE;34;0;34;1
2019-11-18 09:30:00;NORTE;37;0;37;1
2019-11-18 10:00:00;NORTE;33;0;33;1
2019-11-18 10:30:00;NORTE;35;0;35;1
2019-11-18 11:00:00;NORTE;38;0;38;1
2019-11-18 11:30:00;NORTE;31;0;31;1
2019-11-18 12:00:00;NORTE;33;0;33;1
2019-11-18 12:30:00;NORTE;28;0;28;1
2019-11-18 13:00:00;NORTE;31;0;31;1
2019-11-18 13:30:00;NORTE;38;0;38;1
2019-11-18 14:00:00;NORTE;41;0;41;1
2019-11-18 14:30:00;NORTE;28;0;28;1
2019-11-18 15:00:00;NORTE;43;0;43;1
2019-11-18 15:30:00;NORTE;28;0;28;1
2019-11-18 16:00:00;NORTE;34;0;34;1
2019-11-18 16:30:00;NORTE;15;0;15;1
2019-11-18 17:00:00;NORTE;25;0;25;1
2019-11-18 17:30:00;NORTE;37;0;37;1
2019-11-18 18:00:00;NORTE;20;0;20;1
2019-11-18 18:30:00;NORTE;31;0;31;1
2019-11-18 19:00:00;NORTE;36;0;36;1
2019-11-18 19:30:00;NORTE;32;0;32;1
2019-11-18 20:00:00;NORTE;22;0;22;1
2019-11-18 20:30:00;NORTE;25;0;25;1
2019-11-18 21:00:00;NORTE;28;0;28;1
2019-11-18 21:30:00;NORTE;22;0;22;1
2019-11-18 22:00:00;NORTE;16;0;16;1
2019-11-18 22:30:00;NORTE;6;0;6;1
2019-11-18 23:00:00;NORTE;12;0;12;1
2019-11-18 23:30:00;NORTE;4;0;4;1
2019-11-19 00:00:00;NORTE;2;0;2;1
2019-11-19 00:30:00;NORTE;3;0;3;1
2019-11-19 01:00:00;NORTE;2;0;2;1
2019-11-19 01:30:00;NORTE;2;0;2;1
2019-11-19 02:30:00;NORTE;1;0;1;1
2019-11-19 03:00:00;NORTE;4;0;4;1
2019-11-19 03:30:00;NORTE;6;0;6;1
2019-11-19 04:00:00;NORTE;3;0;3;1
2019-11-19 04:30:00;NORTE;7;0;7;1
2019-11-19 05:00:00;NORTE;8;0;8;1
2019-11-19 05:30:00;NORTE;13;0;13;1
2019-11-19 06:00:00;NORTE;15;0;15;1
2019-11-19 06:30:00;NORTE;37;0;37;1
2019-11-19 07:00:00;NORTE;25;0;25;1
2019-11-19 07:30:00;NORTE;27;0;27;1
2019-11-19 08:00:00;NORTE;30;0;30;1
2019-11-19 08:30:00;NORTE;28;0;28;1
2019-11-19 09:00:00;NORTE;35;0;35;1
2019-11-19 09:30:00;NORTE;30;0;30;1
2019-11-19 10:00:00;NORTE;30;0;30;1
2019-11-19 10:30:00;NORTE;29;0;29;1
2019-11-19 11:00:00;NORTE;32;0;32;1
2019-11-19 11:30:00;NORTE;33;0;33;1
2019-11-19 12:00:00;NORTE;24;0;24;1
2019-11-19 12:30:00;NORTE;26;0;26;1
2019-11-19 13:00:00;NORTE;20;0;20;1
2019-11-19 13:30:00;NORTE;34;1;35;1
2019-11-19 14:00:00;CONFLICTIVA;14;7;21;2
2019-11-19 14:30:00;SUR;0;36;36;1
2019-11-19 15:00:00;SUR;0;33;33;1
2019-11-19 15:30:00;SUR;0;28;28;1
2019-11-19 16:00:00;SUR;0;30;30;1
2019-11-19 16:30:00;SUR;0;20;20;1
2019-11-19 17:00:00;CONFLICTIVA;20;3;23;2
2019-11-19 17:30:00;NORTE;36;0;36;1
2019-11-19 18:00:00;NORTE;24;0;24;1
2019-11-19 18:30:00;NORTE;22;0;22;1
2019-11-19 19:00:00;NORTE;37;0;37;1
2019-11-19 19:30:00;NORTE;26;0;26;1
2019-11-19 20:00:00;NORTE;20;0;20;1
2019-11-19 20:30:00;NORTE;18;0;18;1
2019-11-19 21:00:00;NORTE;28;0;28;1
2019-11-19 21:30:00;NORTE;21;0;21;1
2019-11-19 22:00:00;NORTE;10;0;10;1
2019-11-19 22:30:00;NORTE;4;0;4;1
2019-11-19 23:00:00;NORTE;12;0;12;1
2019-11-19 23:30:00;NORTE;4;0;4;1
2019-11-20 00:00:00;NORTE;1;0;1;1
2019-11-20 00:30:00;NORTE;1;0;1;1
2019-11-20 02:00:00;NORTE;1;0;1;1
2019-11-20 02:30:00;NORTE;1;0;1;1
2019-11-20 03:00:00;NORTE;5;0;5;1
2019-11-20 03:30:00;NORTE;1;0;1;1
2019-11-20 04:00:00;NORTE;3;0;3;1
2019-11-20 04:30:00;NORTE;12;0;12;1
2019-11-20 05:00:00;NORTE;5;0;5;1
2019-11-20 05:30:00;NORTE;16;0;16;1
2019-11-20 06:00:00;NORTE;13;0;13;1
2019-11-20 06:30:00;NORTE;35;0;35;1
2019-11-20 07:00:00;NORTE;29;0;29;1
2019-11-20 07:30:00;NORTE;27;0;27;1
2019-11-20 08:00:00;NORTE;26;0;26;1
2019-11-20 08:30:00;NORTE;30;0;30;1
2019-11-20 09:00:00;NORTE;37;0;37;1
2019-11-20 09:30:00;NORTE;33;0;33;1
2019-11-20 10:00:00;NORTE;24;0;24;1
2019-11-20 10:30:00;NORTE;35;0;35;1
2019-11-20 11:00:00;NORTE;31;0;31;1
2019-11-20 11:30:00;NORTE;28;0;28;1
2019-11-20 12:00:00;NORTE;25;0;25;1
2019-11-20 12:30:00;NORTE;33;0;33;1
2019-11-20 13:00:00;NORTE;22;0;22;1
2019-11-20 13:30:00;NORTE;32;0;32;1
2019-11-20 14:00:00;NORTE;40;0;40;1
2019-11-20 14:30:00;NORTE;28;0;28;1
2019-11-20 15:00:00;NORTE;36;0;36;1
2019-11-20 15:30:00;NORTE;32;0;32;1
2019-11-20 16:00:00;NORTE;32;0;32;1
2019-11-20 16:30:00;NORTE;15;0;15;1
2019-11-20 17:00:00;NORTE;17;0;17;1
2019-11-20 17:30:00;NORTE;26;0;26;1
2019-11-20 18:00:00;NORTE;25;0;25;1
2019-11-20 18:30:00;NORTE;23;0;23;1
2019-11-20 19:00:00;NORTE;36;0;36;1
2019-11-20 19:30:00;NORTE;24;0;24;1
2019-11-20 20:00:00;NORTE;29;0;29;1
2019-11-20 20:30:00;NORTE;25;0;25;1
2019-11-20 21:00:00;NORTE;32;0;32;1
2019-11-20 21:30:00;NORTE;29;0;29;1
2019-11-20 22:00:00;NORTE;10;0;10;1
2019-11-20 22:30:00;NORTE;4;0;4;1
2019-11-20 23:00:00;NORTE;15;0;15;1
2019-11-20 23:30:00;NORTE;4;0;4;1
2019-11-21 00:00:00;NORTE;3;0;3;1
2019-11-21 00:30:00;NORTE;1;0;1;1
2019-11-21 01:30:00;NORTE;1;0;1;1
2019-11-21 02:12:00;NORTE;1;0;1;1
2019-11-21 03:00:00;NORTE;4;0;4;1
2019-11-21 03:30:00;NORTE;4;0;4;1
2019-11-21 04:00:00;NORTE;4;0;4;1
2019-11-21 04:30:00;NORTE;5;0;5;1
2019-11-21 04:41:00;NORTE;5;0;5;1
2019-11-21 05:00:00;NORTE;9;0;9;1
2019-11-21 05:30:00;NORTE;13;0;13;1
2019-11-21 06:00:00;NORTE;23;0;23;1
2019-11-21 06:30:00;NORTE;34;0;34;1
2019-11-21 07:00:00;NORTE;10;0;10;1
2019-11-21 07:17:00;NORTE;14;0;14;1
2019-11-21 07:30:00;NORTE;21;0;21;1
2019-11-21 08:00:00;NORTE;31;0;31;1
2019-11-21 08:30:00;NORTE;32;0;32;1
2019-11-21 09:00:00;NORTE;34;0;34;1
2019-11-21 09:30:00;NORTE;36;0;36;1
2019-11-21 10:00:00;NORTE;25;0;25;1
2019-11-21 10:30:00;NORTE;35;0;35;1
2019-11-21 11:00:00;NORTE;31;0;31;1
2019-11-21 11:30:00;NORTE;41;0;41;1
2019-11-21 12:00:00;NORTE;34;0;34;1
2019-11-21 12:30:00;NORTE;23;0;23;1
2019-11-21 13:00:00;NORTE;25;0;25;1
2019-11-21 13:30:00;NORTE;33;0;33;1
2019-11-21 14:00:00;NORTE;32;0;32;1
2019-11-21 14:30:00;NORTE;27;0;27;1
2019-11-21 15:00:00;NORTE;41;0;41;1
2019-11-21 15:30:00;NORTE;32;0;32;1
2019-11-21 16:00:00;NORTE;26;0;26;1
2019-11-21 16:30:00;NORTE;23;0;23;1
2019-11-21 17:00:00;NORTE;18;0;18;1
2019-11-21 17:30:00;NORTE;35;0;35;1
2019-11-21 18:00:00;NORTE;26;0;26;1
2019-11-21 18:30:00;NORTE;27;0;27;1
2019-11-21 19:00:00;NORTE;42;0;42;1
2019-11-21 19:30:00;NORTE;30;0;30;1
2019-11-21 20:00:00;NORTE;28;0;28;1
2019-11-21 20:30:00;NORTE;36;0;36;1
2019-11-21 21:00:00;NORTE;22;0;22;1
2019-11-21 21:30:00;NORTE;27;0;27;1
2019-11-21 22:00:00;NORTE;11;0;11;1
2019-11-21 22:30:00;NORTE;12;0;12;1
2019-11-21 23:00:00;NORTE;11;0;11;1
2019-11-21 23:30:00;NORTE;4;0;4;1
2019-11-22 01:00:00;NORTE;2;0;2;1
2019-11-22 02:00:00;NORTE;1;0;1;1
2019-11-22 02:30:00;NORTE;1;0;1;1
2019-11-22 03:00:00;NORTE;4;0;4;1
2019-11-22 03:30:00;NORTE;5;0;5;1
2019-11-22 04:00:00;NORTE;4;0;4;1
2019-11-22 04:30:00;NORTE;9;0;9;1
2019-11-22 05:00:00;CONFLICTIVA;5;4;9;2
2019-11-22 05:30:00;SUR;0;15;15;1
2019-11-22 06:00:00;SUR;0;21;21;1
2019-11-22 06:30:00;SUR;0;38;38;1
2019-11-22 07:00:00;SUR;0;18;18;1
2019-11-22 07:30:00;SUR;0;25;25;1
2019-11-22 08:00:00;SUR;0;32;32;1
2019-11-22 08:30:00;SUR;0;28;28;1
2019-11-22 09:00:00;SUR;0;32;32;1
2019-11-22 09:30:00;SUR;0;38;38;1
2019-11-22 10:00:00;SUR;0;34;34;1
2019-11-22 10:30:00;SUR;0;41;41;1
2019-11-22 11:00:00;SUR;0;31;31;1
2019-11-22 11:30:00;SUR;0;31;31;1
2019-11-22 12:00:00;SUR;0;29;29;1
2019-11-22 12:30:39;SUR;0;1;1;1
2019-11-22 12:30:56;SUR;0;1;1;1
2019-11-22 12:32:00;SUR;0;27;27;1
2019-11-22 13:00:00;SUR;0;31;31;1
2019-11-22 13:30:00;SUR;0;31;31;1
2019-11-22 14:00:00;SUR;0;28;28;1
2019-11-22 14:30:00;SUR;0;41;41;1
2019-11-22 15:00:00;SUR;0;39;39;1
2019-11-22 15:30:00;SUR;0;29;29;1
2019-11-22 16:00:00;SUR;0;33;33;1
2019-11-22 16:30:00;SUR;0;31;31;1
2019-11-22 17:00:00;SUR;0;14;14;1
2019-11-22 17:30:00;SUR;0;33;33;1
2019-11-22 18:00:00;SUR;0;27;27;1
2019-11-22 18:30:00;SUR;0;31;31;1
2019-11-22 19:00:00;SUR;0;38;38;1
2019-11-22 19:30:00;SUR;0;29;29;1
2019-11-22 20:00:00;SUR;0;36;36;1
2019-11-22 20:30:00;SUR;0;31;31;1
2019-11-22 21:00:00;SUR;0;29;29;1
2019-11-22 21:30:00;SUR;0;28;28;1
2019-11-22 22:00:00;SUR;0;18;18;1
2019-11-22 22:30:00;SUR;0;13;13;1
2019-11-22 23:00:00;SUR;0;16;16;1
2019-11-22 23:30:00;SUR;0;5;5;1
2019-11-23 00:00:00;SUR;0;2;2;1
2019-11-23 00:30:00;SUR;0;2;2;1
2019-11-23 01:00:00;SUR;0;2;2;1
2019-11-23 02:00:00;SUR;0;2;2;1
2019-11-23 03:00:00;SUR;0;4;4;1
2019-11-23 03:30:00;SUR;0;5;5;1
2019-11-23 04:00:00;SUR;0;1;1;1
2019-11-23 04:30:00;SUR;0;5;5;1
2019-11-23 05:00:00;SUR;0;11;11;1
2019-11-23 05:30:00;SUR;0;12;12;1
2019-11-23 06:00:00;CONFLICTIVA;2;12;14;2
2019-11-23 06:30:00;NORTE;36;0;36;1
2019-11-23 07:00:00;NORTE;20;0;20;1
2019-11-23 07:30:00;NORTE;23;0;23;1
2019-11-23 08:00:00;NORTE;33;0;33;1
2019-11-23 08:30:00;NORTE;25;0;25;1
2019-11-23 09:00:00;NORTE;37;0;37;1
2019-11-23 09:30:00;NORTE;36;0;36;1
2019-11-23 10:00:00;NORTE;29;0;29;1
2019-11-23 10:30:00;NORTE;41;0;41;1
2019-11-23 11:00:00;NORTE;29;0;29;1
2019-11-23 11:30:00;NORTE;31;0;31;1
2019-11-23 12:00:00;NORTE;30;0;30;1
2019-11-23 12:30:00;NORTE;30;0;30;1
2019-11-23 13:00:00;NORTE;29;0;29;1
2019-11-23 13:30:00;NORTE;28;0;28;1
2019-11-23 14:00:00;NORTE;28;0;28;1
2019-11-23 14:30:00;NORTE;32;0;32;1
2019-11-23 15:00:00;NORTE;32;0;32;1
2019-11-23 15:30:00;NORTE;27;0;27;1
2019-11-23 16:00:00;NORTE;20;0;20;1
2019-11-23 16:30:00;NORTE;14;0;14;1
2019-11-23 17:00:00;NORTE;23;0;23;1
2019-11-23 17:30:00;NORTE;30;0;30;1
2019-11-23 18:00:00;NORTE;17;0;17;1
2019-11-23 18:30:00;NORTE;23;0;23;1
2019-11-23 19:00:00;NORTE;31;0;31;1
2019-11-23 19:30:00;NORTE;16;0;16;1
2019-11-23 20:00:00;NORTE;22;0;22;1
2019-11-23 20:30:00;NORTE;25;0;25;1
2019-11-23 21:00:00;NORTE;19;0;19;1
2019-11-23 21:30:00;NORTE;15;0;15;1
2019-11-23 22:00:00;NORTE;8;0;8;1
2019-11-23 22:30:00;NORTE;5;0;5;1
2019-11-23 23:00:00;NORTE;11;0;11;1
2019-11-23 23:30:00;NORTE;6;0;6;1
2019-11-24 00:00:00;NORTE;1;0;1;1
2019-11-24 00:30:00;NORTE;2;0;2;1
2019-11-24 01:30:00;NORTE;2;0;2;1
2019-11-24 02:00:00;NORTE;3;0;3;1
2019-11-24 02:30:00;NORTE;2;0;2;1
2019-11-24 03:00:00;NORTE;2;0;2;1
2019-11-24 03:30:00;NORTE;3;0;3;1
2019-11-24 04:00:00;NORTE;3;0;3;1
2019-11-24 04:30:00;NORTE;6;0;6;1
2019-11-24 05:00:00;NORTE;8;0;8;1
2019-11-24 05:30:00;NORTE;10;0;10;1
2019-11-24 06:00:00;NORTE;20;0;20;1
2019-11-24 06:30:00;NORTE;24;0;24;1
2019-11-24 07:00:00;NORTE;13;0;13;1
2019-11-24 07:30:00;NORTE;22;0;22;1
2019-11-24 08:00:00;NORTE;33;0;33;1
2019-11-24 08:30:00;NORTE;28;0;28;1
2019-11-24 09:00:00;NORTE;42;0;42;1
2019-11-24 09:30:00;NORTE;31;0;31;1
2019-11-24 10:00:00;NORTE;26;0;26;1
2019-11-24 10:30:00;NORTE;37;0;37;1
2019-11-24 11:00:00;NORTE;39;0;39;1
2019-11-24 11:30:00;NORTE;33;0;33;1
2019-11-24 12:00:00;NORTE;31;0;31;1
2019-11-24 12:30:00;NORTE;31;0;31;1
2019-11-24 13:00:00;NORTE;33;0;33;1
2019-11-24 13:30:00;NORTE;32;0;32;1
2019-11-24 14:00:00;NORTE;41;0;41;1
2019-11-24 14:30:00;NORTE;39;0;39;1
2019-11-24 15:00:00;NORTE;37;0;37;1
2019-11-24 15:30:00;NORTE;25;2;27;1
2019-11-24 16:00:00;SUR;0;34;34;1
2019-11-24 16:30:00;SUR;0;15;15;1
2019-11-24 17:00:00;SUR;0;22;22;1
2019-11-24 17:30:00;SUR;0;32;32;1
2019-11-24 18:00:00;SUR;0;26;26;1
2019-11-24 18:30:00;SUR;0;34;34;1
2019-11-24 19:00:00;SUR;0;43;43;1
2019-11-24 19:30:00;SUR;0;32;32;1
2019-11-24 20:00:00;SUR;0;29;29;1
2019-11-24 20:30:00;SUR;0;33;33;1
2019-11-24 21:00:00;SUR;0;28;28;1
2019-11-24 21:30:00;SUR;0;23;23;1
2019-11-24 22:00:00;SUR;0;12;12;1
2019-11-24 22:30:00;SUR;0;6;6;1
2019-11-24 22:40:00;SUR;0;10;10;1
2019-11-24 23:00:00;SUR;0;12;12;1
2019-11-24 23:30:00;SUR;0;6;6;1
2019-11-25 00:00:00;SUR;0;4;4;1
2019-11-25 01:00:00;SUR;0;1;1;1
2019-11-25 02:30:00;SUR;0;2;2;1
2019-11-25 03:00:00;SUR;0;6;6;1
2019-11-25 03:30:00;SUR;0;4;4;1
2019-11-25 04:00:00;SUR;0;1;1;1
2019-11-25 04:30:00;SUR;0;3;3;1
2019-11-25 05:00:00;SUR;0;8;8;1
2019-11-25 05:30:00;SUR;0;15;15;1
2019-11-25 06:00:00;SUR;0;29;29;1
2019-11-25 06:30:00;SUR;0;12;12;1
2019-11-25 06:39:00;SUR;0;27;27;1
2019-11-25 07:00:00;SUR;0;13;13;1
2019-11-25 07:17:00;SUR;0;7;7;1
2019-11-25 07:30:00;SUR;0;30;30;1
2019-11-25 08:00:00;SUR;0;40;40;1
2019-11-25 08:30:00;SUR;0;36;36;1
2019-11-25 09:00:00;SUR;0;42;42;1
2019-11-25 09:30:00;SUR;0;37;37;1
2019-11-25 10:00:00;SUR;0;31;31;1
2019-11-25 10:30:00;SUR;0;29;29;1
2019-11-25 11:00:00;SUR;0;38;38;1
2019-11-25 11:30:00;SUR;0;31;31;1
2019-11-25 12:00:00;SUR;0;30;30;1
2019-11-25 12:30:00;SUR;0;33;33;1
2019-11-25 13:00:00;SUR;0;26;26;1
2019-11-25 13:30:00;SUR;0;32;32;1
2019-11-25 14:00:00;SUR;0;36;36;1
2019-11-25 14:30:00;SUR;0;37;37;1
2019-11-25 15:00:00;SUR;0;40;40;1
2019-11-25 15:30:00;SUR;0;29;29;1
2019-11-25 16:00:00;SUR;0;30;30;1
2019-11-25 16:30:00;SUR;0;23;23;1
2019-11-25 17:00:00;SUR;0;20;20;1
2019-11-25 17:30:00;SUR;0;31;31;1
2019-11-25 18:00:00;SUR;0;27;27;1
2019-11-25 18:30:00;SUR;0;26;26;1
2019-11-25 19:00:00;SUR;0;34;34;1
2019-11-25 19:30:00;SUR;0;35;35;1
2019-11-25 20:00:00;SUR;0;33;33;1
2019-11-25 20:30:00;SUR;0;29;29;1
2019-11-25 21:00:00;SUR;0;28;28;1
2019-11-25 21:30:00;SUR;0;27;27;1
2019-11-25 22:00:00;SUR;0;14;14;1
2019-11-25 22:30:00;SUR;0;10;10;1
2019-11-25 23:00:00;SUR;0;13;13;1
2019-11-25 23:30:00;SUR;0;5;5;1
2019-11-26 00:00:00;SUR;0;1;1;1
2019-11-26 00:30:00;SUR;0;1;1;1
2019-11-26 02:00:00;SUR;0;2;2;1
2019-11-26 02:30:00;SUR;0;2;2;1
2019-11-26 03:00:00;CONFLICTIVA;2;2;4;2
2019-11-26 03:30:00;NORTE;6;0;6;1
2019-11-26 04:00:00;NORTE;1;0;1;1
2019-11-26 04:30:00;NORTE;6;0;6;1
2019-11-26 04:50:00;NORTE;7;0;7;1
2019-11-26 05:00:00;NORTE;8;0;8;1
2019-11-26 05:30:00;NORTE;9;0;9;1
2019-11-26 06:00:00;NORTE;23;0;23;1
2019-11-26 06:30:00;NORTE;33;0;33;1
2019-11-26 07:00:00;NORTE;24;0;24;1
2019-11-26 07:30:00;NORTE;28;0;28;1
2019-11-26 08:00:00;NORTE;34;0;34;1
2019-11-26 08:30:00;NORTE;30;0;30;1
2019-11-26 09:00:00;NORTE;34;0;34;1
2019-11-26 09:30:00;NORTE;41;0;41;1
2019-11-26 10:00:00;NORTE;23;0;23;1
2019-11-26 10:30:00;NORTE;32;0;32;1
2019-11-26 11:00:00;NORTE;26;0;26;1
2019-11-26 11:18:00;NORTE;12;0;12;1
2019-11-26 11:30:00;NORTE;30;0;30;1
2019-11-26 12:00:00;SUR;0;29;29;1
2019-11-26 12:30:00;SUR;0;30;30;1
2019-11-26 13:00:00;SUR;0;24;24;1
2019-11-26 13:30:00;SUR;0;26;26;1
2019-11-26 13:54:00;SUR;0;7;7;1
2019-11-26 14:00:00;SUR;0;37;37;1
2019-11-26 14:30:00;SUR;0;31;31;1
2019-11-26 15:00:00;SUR;0;33;33;1
2019-11-26 15:30:00;SUR;0;32;32;1
2019-11-26 16:00:00;SUR;0;24;24;1
2019-11-26 16:30:00;SUR;0;22;22;1
2019-11-26 17:00:00;SUR;0;20;20;1
2019-11-26 17:30:00;SUR;0;34;34;1
2019-11-26 18:00:00;SUR;0;24;24;1
2019-11-26 18:30:00;SUR;0;23;23;1
2019-11-26 19:00:00;SUR;0;35;35;1
2019-11-26 19:30:00;SUR;0;30;30;1
2019-11-26 20:00:00;SUR;0;16;16;1
2019-11-26 20:30:00;SUR;0;18;18;1
2019-11-26 20:52:00;SUR;0;8;8;1
2019-11-26 21:00:00;SUR;0;31;31;1
2019-11-26 21:30:00;SUR;0;25;25;1
2019-11-26 22:00:00;SUR;0;13;13;1
2019-11-26 22:30:00;SUR;0;7;7;1
2019-11-26 23:00:00;SUR;0;13;13;1
2019-11-26 23:30:00;SUR;0;9;9;1
2019-11-27 00:00:00;SUR;0;3;3;1
2019-11-27 01:30:00;SUR;0;2;2;1
2019-11-27 02:00:00;SUR;0;3;3;1
2019-11-27 02:30:00;SUR;0;1;1;1
2019-11-27 03:00:00;SUR;0;4;4;1
2019-11-27 03:30:00;SUR;0;4;4;1
2019-11-27 04:00:00;SUR;0;4;4;1
2019-11-27 04:30:00;SUR;0;11;11;1
2019-11-27 05:00:00;SUR;0;6;6;1
2019-11-27 05:30:00;SUR;0;13;13;1
2019-11-27 06:00:00;CONFLICTIVA;5;13;18;2
2019-11-27 06:30:00;NORTE;42;0;42;1
2019-11-27 07:00:00;NORTE;21;0;21;1
2019-11-27 07:30:00;NORTE;20;0;20;1
2019-11-27 08:00:00;NORTE;37;0;37;1
2019-11-27 08:30:00;NORTE;33;0;33;1
2019-11-27 09:00:00;NORTE;39;0;39;1
2019-11-27 09:30:00;NORTE;33;0;33;1
2019-11-27 10:00:00;NORTE;25;0;25;1
2019-11-27 10:30:00;NORTE;32;0;32;1
2019-11-27 11:00:00;NORTE;34;0;34;1
2019-11-27 11:30:00;NORTE;29;0;29;1
2019-11-27 12:00:00;CONFLICTIVA;13;9;22;2
2019-11-27 12:30:00;SUR;0;33;33;1
2019-11-27 13:00:00;SUR;0;28;28;1
2019-11-27 13:30:00;SUR;0;35;35;1
2019-11-27 14:00:00;SUR;0;36;36;1
2019-11-27 14:30:00;SUR;0;31;31;1
2019-11-27 15:00:00;SUR;0;40;40;1
2019-11-27 15:30:00;SUR;0;30;30;1
2019-11-27 16:00:00;SUR;0;34;34;1
2019-11-27 16:30:00;SUR;0;16;16;1
2019-11-27 17:00:00;SUR;0;21;21;1
2019-11-27 17:30:00;SUR;0;30;30;1
2019-11-27 18:00:00;SUR;0;23;23;1
2019-11-27 18:30:00;SUR;0;25;25;1
2019-11-27 19:00:00;SUR;0;38;38;1
2019-11-27 19:30:00;SUR;0;20;20;1
2019-11-27 20:00:00;SUR;0;27;27;1
2019-11-27 20:30:00;SUR;0;28;28;1
2019-11-27 21:00:00;SUR;0;29;29;1
2019-11-27 21:30:00;SUR;0;22;22;1
2019-11-27 22:00:00;SUR;0;16;16;1
2019-11-27 22:30:00;SUR;0;3;3;1
2019-11-27 23:00:00;SUR;0;13;13;1
2019-11-27 23:30:00;SUR;0;4;4;1
2019-11-28 00:00:00;SUR;0;3;3;1
2019-11-28 00:30:00;SUR;0;1;1;1
2019-11-28 02:00:00;SUR;0;1;1;1
2019-11-28 03:00:00;SUR;0;6;6;1
2019-11-28 03:30:00;SUR;0;5;5;1
2019-11-28 04:00:00;SUR;0;4;4;1
2019-11-28 04:30:00;SUR;0;11;11;1
2019-11-28 05:00:00;SUR;0;8;8;1
2019-11-28 05:30:00;SUR;0;11;11;1
2019-11-28 06:00:00;SUR;0;26;26;1
2019-11-28 06:30:00;SUR;0;34;34;1
2019-11-28 07:00:00;SUR;0;19;19;1
2019-11-28 07:30:00;SUR;0;24;24;1
2019-11-28 08:00:00;SUR;0;31;31;1
2019-11-28 08:30:00;SUR;0;36;36;1
2019-11-28 09:00:00;SUR;0;33;33;1
2019-11-28 09:30:00;SUR;0;39;39;1
2019-11-28 10:00:00;SUR;0;27;27;1
2019-11-28 10:30:00;SUR;0;32;32;1
2019-11-28 11:00:00;SUR;0;32;32;1
2019-11-28 11:30:00;SUR;0;33;33;1
2019-11-28 12:00:00;SUR;0;28;28;1
2019-11-28 12:30:00;SUR;0;29;29;1
2019-11-28 13:00:00;SUR;0;26;26;1
2019-11-28 13:30:00;SUR;0;33;33;1
2019-11-28 14:00:00;SUR;0;36;36;1
2019-11-28 14:30:00;SUR;0;35;35;1
2019-11-28 15:00:00;SUR;0;39;39;1
2019-11-28 15:30:00;SUR;0;24;24;1
2019-11-28 16:00:00;SUR;0;30;30;1
2019-11-28 16:30:00;SUR;0;18;18;1
2019-11-28 17:00:00;SUR;0;21;21;1
2019-11-28 17:30:00;SUR;0;34;34;1
2019-11-28 18:00:00;SUR;0;22;22;1
2019-11-28 18:30:00;SUR;0;32;32;1
2019-11-28 19:00:00;SUR;0;49;49;1
2019-11-28 19:30:00;SUR;0;27;27;1
2019-11-28 20:00:00;SUR;0;29;29;1
2019-11-28 20:30:00;SUR;0;29;29;1
2019-11-28 21:00:00;SUR;0;29;29;1
2019-11-28 21:30:00;SUR;0;29;29;1
2019-11-28 22:00:00;SUR;0;12;12;1
2019-11-28 22:30:00;SUR;0;8;8;1
2019-11-28 23:00:00;SUR;0;12;12;1
2019-11-28 23:30:00;SUR;0;4;4;1
2019-11-29 00:00:00;SUR;0;3;3;1
2019-11-29 00:30:00;SUR;0;1;1;1
2019-11-29 01:00:00;SUR;0;2;2;1
2019-11-29 02:00:00;SUR;0;3;3;1
2019-11-29 02:30:00;SUR;0;1;1;1
2019-11-29 03:00:00;SUR;0;3;3;1
2019-11-29 03:30:00;SUR;0;6;6;1
2019-11-29 04:00:00;SUR;0;4;4;1
2019-11-29 04:30:00;SUR;0;8;8;1
2019-11-29 05:00:00;SUR;0;8;8;1
2019-11-29 05:30:00;SUR;0;6;6;1
2019-11-29 05:42:00;SUR;0;9;9;1
2019-11-29 06:00:00;SUR;0;27;27;1
2019-11-29 06:30:00;SUR;0;27;27;1
2019-11-29 07:00:00;SUR;0;22;22;1
2019-11-29 07:30:00;SUR;0;24;24;1
2019-11-29 08:00:00;SUR;0;31;31;1
2019-11-29 08:30:00;SUR;0;31;31;1
2019-11-29 09:00:00;SUR;0;36;36;1
2019-11-29 09:30:00;SUR;0;41;41;1
2019-11-29 10:00:00;SUR;0;34;34;1
2019-11-29 10:30:00;SUR;0;38;38;1
2019-11-29 11:00:00;SUR;0;34;34;1
2019-11-29 11:30:00;SUR;0;29;29;1
2019-11-29 12:00:00;SUR;0;34;34;1
2019-11-29 12:30:00;SUR;0;27;27;1
2019-11-29 13:00:00;SUR;0;33;33;1
2019-11-29 13:30:00;SUR;0;37;37;1
2019-11-29 14:00:00;SUR;0;32;32;1
2019-11-29 14:30:00;SUR;0;35;35;1
2019-11-29 15:00:00;SUR;0;34;34;1
2019-11-29 15:30:00;SUR;0;39;39;1
2019-11-29 16:00:00;SUR;0;31;31;1
2019-11-29 16:30:00;SUR;0;22;22;1
2019-11-29 17:00:00;SUR;0;17;17;1
2019-11-29 17:30:00;SUR;0;35;35;1
2019-11-29 18:00:00;SUR;0;27;27;1
2019-11-29 18:30:00;SUR;0;27;27;1
2019-11-29 19:00:00;SUR;0;40;40;1
2019-11-29 19:30:00;SUR;0;32;32;1
2019-11-29 20:00:00;SUR;0;31;31;1
2019-11-29 20:30:00;SUR;1;30;31;1
2019-11-29 21:00:00;SUR;0;33;33;1
2019-11-29 21:30:00;SUR;0;17;17;1
2019-11-29 22:00:00;CONFLICTIVA;3;11;14;2
2019-11-29 22:30:00;NORTE;14;0;14;1
2019-11-29 23:00:00;NORTE;14;0;14;1
2019-11-29 23:30:00;NORTE;6;0;6;1
2019-11-30 00:00:00;NORTE;1;0;1;1
2019-11-30 01:00:00;NORTE;2;0;2;1
2019-11-30 01:30:00;NORTE;1;0;1;1
2019-11-30 02:00:00;NORTE;1;0;1;1
2019-11-30 02:30:00;NORTE;2;0;2;1
2019-11-30 03:00:00;NORTE;3;0;3;1
2019-11-30 03:30:00;NORTE;4;0;4;1
2019-11-30 04:00:00;NORTE;5;0;5;1
2019-11-30 04:30:00;NORTE;4;0;4;1
2019-11-30 05:00:00;NORTE;7;0;7;1
2019-11-30 05:30:00;SUR;0;11;11;1
2019-11-30 05:50:00;SUR;0;5;5;1
2019-11-30 06:00:00;SUR;0;17;17;1
2019-11-30 06:30:00;SUR;0;29;29;1
2019-11-30 07:00:00;SUR;0;20;20;1
2019-11-30 07:30:00;SUR;0;20;20;1
2019-11-30 08:00:00;SUR;0;35;35;1
2019-11-30 08:30:00;SUR;0;28;28;1
2019-11-30 09:00:00;SUR;0;38;38;1
2019-11-30 09:30:00;SUR;0;37;37;1
2019-11-30 10:00:00;SUR;0;31;31;1
2019-11-30 10:30:00;SUR;0;33;33;1
2019-11-30 11:00:00;SUR;0;30;30;1
2019-11-30 11:30:00;SUR;0;28;28;1
2019-11-30 12:00:00;SUR;0;29;29;1
2019-11-30 12:30:00;SUR;0;33;33;1
2019-11-30 13:00:00;SUR;0;25;25;1
2019-11-30 13:30:00;SUR;0;26;26;1
2019-11-30 14:00:00;SUR;0;38;38;1
2019-11-30 14:30:00;SUR;0;27;27;1
2019-11-30 15:00:00;SUR;0;34;34;1
2019-11-30 15:30:00;SUR;0;33;33;1
2019-11-30 16:00:00;SUR;0;33;33;1
2019-11-30 16:30:00;SUR;0;15;15;1
2019-11-30 17:00:00;SUR;0;14;14;1
2019-11-30 17:30:00;SUR;0;30;30;1
2019-11-30 18:00:00;SUR;0;19;19;1
2019-11-30 18:30:00;SUR;0;24;24;1
2019-11-30 19:00:00;SUR;0;32;32;1
2019-11-30 19:30:00;SUR;0;19;19;1
2019-11-30 20:00:00;SUR;0;21;21;1
2019-11-30 20:30:00;SUR;0;26;26;1
2019-11-30 21:00:00;SUR;0;14;14;1
2019-11-30 21:30:00;SUR;0;20;20;1
2019-11-30 22:00:00;SUR;0;8;8;1
2019-11-30 22:30:00;SUR;0;4;4;1
2019-11-30 23:00:00;SUR;0;12;12;1
2019-11-30 23:30:00;SUR;0;7;7;1
2019-12-01 00:00:00;SUR;0;3;3;1
2019-12-01 00:30:00;SUR;0;2;2;1
2019-12-01 01:00:00;SUR;0;1;1;1
2019-12-01 01:30:00;SUR;0;1;1;1
2019-12-01 02:00:00;SUR;0;2;2;1
2019-12-01 02:30:00;NORTE;3;0;3;1
2019-12-01 03:30:00;NORTE;3;0;3;1
2019-12-01 04:00:00;NORTE;2;0;2;1
2019-12-01 04:30:00;NORTE;3;0;3;1
2019-12-01 05:00:00;NORTE;10;0;10;1
2019-12-01 05:30:00;NORTE;14;0;14;1
2019-12-01 06:00:00;NORTE;20;0;20;1
2019-12-01 06:30:00;NORTE;17;0;17;1
2019-12-01 07:00:00;NORTE;19;0;19;1
2019-12-01 07:30:00;NORTE;28;0;28;1
2019-12-01 08:00:00;NORTE;27;1;28;1
2019-12-01 08:30:00;NORTE;25;0;25;1
2019-12-01 09:00:00;NORTE;13;0;13;1
2019-12-01 09:13:00;NORTE;22;0;22;1
2019-12-01 09:30:00;NORTE;33;0;33;1
2019-12-01 10:00:00;NORTE;29;0;29;1
2019-12-01 10:30:00;NORTE;36;0;36;1
2019-12-01 11:00:00;NORTE;34;0;34;1
2019-12-01 11:30:00;NORTE;36;0;36;1
2019-12-01 12:00:31;NORTE;1;0;1;1
2019-12-01 12:01:30;NORTE;1;0;1;1
2019-12-01 12:02:00;NORTE;29;0;29;1
2019-12-01 12:30:00;NORTE;32;0;32;1
2019-12-01 13:00:00;NORTE;31;0;31;1
2019-12-01 13:30:00;NORTE;34;0;34;1
2019-12-01 14:00:00;NORTE;44;0;44;1
2019-12-01 14:30:00;NORTE;38;0;38;1
2019-12-01 15:00:00;NORTE;37;0;37;1
2019-12-01 15:30:00;NORTE;33;0;33;1
2019-12-01 16:00:00;NORTE;34;0;34;1
2019-12-01 16:30:00;NORTE;7;0;7;1
2019-12-01 16:42:00;NORTE;7;0;7;1
2019-12-01 17:00:00;NORTE;8;0;8;1
2019-12-01 17:10:00;NORTE;16;0;16;1
2019-12-01 17:30:00;NORTE;33;0;33;1
2019-12-01 18:00:00;NORTE;23;0;23;1
2019-12-01 18:30:00;NORTE;29;0;29;1
2019-12-01 19:00:00;NORTE;38;0;38;1
2019-12-01 19:30:00;NORTE;33;0;33;1
2019-12-01 20:00:00;NORTE;27;0;27;1
2019-12-01 20:30:00;NORTE;33;0;33;1
2019-12-01 21:00:00;NORTE;26;0;26;1
2019-12-01 21:30:00;NORTE;28;0;28;1
2019-12-01 22:00:00;NORTE;17;0;17;1
2019-12-01 22:30:00;NORTE;11;0;11;1
2019-12-01 23:00:00;NORTE;10;0;10;1
2019-12-01 23:30:00;NORTE;8;0;8;1
2019-12-02 00:00:00;NORTE;2;0;2;1
2019-12-02 01:00:00;NORTE;3;0;3;1
2019-12-02 02:30:00;NORTE;2;0;2;1
2019-12-02 03:00:00;NORTE;4;0;4;1
2019-12-02 03:30:00;NORTE;4;0;4;1
2019-12-02 04:00:00;NORTE;1;0;1;1
2019-12-02 04:30:00;NORTE;5;0;5;1
2019-12-02 05:00:00;NORTE;9;0;9;1
2019-12-02 05:30:00;NORTE;15;0;15;1
2019-12-02 06:00:00;NORTE;19;0;19;1
2019-12-02 06:30:00;NORTE;41;0;41;1
2019-12-02 07:00:00;NORTE;20;0;20;1
2019-12-02 07:30:00;NORTE;32;0;32;1
2019-12-02 08:00:00;NORTE;37;0;37;1
2019-12-02 08:30:00;NORTE;32;0;32;1
2019-12-02 09:00:00;NORTE;34;0;34;1
2019-12-02 09:30:00;NORTE;42;0;42;1
2019-12-02 10:00:00;NORTE;30;0;30;1
2019-12-02 10:30:00;NORTE;35;0;35;1
2019-12-02 11:00:00;NORTE;40;0;40;1
2019-12-02 11:30:00;NORTE;31;0;31;1
2019-12-02 12:00:00;NORTE;27;0;27;1
2019-12-02 12:30:00;NORTE;34;0;34;1
2019-12-02 13:00:00;NORTE;29;0;29;1
2019-12-02 13:30:00;NORTE;36;0;36;1
2019-12-02 14:00:00;NORTE;36;0;36;1
2019-12-02 14:30:00;NORTE;32;0;32;1
2019-12-02 15:00:00;NORTE;35;0;35;1
2019-12-02 15:30:00;NORTE;37;0;37;1
2019-12-02 16:00:00;NORTE;36;0;36;1
2019-12-02 16:30:00;NORTE;21;0;21;1
2019-12-02 17:00:00;NORTE;20;0;20;1
2019-12-02 17:30:00;NORTE;39;0;39;1
2019-12-02 18:00:00;NORTE;23;0;23;1
2019-12-02 18:30:00;NORTE;30;0;30;1
2019-12-02 19:00:00;NORTE;34;0;34;1
2019-12-02 19:30:00;NORTE;36;0;36;1
2019-12-02 20:00:00;NORTE;32;0;32;1
2019-12-02 20:30:00;NORTE;21;0;21;1
2019-12-02 21:00:00;NORTE;30;0;30;1
2019-12-02 21:30:00;NORTE;25;0;25;1
2019-12-02 22:00:00;NORTE;12;0;12;1
2019-12-02 22:30:00;NORTE;8;0;8;1
2019-12-02 23:00:00;NORTE;13;0;13;1
2019-12-02 23:30:00;NORTE;3;0;3;1
2019-12-03 00:00:00;NORTE;1;0;1;1
2019-12-03 00:30:00;NORTE;1;0;1;1
2019-12-03 01:00:00;NORTE;1;0;1;1
2019-12-03 03:00:00;NORTE;3;0;3;1
2019-12-03 03:30:00;NORTE;8;0;8;1
2019-12-03 04:00:00;NORTE;5;0;5;1
2019-12-03 04:30:00;NORTE;8;0;8;1
2019-12-03 05:00:00;NORTE;7;0;7;1
2019-12-03 05:30:00;NORTE;13;0;13;1
2019-12-03 06:00:00;NORTE;22;0;22;1
2019-12-03 06:30:00;NORTE;38;0;38;1
2019-12-03 07:00:00;NORTE;26;0;26;1
2019-12-03 07:30:00;NORTE;23;0;23;1
2019-12-03 08:00:00;NORTE;36;0;36;1
2019-12-03 08:30:00;NORTE;28;0;28;1
2019-12-03 09:00:00;NORTE;34;0;34;1
2019-12-03 09:30:00;NORTE;33;0;33;1
2019-12-03 10:00:00;NORTE;29;0;29;1
2019-12-03 10:30:00;NORTE;32;0;32;1
2019-12-03 11:00:00;NORTE;26;0;26;1
2019-12-03 11:30:00;NORTE;43;0;43;1
2019-12-03 12:00:00;NORTE;30;0;30;1
2019-12-03 12:30:00;NORTE;29;0;29;1
2019-12-03 13:00:00;NORTE;31;0;31;1
2019-12-03 13:30:00;NORTE;30;0;30;1
2019-12-03 14:00:00;NORTE;28;0;28;1
2019-12-03 14:30:00;NORTE;28;0;28;1
2019-12-03 15:00:00;NORTE;39;0;39;1
2019-12-03 15:30:00;NORTE;29;0;29;1
2019-12-03 16:00:00;NORTE;29;0;29;1
2019-12-03 16:30:00;NORTE;17;0;17;1
2019-12-03 17:00:00;NORTE;21;0;21;1
2019-12-03 17:30:00;NORTE;38;0;38;1
2019-12-03 18:00:00;NORTE;25;0;25;1
2019-12-03 18:30:00;NORTE;26;0;26;1
2019-12-03 19:00:00;NORTE;36;0;36;1
2019-12-03 19:30:00;NORTE;20;0;20;1
2019-12-03 20:00:00;NORTE;26;0;26;1
2019-12-03 20:30:00;NORTE;31;0;31;1
2019-12-03 21:00:00;NORTE;25;0;25;1
2019-12-03 21:30:00;NORTE;25;0;25;1
2019-12-03 22:00:00;NORTE;7;0;7;1
2019-12-03 22:30:00;NORTE;4;0;4;1
2019-12-03 23:00:00;NORTE;11;0;11;1
2019-12-03 23:30:00;NORTE;5;0;5;1
2019-12-04 00:00:00;NORTE;1;0;1;1
2019-12-04 00:30:00;NORTE;1;0;1;1
2019-12-04 01:00:00;NORTE;1;0;1;1
2019-12-04 01:30:00;NORTE;1;0;1;1
2019-12-04 03:00:00;NORTE;3;0;3;1
2019-12-04 03:30:00;NORTE;5;0;5;1
2019-12-04 04:00:00;NORTE;3;0;3;1
2019-12-04 04:30:00;NORTE;9;0;9;1
2019-12-04 05:00:00;NORTE;8;0;8;1
2019-12-04 05:30:00;NORTE;15;0;15;1
2019-12-04 06:00:00;NORTE;20;0;20;1
2019-12-04 06:30:00;NORTE;36;0;36;1
2019-12-04 07:00:00;NORTE;27;0;27;1
2019-12-04 07:30:00;NORTE;23;0;23;1
2019-12-04 08:00:00;NORTE;34;0;34;1
2019-12-04 08:30:00;NORTE;27;0;27;1
2019-12-04 09:00:00;NORTE;36;0;36;1
2019-12-04 09:30:00;NORTE;31;0;31;1
2019-12-04 10:00:00;NORTE;22;0;22;1
2019-12-04 10:30:00;NORTE;39;1;40;1
2019-12-04 11:00:00;NORTE;33;0;33;1
2019-12-04 11:30:00;NORTE;35;0;35;1
2019-12-04 12:00:00;NORTE;26;0;26;1
2019-12-04 12:30:00;NORTE;35;0;35;1
2019-12-04 13:00:00;NORTE;31;0;31;1
2019-12-04 13:30:00;NORTE;30;0;30;1
2019-12-04 14:00:00;NORTE;37;0;37;1
2019-12-04 14:30:00;NORTE;34;0;34;1
2019-12-04 15:00:00;NORTE;39;0;39;1
2019-12-04 15:30:00;NORTE;32;0;32;1
2019-12-04 16:00:00;NORTE;35;0;35;1
2019-12-04 16:30:00;NORTE;13;0;13;1
2019-12-04 17:00:00;NORTE;19;0;19;1
2019-12-04 17:30:00;NORTE;36;0;36;1
2019-12-04 18:00:00;NORTE;23;0;23;1
2019-12-04 18:30:00;NORTE;23;0;23;1
2019-12-04 19:00:00;NORTE;47;0;47;1
2019-12-04 19:30:00;NORTE;22;0;22;1
2019-12-04 20:00:00;NORTE;27;0;27;1
2019-12-04 20:30:00;NORTE;30;0;30;1
2019-12-04 21:00:00;NORTE;27;0;27;1
2019-12-04 21:30:00;NORTE;27;0;27;1
2019-12-04 22:00:00;NORTE;9;0;9;1
2019-12-04 22:30:00;NORTE;3;0;3;1
2019-12-04 23:00:00;NORTE;13;0;13;1
2019-12-04 23:30:00;NORTE;5;0;5;1
2019-12-05 00:00:00;NORTE;2;0;2;1
2019-12-05 01:00:00;NORTE;1;0;1;1
2019-12-05 02:30:00;NORTE;2;0;2;1
2019-12-05 03:00:00;NORTE;2;0;2;1
2019-12-05 03:30:00;NORTE;6;0;6;1
2019-12-05 04:00:00;NORTE;5;0;5;1
2019-12-05 04:30:00;NORTE;11;0;11;1
2019-12-05 05:00:00;NORTE;8;0;8;1
2019-12-05 05:30:00;NORTE;12;0;12;1
2019-12-05 06:00:00;NORTE;18;0;18;1
2019-12-05 06:30:00;NORTE;38;0;38;1
2019-12-05 07:00:00;NORTE;23;0;23;1
2019-12-05 07:30:00;NORTE;24;0;24;1
2019-12-05 08:00:00;NORTE;29;0;29;1
2019-12-05 08:30:00;NORTE;33;1;34;1
2019-12-05 09:00:00;NORTE;32;0;32;1
2019-12-05 09:30:00;NORTE;36;0;36;1
2019-12-05 10:00:00;NORTE;33;0;33;1
2019-12-05 10:30:00;NORTE;35;0;35;1
2019-12-05 11:00:00;NORTE;31;0;31;1
2019-12-05 11:30:00;NORTE;37;0;37;1
2019-12-05 12:00:00;NORTE;28;0;28;1
2019-12-05 12:30:00;NORTE;26;0;26;1
2019-12-05 13:00:00;NORTE;27;0;27;1
2019-12-05 13:30:00;NORTE;28;0;28;1
2019-12-05 14:00:00;NORTE;36;0;36;1
2019-12-05 14:30:00;NORTE;30;0;30;1
2019-12-05 15:00:00;NORTE;38;0;38;1
2019-12-05 15:30:00;NORTE;38;0;38;1
2019-12-05 16:00:00;NORTE;29;0;29;1
2019-12-05 16:30:00;NORTE;18;0;18;1
2019-12-05 17:00:00;NORTE;21;0;21;1
2019-12-05 17:30:00;NORTE;35;0;35;1
2019-12-05 18:00:00;NORTE;28;0;28;1
2019-12-05 18:30:00;NORTE;22;0;22;1
2019-12-05 19:00:00;NORTE;40;0;40;1
2019-12-05 19:30:00;NORTE;34;0;34;1
2019-12-05 20:00:00;NORTE;21;0;21;1
2019-12-05 20:30:00;NORTE;33;0;33;1
2019-12-05 21:00:00;NORTE;28;0;28;1
2019-12-05 21:30:00;NORTE;27;0;27;1
2019-12-05 22:00:00;NORTE;14;0;14;1
2019-12-05 22:30:00;NORTE;11;0;11;1
2019-12-05 23:00:00;NORTE;11;0;11;1
2019-12-05 23:30:00;NORTE;11;0;11;1
2019-12-06 00:00:00;NORTE;4;0;4;1
2019-12-06 00:30:00;NORTE;1;0;1;1
2019-12-06 01:00:00;NORTE;1;0;1;1
2019-12-06 01:30:00;NORTE;1;0;1;1
2019-12-06 02:00:00;NORTE;1;0;1;1
2019-12-06 02:30:00;NORTE;1;0;1;1
2019-12-06 03:00:00;NORTE;5;0;5;1
2019-12-06 03:30:00;NORTE;7;0;7;1
2019-12-06 04:00:00;NORTE;4;0;4;1
2019-12-06 04:30:00;NORTE;10;0;10;1
2019-12-06 05:00:00;NORTE;6;0;6;1
2019-12-06 05:30:00;NORTE;13;0;13;1
2019-12-06 06:00:00;NORTE;19;0;19;1
2019-12-06 06:30:00;NORTE;31;0;31;1
2019-12-06 07:00:00;NORTE;32;0;32;1
2019-12-06 07:30:00;NORTE;20;0;20;1
2019-12-06 08:00:00;NORTE;30;0;30;1
2019-12-06 08:30:00;NORTE;30;0;30;1
2019-12-06 09:00:00;NORTE;37;0;37;1
2019-12-06 09:30:00;NORTE;40;0;40;1
2019-12-06 10:00:00;NORTE;39;0;39;1
2019-12-06 10:30:00;NORTE;29;0;29;1
2019-12-06 11:00:00;NORTE;36;0;36;1
2019-12-06 11:30:00;NORTE;30;0;30;1
2019-12-06 12:00:00;NORTE;28;0;28;1
2019-12-06 12:30:00;NORTE;27;0;27;1
2019-12-06 13:00:00;NORTE;29;0;29;1
2019-12-06 13:30:00;NORTE;28;0;28;1
2019-12-06 14:00:00;NORTE;41;0;41;1
2019-12-06 14:30:00;NORTE;34;0;34;1
2019-12-06 15:00:00;NORTE;40;0;40;1
2019-12-06 15:30:00;NORTE;29;0;29;1
2019-12-06 16:00:00;NORTE;36;0;36;1
2019-12-06 16:30:00;NORTE;20;0;20;1
2019-12-06 17:00:00;NORTE;25;0;25;1
2019-12-06 17:30:00;NORTE;31;0;31;1
2019-12-06 18:00:24;NORTE;1;0;1;1
2019-12-06 18:01:34;NORTE;1;0;1;1
2019-12-06 18:02:59;NORTE;1;0;1;1
2019-12-06 18:03:20;NORTE;1;0;1;1
2019-12-06 18:04:21;NORTE;1;0;1;1
2019-12-06 18:06:10;NORTE;1;0;1;1
2019-12-06 18:06:19;NORTE;1;0;1;1
2019-12-06 18:07:37;NORTE;1;0;1;1
2019-12-06 18:09:17;NORTE;2;0;2;1
2019-12-06 18:10:54;NORTE;1;0;1;1
2019-12-06 18:12:05;NORTE;1;0;1;1
2019-12-06 18:12:32;NORTE;1;0;1;1
2019-12-06 18:13:18;NORTE;1;0;1;1
2019-12-06 18:15:32;NORTE;1;0;1;1
2019-12-06 18:15:38;NORTE;1;0;1;1
2019-12-06 18:16:05;NORTE;1;0;1;1
2019-12-06 18:17:17;NORTE;1;0;1;1
2019-12-06 18:18:07;NORTE;1;0;1;1
2019-12-06 18:19:13;NORTE;1;0;1;1
2019-12-06 18:20:04;NORTE;1;0;1;1
2019-12-06 18:21:25;NORTE;1;0;1;1
2019-12-06 18:22:00;NORTE;1;0;1;1
2019-12-06 18:24:34;NORTE;1;0;1;1
2019-12-06 18:26:30;NORTE;1;0;1;1
2019-12-06 18:30:38;NORTE;1;0;1;1
2019-12-06 18:32:39;NORTE;1;0;1;1
2019-12-06 18:36:43;NORTE;1;0;1;1
2019-12-06 18:36:50;NORTE;1;0;1;1
2019-12-06 18:39:07;NORTE;1;0;1;1
2019-12-06 18:40:12;NORTE;1;0;1;1
2019-12-06 18:40:17;NORTE;2;0;2;1
2019-12-06 18:41:49;NORTE;1;0;1;1
2019-12-06 18:45:50;NORTE;1;0;1;1
2019-12-06 18:48:31;NORTE;1;0;1;1
2019-12-06 18:51:13;NORTE;1;0;1;1
2019-12-06 18:51:21;NORTE;1;0;1;1
2019-12-06 18:52:49;NORTE;1;0;1;1
2019-12-06 18:53:20;NORTE;1;0;1;1
2019-12-06 18:55:10;NORTE;1;0;1;1
2019-12-06 18:55:12;NORTE;1;0;1;1
2019-12-06 18:56:34;NORTE;1;0;1;1
2019-12-06 18:57:32;NORTE;1;0;1;1
2019-12-06 18:57:46;NORTE;1;0;1;1
2019-12-06 18:58:48;NORTE;1;0;1;1
2019-12-06 18:59:29;NORTE;1;0;1;1
2019-12-06 19:00:00;NORTE;32;0;32;1
2019-12-06 19:30:00;NORTE;20;0;20;1
2019-12-06 20:00:00;NORTE;20;0;20;1
2019-12-06 20:30:00;NORTE;29;0;29;1
2019-12-06 21:00:00;NORTE;29;0;29;1
2019-12-06 21:30:00;NORTE;22;0;22;1
2019-12-06 22:00:00;NORTE;13;0;13;1
2019-12-06 22:30:00;NORTE;13;0;13;1
2019-12-06 23:00:00;NORTE;16;0;16;1
2019-12-06 23:30:00;NORTE;6;0;6;1
2019-12-07 00:00:00;NORTE;3;0;3;1
2019-12-07 00:30:00;NORTE;1;0;1;1
2019-12-07 01:00:00;NORTE;2;0;2;1
2019-12-07 02:30:00;NORTE;1;0;1;1
2019-12-07 03:00:00;NORTE;1;0;1;1
2019-12-07 03:30:00;NORTE;8;0;8;1
2019-12-07 04:00:00;NORTE;2;0;2;1
2019-12-07 04:30:00;NORTE;8;0;8;1
2019-12-07 05:00:00;NORTE;6;0;6;1
2019-12-07 05:30:00;NORTE;13;0;13;1
2019-12-07 06:00:00;NORTE;23;0;23;1
2019-12-07 06:30:00;NORTE;17;0;17;1
2019-12-07 07:00:00;NORTE;20;0;20;1
2019-12-07 07:30:00;NORTE;18;0;18;1
2019-12-07 08:00:00;NORTE;32;0;32;1
2019-12-07 08:30:00;NORTE;24;0;24;1
2019-12-07 09:00:00;NORTE;37;0;37;1
2019-12-07 09:30:00;NORTE;35;0;35;1
2019-12-07 10:00:00;NORTE;34;0;34;1
2019-12-07 10:30:00;NORTE;32;0;32;1
2019-12-07 11:00:00;NORTE;37;0;37;1
2019-12-07 11:30:00;NORTE;30;0;30;1
2019-12-07 12:00:00;NORTE;32;0;32;1
2019-12-07 12:30:00;NORTE;24;0;24;1
2019-12-07 13:00:00;NORTE;35;0;35;1
2019-12-07 13:30:00;NORTE;32;0;32;1
2019-12-07 14:00:00;NORTE;26;0;26;1
2019-12-07 14:30:00;NORTE;31;0;31;1
2019-12-07 15:00:00;NORTE;33;0;33;1
2019-12-07 15:30:00;NORTE;24;0;24;1
2019-12-07 16:00:00;NORTE;27;0;27;1
2019-12-07 16:30:00;NORTE;16;0;16;1
2019-12-07 17:00:00;NORTE;20;0;20;1
2019-12-07 17:30:00;NORTE;27;0;27;1
2019-12-07 18:00:00;NORTE;21;0;21;1
2019-12-07 18:30:00;NORTE;16;0;16;1
2019-12-07 19:00:00;NORTE;28;0;28;1
2019-12-07 19:30:00;NORTE;23;0;23;1
2019-12-07 20:00:00;NORTE;19;0;19;1
2019-12-07 20:30:00;NORTE;23;0;23;1
2019-12-07 21:00:00;NORTE;18;0;18;1
2019-12-07 21:30:00;NORTE;9;0;9;1
2019-12-07 22:00:00;NORTE;8;0;8;1
2019-12-07 22:30:00;NORTE;9;0;9;1
2019-12-07 23:00:00;NORTE;15;0;15;1
2019-12-07 23:30:00;NORTE;2;0;2;1
2019-12-08 00:00:00;NORTE;1;0;1;1
2019-12-08 00:30:00;NORTE;2;0;2;1
2019-12-08 01:00:00;NORTE;1;0;1;1
2019-12-08 01:30:00;NORTE;2;0;2;1
2019-12-08 02:30:00;NORTE;2;0;2;1
2019-12-08 03:00:00;NORTE;5;0;5;1
2019-12-08 03:30:00;NORTE;5;0;5;1
2019-12-08 04:30:00;NORTE;1;0;1;1
2019-12-08 04:37:00;NORTE;4;0;4;1
2019-12-08 05:00:00;NORTE;6;0;6;1
2019-12-08 05:30:00;NORTE;12;0;12;1
2019-12-08 06:00:00;NORTE;15;0;15;1
2019-12-08 06:30:00;NORTE;25;0;25;1
2019-12-08 07:00:00;NORTE;18;0;18;1
2019-12-08 07:30:00;NORTE;19;0;19;1
2019-12-08 08:00:00;NORTE;23;0;23;1
2019-12-08 08:30:00;NORTE;24;0;24;1
2019-12-08 09:00:00;NORTE;27;0;27;1
2019-12-08 09:30:00;NORTE;35;0;35;1
2019-12-08 10:00:00;NORTE;4;0;4;1
2019-12-08 10:05:00;NORTE;18;0;18;1
2019-12-08 10:23:00;NORTE;5;0;5;1
2019-12-08 10:30:00;NORTE;44;0;44;1
2019-12-08 11:00:00;NORTE;32;0;32;1
2019-12-08 11:24:00;NORTE;7;0;7;1
2019-12-08 11:30:00;NORTE;36;0;36;1
2019-12-08 12:00:00;NORTE;36;0;36;1
2019-12-08 12:30:00;NORTE;32;0;32;1
2019-12-08 13:00:00;NORTE;27;0;27;1
2019-12-08 13:30:00;NORTE;29;0;29;1
2019-12-08 14:00:00;NORTE;37;0;37;1
2019-12-08 14:30:00;NORTE;43;0;43;1
2019-12-08 15:00:00;NORTE;41;0;41;1
2019-12-08 15:30:00;NORTE;33;0;33;1
2019-12-08 16:00:00;NORTE;28;0;28;1
2019-12-08 16:30:00;NORTE;19;0;19;1
2019-12-08 17:00:00;NORTE;18;0;18;1
2019-12-08 17:30:00;NORTE;39;0;39;1
2019-12-08 18:00:00;NORTE;22;0;22;1
2019-12-08 18:23:00;NORTE;8;0;8;1
2019-12-08 18:30:00;NORTE;27;0;27;1
2019-12-08 19:00:00;NORTE;35;0;35;1
2019-12-08 19:30:00;NORTE;36;0;36;1
2019-12-08 20:00:00;NORTE;29;0;29;1
2019-12-08 20:30:00;NORTE;31;0;31;1
2019-12-08 21:00:00;NORTE;27;0;27;1
2019-12-08 21:30:00;NORTE;24;0;24;1
2019-12-08 22:00:00;NORTE;11;0;11;1
2019-12-08 22:30:00;NORTE;12;0;12;1
2019-12-08 22:50:00;NORTE;4;0;4;1
2019-12-08 23:00:00;NORTE;7;0;7;1
2019-12-08 23:15:00;NORTE;6;0;6;1
2019-12-08 23:30:00;NORTE;8;0;8;1
2019-12-09 00:00:00;NORTE;1;0;1;1
2019-12-09 01:00:00;NORTE;2;0;2;1
2019-12-09 01:30:00;NORTE;1;0;1;1
2019-12-09 03:00:00;NORTE;4;0;4;1
2019-12-09 03:30:00;NORTE;8;0;8;1
2019-12-09 04:00:00;NORTE;1;0;1;1
2019-12-09 04:30:00;NORTE;6;0;6;1
2019-12-09 05:00:00;NORTE;5;0;5;1
2019-12-09 05:30:00;NORTE;8;0;8;1
2019-12-09 06:00:00;NORTE;23;0;23;1
2019-12-09 06:30:00;NORTE;33;0;33;1
2019-12-09 07:00:00;NORTE;29;0;29;1
2019-12-09 07:30:00;NORTE;10;0;10;1
2019-12-09 07:44:00;NORTE;11;0;11;1
2019-12-09 08:00:00;NORTE;39;0;39;1
2019-12-09 08:30:00;NORTE;22;0;22;1
2019-12-09 09:00:00;NORTE;14;0;14;1
2019-12-09 09:14:00;NORTE;19;0;19;1
2019-12-09 09:30:00;NORTE;21;0;21;1
2019-12-09 09:49:00;NORTE;15;0;15;1
2019-12-09 10:00:00;NORTE;31;0;31;1
2019-12-09 10:30:00;NORTE;36;0;36;1
2019-12-09 11:00:00;NORTE;41;0;41;1
2019-12-09 11:30:00;NORTE;30;0;30;1
2019-12-09 12:00:00;NORTE;29;0;29;1
2019-12-09 12:30:00;NORTE;36;0;36;1
2019-12-09 13:00:00;NORTE;30;0;30;1
2019-12-09 13:30:00;NORTE;34;0;34;1
2019-12-09 14:00:00;NORTE;41;0;41;1
2019-12-09 14:30:00;NORTE;37;0;37;1
2019-12-09 15:00:00;NORTE;45;0;45;1
2019-12-09 15:30:00;NORTE;34;0;34;1
2019-12-09 16:00:00;NORTE;36;0;36;1
2019-12-09 16:30:00;NORTE;26;0;26;1
2019-12-09 17:00:00;NORTE;17;0;17;1
2019-12-09 17:30:00;NORTE;36;0;36;1
2019-12-09 18:00:00;NORTE;31;0;31;1
2019-12-09 18:30:00;NORTE;32;0;32;1
2019-12-09 19:00:00;NORTE;43;0;43;1
2019-12-09 19:30:00;NORTE;36;0;36;1
2019-12-09 20:00:00;NORTE;35;0;35;1
2019-12-09 20:30:00;NORTE;24;0;24;1
2019-12-09 21:00:00;NORTE;29;0;29;1
2019-12-09 21:30:00;NORTE;22;0;22;1
2019-12-09 22:00:00;NORTE;17;0;17;1
2019-12-09 22:30:00;NORTE;13;0;13;1
2019-12-09 23:00:00;NORTE;2;0;2;1
2019-12-09 23:09:00;NORTE;10;0;10;1
2019-12-09 23:30:00;NORTE;5;0;5;1
2019-12-10 00:00:00;NORTE;3;0;3;1
2019-12-10 00:30:00;NORTE;3;0;3;1
2019-12-10 01:00:00;NORTE;2;0;2;1
2019-12-10 02:30:00;NORTE;1;0;1;1
2019-12-10 03:00:00;NORTE;5;0;5;1
2019-12-10 03:30:00;NORTE;4;0;4;1
2019-12-10 04:00:00;NORTE;6;0;6;1
2019-12-10 04:30:00;NORTE;8;0;8;1
2019-12-10 05:00:00;NORTE;11;0;11;1
2019-12-10 05:30:00;NORTE;9;0;9;1
2019-12-10 06:00:00;NORTE;18;0;18;1
2019-12-10 06:30:00;NORTE;24;0;24;1
2019-12-10 07:00:00;NORTE;19;0;19;1
2019-12-10 07:30:00;NORTE;19;0;19;1
2019-12-10 08:00:00;NORTE;21;0;21;1
2019-12-10 08:30:00;NORTE;29;0;29;1
2019-12-10 09:00:00;NORTE;38;0;38;1
2019-12-10 09:30:00;NORTE;28;0;28;1
2019-12-10 10:00:00;NORTE;37;0;37;1
2019-12-10 10:30:00;NORTE;27;0;27;1
2019-12-10 11:00:00;NORTE;33;0;33;1
2019-12-10 11:30:00;NORTE;28;0;28;1
2019-12-10 11:53:00;NORTE;6;0;6;1
2019-12-10 12:00:00;NORTE;32;0;32;1
2019-12-10 12:30:00;NORTE;20;0;20;1
2019-12-10 12:50:00;NORTE;9;0;9;1
2019-12-10 13:00:00;NORTE;33;0;33;1
2019-12-10 13:30:00;NORTE;29;0;29;1
2019-12-10 14:00:00;NORTE;32;0;32;1
2019-12-10 14:30:00;NORTE;40;0;40;1
2019-12-10 15:00:00;NORTE;39;0;39;1
2019-12-10 15:30:00;NORTE;34;0;34;1
2019-12-10 16:00:00;NORTE;34;0;34;1
2019-12-10 16:30:00;NORTE;33;0;33;1
2019-12-10 17:00:00;NORTE;19;0;19;1
2019-12-10 17:30:00;NORTE;30;1;31;1
2019-12-10 18:00:00;NORTE;38;0;38;1
2019-12-10 18:30:00;NORTE;28;0;28;1
2019-12-10 19:00:00;NORTE;34;0;34;1
2019-12-10 19:30:00;NORTE;26;0;26;1
2019-12-10 20:00:00;NORTE;17;0;17;1
2019-12-10 20:30:00;NORTE;24;0;24;1
2019-12-10 21:00:00;NORTE;15;0;15;1
2019-12-10 21:18:00;NORTE;11;0;11;1
2019-12-10 21:30:00;NORTE;22;0;22;1
2019-12-10 22:00:06;NORTE;1;0;1;1
2019-12-10 22:03:00;NORTE;16;0;16;1
2019-12-10 22:30:00;NORTE;6;0;6;1
2019-12-10 22:47:00;NORTE;2;0;2;1
2019-12-10 23:00:00;NORTE;10;0;10;1
2019-12-10 23:30:00;NORTE;10;0;10;1
2019-12-11 00:00:00;NORTE;3;0;3;1
2019-12-11 00:30:00;NORTE;2;0;2;1
2019-12-11 01:30:00;NORTE;1;0;1;1
2019-12-11 02:30:00;NORTE;2;0;2;1
2019-12-11 03:00:00;NORTE;5;0;5;1
2019-12-11 03:30:00;NORTE;5;0;5;1
2019-12-11 04:00:00;NORTE;2;0;2;1
2019-12-11 04:30:00;NORTE;4;0;4;1
2019-12-11 04:50:00;NORTE;4;0;4;1
2019-12-11 05:00:00;NORTE;7;0;7;1
2019-12-11 05:30:00;NORTE;12;0;12;1
2019-12-11 05:50:00;NORTE;6;0;6;1
2019-12-11 06:00:00;NORTE;21;0;21;1
2019-12-11 06:30:00;NORTE;34;0;34;1
2019-12-11 07:00:00;NORTE;27;0;27;1
2019-12-11 07:30:00;NORTE;23;0;23;1
2019-12-11 08:00:00;NORTE;31;0;31;1
2019-12-11 08:30:00;NORTE;19;0;19;1
2019-12-11 09:00:00;NORTE;26;0;26;1
2019-12-11 09:30:00;NORTE;10;0;10;1
2019-12-11 09:41:00;NORTE;14;0;14;1
2019-12-11 10:00:00;NORTE;24;0;24;1
2019-12-11 10:17:00;NORTE;10;0;10;1
2019-12-11 10:30:00;NORTE;24;0;24;1
2019-12-11 11:00:00;SUR;3;33;36;1
2019-12-11 11:30:00;SUR;0;29;29;1
2019-12-11 12:00:00;CONFLICTIVA;9;19;28;2
2019-12-11 12:30:00;NORTE;41;0;41;1
2019-12-11 13:00:00;NORTE;31;0;31;1
2019-12-11 13:30:00;NORTE;35;0;35;1
2019-12-11 14:00:00;NORTE;43;0;43;1
2019-12-11 14:30:00;NORTE;39;0;39;1
2019-12-11 15:00:00;NORTE;38;0;38;1
2019-12-11 15:30:00;NORTE;37;0;37;1
2019-12-11 16:00:00;NORTE;32;0;32;1
2019-12-11 16:30:00;NORTE;28;0;28;1
2019-12-11 17:00:00;NORTE;14;0;14;1
2019-12-11 17:30:00;NORTE;43;0;43;1
2019-12-11 18:00:00;NORTE;21;0;21;1
2019-12-11 18:30:00;NORTE;18;0;18;1
2019-12-11 19:00:00;NORTE;39;0;39;1
2019-12-11 19:30:00;NORTE;31;0;31;1
2019-12-11 20:00:00;NORTE;26;0;26;1
2019-12-11 20:30:00;NORTE;31;0;31;1
2019-12-11 21:00:00;NORTE;33;0;33;1
2019-12-11 21:30:00;NORTE;27;0;27;1
2019-12-11 22:00:00;NORTE;12;0;12;1
2019-12-11 22:30:00;NORTE;8;0;8;1
2019-12-11 23:00:00;NORTE;9;0;9;1
2019-12-11 23:30:00;NORTE;5;0;5;1
2019-12-12 00:00:00;NORTE;2;0;2;1
2019-12-12 00:30:00;NORTE;2;0;2;1
2019-12-12 01:00:00;NORTE;1;0;1;1
2019-12-12 01:30:00;NORTE;1;0;1;1
2019-12-12 02:00:00;NORTE;2;0;2;1
2019-12-12 02:30:00;NORTE;2;0;2;1
2019-12-12 03:00:00;NORTE;2;0;2;1
2019-12-12 03:30:00;NORTE;4;0;4;1
2019-12-12 04:00:00;NORTE;8;0;8;1
2019-12-12 04:30:00;CONFLICTIVA;2;3;5;2
2019-12-12 05:00:00;SUR;0;12;12;1
2019-12-12 05:30:00;SUR;0;12;12;1
2019-12-12 06:00:00;SUR;0;29;29;1
2019-12-12 06:30:00;SUR;0;31;31;1
2019-12-12 07:00:00;SUR;0;22;22;1
2019-12-12 07:30:00;SUR;0;21;21;1
2019-12-12 08:00:00;SUR;0;30;30;1
2019-12-12 08:30:00;SUR;0;28;28;1
2019-12-12 09:00:00;SUR;0;26;26;1
2019-12-12 09:30:00;SUR;0;39;39;1
2019-12-12 10:00:00;SUR;0;33;33;1
2019-12-12 10:30:00;SUR;0;30;30;1
2019-12-12 11:00:00;SUR;0;31;31;1
2019-12-12 11:30:00;SUR;0;36;36;1
2019-12-12 12:00:00;SUR;0;32;32;1
2019-12-12 12:30:00;SUR;0;28;28;1
2019-12-12 13:00:00;SUR;0;25;25;1
2019-12-12 13:30:00;SUR;0;33;33;1
2019-12-12 14:00:00;SUR;0;35;35;1
2019-12-12 14:30:00;SUR;0;35;35;1
2019-12-12 15:00:00;SUR;0;37;37;1
2019-12-12 15:30:00;SUR;0;25;25;1
2019-12-12 16:00:00;SUR;0;39;39;1
2019-12-12 16:30:00;SUR;0;26;26;1
2019-12-12 17:00:00;SUR;0;21;21;1
2019-12-12 17:32:01;SUR;0;1;1;1
2019-12-12 17:32:34;SUR;0;1;1;1
2019-12-12 17:34:18;SUR;0;1;1;1
2019-12-12 17:35:00;SUR;0;1;1;1
2019-12-12 17:36:24;SUR;0;1;1;1
2019-12-12 17:38:29;SUR;0;1;1;1
2019-12-12 17:40:18;SUR;0;1;1;1
2019-12-12 17:40:54;SUR;0;1;1;1
2019-12-12 17:41:20;SUR;0;1;1;1
2019-12-12 17:42:18;SUR;0;1;1;1
2019-12-12 17:42:56;SUR;0;1;1;1
2019-12-12 17:43:18;SUR;0;1;1;1
2019-12-12 17:43:40;SUR;0;1;1;1
2019-12-12 17:44:25;SUR;0;1;1;1
2019-12-12 17:44:28;SUR;0;1;1;1
2019-12-12 17:45:50;SUR;0;1;1;1
2019-12-12 17:46:38;SUR;0;1;1;1
2019-12-12 17:48:13;SUR;0;1;1;1
2019-12-12 17:48:32;SUR;0;1;1;1
2019-12-12 17:49:49;SUR;0;2;2;1
2019-12-12 17:50:52;SUR;0;1;1;1
2019-12-12 17:51:54;SUR;0;1;1;1
2019-12-12 17:52:35;SUR;0;1;1;1
2019-12-12 17:57:00;SUR;0;1;1;1
2019-12-12 17:58:11;SUR;0;1;1;1
2019-12-12 17:58:27;SUR;0;1;1;1
2019-12-12 17:59:24;SUR;0;1;1;1
2019-12-12 17:59:53;SUR;0;1;1;1
2019-12-12 18:00:00;SUR;0;32;32;1
2019-12-12 18:30:00;SUR;0;29;29;1
2019-12-12 19:00:00;SUR;0;41;41;1
2019-12-12 19:30:00;SUR;0;25;25;1
2019-12-12 20:00:00;SUR;0;22;22;1
2019-12-12 20:30:00;SUR;0;30;30;1
2019-12-12 21:00:00;SUR;0;27;27;1
2019-12-12 21:30:00;SUR;0;26;26;1
2019-12-12 22:00:00;SUR;0;21;21;1
2019-12-12 22:30:00;SUR;0;10;10;1
2019-12-12 23:00:00;SUR;0;17;17;1
2019-12-12 23:30:00;SUR;0;8;8;1
2019-12-13 00:00:00;SUR;0;1;1;1
2019-12-13 00:30:00;NORTE;1;0;1;1
2019-12-13 01:00:00;NORTE;3;0;3;1
2019-12-13 02:30:00;NORTE;2;0;2;1
2019-12-13 03:00:00;NORTE;3;0;3;1
2019-12-13 03:30:00;NORTE;3;0;3;1
2019-12-13 04:00:00;NORTE;5;0;5;1
2019-12-13 04:30:00;NORTE;8;0;8;1
2019-12-13 05:00:00;NORTE;11;0;11;1
2019-12-13 05:30:00;NORTE;15;0;15;1
2019-12-13 06:00:00;NORTE;24;0;24;1
2019-12-13 06:30:00;NORTE;34;0;34;1
2019-12-13 07:00:00;NORTE;21;0;21;1
2019-12-13 07:30:00;NORTE;14;0;14;1
2019-12-13 08:00:00;NORTE;33;0;33;1
2019-12-13 08:30:00;NORTE;32;0;32;1
2019-12-13 09:00:00;NORTE;27;0;27;1
2019-12-13 09:30:00;NORTE;32;0;32;1
2019-12-13 10:00:00;NORTE;30;0;30;1
2019-12-13 10:30:00;NORTE;29;1;30;1
2019-12-13 11:00:00;CONFLICTIVA;13;17;30;2
2019-12-13 11:30:00;SUR;0;41;41;1
2019-12-13 12:00:00;SUR;0;39;39;1
2019-12-13 12:30:00;SUR;0;30;30;1
2019-12-13 13:00:00;SUR;0;27;27;1
2019-12-13 13:30:00;SUR;0;32;32;1
2019-12-13 14:00:00;SUR;0;42;42;1
2019-12-13 14:30:00;CONFLICTIVA;12;20;32;2
2019-12-13 15:00:00;NORTE;50;0;50;1
2019-12-13 15:30:00;NORTE;33;0;33;1
2019-12-13 16:00:00;NORTE;37;0;37;1
2019-12-13 16:30:00;NORTE;22;0;22;1
2019-12-13 17:00:00;NORTE;22;0;22;1
2019-12-13 17:30:00;NORTE;34;0;34;1
2019-12-13 18:00:00;NORTE;30;0;30;1
2019-12-13 18:30:00;NORTE;27;0;27;1
2019-12-13 19:00:00;NORTE;39;0;39;1
2019-12-13 19:30:00;NORTE;30;0;30;1
2019-12-13 20:00:00;NORTE;33;0;33;1
2019-12-13 20:30:00;NORTE;27;0;27;1
2019-12-13 21:00:00;SUR;0;37;37;1
2019-12-13 21:30:00;SUR;0;22;22;1
2019-12-13 22:00:00;SUR;0;14;14;1
2019-12-13 22:30:00;SUR;0;12;12;1
2019-12-13 23:00:00;SUR;0;11;11;1
2019-12-13 23:30:00;SUR;0;3;3;1
2019-12-14 00:00:00;SUR;0;4;4;1
2019-12-14 00:30:00;SUR;0;2;2;1
2019-12-14 01:30:00;SUR;0;1;1;1
2019-12-14 02:00:00;SUR;0;1;1;1
2019-12-14 02:30:00;SUR;0;1;1;1
2019-12-14 03:00:00;SUR;0;5;5;1
2019-12-14 03:30:00;SUR;0;5;5;1
2019-12-14 04:00:00;CONFLICTIVA;1;2;3;2
2019-12-14 04:30:00;NORTE;3;0;3;1
2019-12-14 05:00:00;NORTE;6;0;6;1
2019-12-14 05:30:00;NORTE;20;0;20;1
2019-12-14 06:00:00;NORTE;20;0;20;1
2019-12-14 06:30:00;NORTE;27;0;27;1
2019-12-14 07:00:00;NORTE;2;0;2;1
2019-12-14 07:07:00;NORTE;9;0;9;1
2019-12-14 07:27:00;NORTE;2;0;2;1
2019-12-14 07:30:00;NORTE;12;0;12;1
2019-12-14 07:49:00;NORTE;6;0;6;1
2019-12-14 08:00:00;NORTE;19;0;19;1
2019-12-14 08:24:00;NORTE;5;0;5;1
2019-12-14 08:30:00;NORTE;22;0;22;1
2019-12-14 09:00:03;NORTE;1;0;1;1
2019-12-14 09:01:28;NORTE;1;0;1;1
2019-12-14 09:02:41;NORTE;1;0;1;1
2019-12-14 09:03:00;NORTE;20;0;20;1
2019-12-14 09:30:00;NORTE;19;0;19;1
2019-12-14 10:00:00;NORTE;27;0;27;1
2019-12-14 10:30:00;NORTE;10;0;10;1
2019-12-14 10:39:00;NORTE;25;0;25;1
2019-12-14 11:00:00;NORTE;21;0;21;1
2019-12-14 11:21:00;NORTE;11;0;11;1
2019-12-14 11:30:00;NORTE;17;0;17;1
2019-12-14 11:48:00;NORTE;7;0;7;1
2019-12-14 12:00:00;NORTE;30;0;30;1
2019-12-14 12:30:00;NORTE;40;0;40;1
2019-12-14 13:00:00;NORTE;26;0;26;1
2019-12-14 13:30:00;NORTE;26;0;26;1
2019-12-14 14:00:00;NORTE;29;0;29;1
2019-12-14 14:30:00;CONFLICTIVA;27;10;37;2
2019-12-14 15:00:00;SUR;0;47;47;1
2019-12-14 15:30:00;SUR;0;34;34;1
2019-12-14 16:00:00;SUR;0;36;36;1
2019-12-14 16:30:00;SUR;0;34;34;1
2019-12-14 17:00:00;SUR;0;27;27;1
2019-12-14 17:30:00;SUR;0;18;18;1
2019-12-14 18:00:00;SUR;0;24;24;1
2019-12-14 18:30:00;SUR;0;21;21;1
2019-12-14 19:00:00;SUR;0;30;30;1
2019-12-14 19:30:00;SUR;0;24;24;1
2019-12-14 20:00:00;SUR;0;21;21;1
2019-12-14 20:30:00;SUR;0;25;25;1
2019-12-14 21:00:00;SUR;0;22;22;1
2019-12-14 21:30:00;SUR;0;16;16;1
2019-12-14 22:00:00;NORTE;17;0;17;1
2019-12-14 22:30:00;NORTE;12;0;12;1
2019-12-14 23:00:00;NORTE;9;0;9;1
2019-12-14 23:30:00;NORTE;5;0;5;1
2019-12-15 00:00:00;NORTE;2;0;2;1
2019-12-15 00:30:00;NORTE;4;0;4;1
2019-12-15 01:00:00;NORTE;1;0;1;1
2019-12-15 01:30:00;NORTE;1;0;1;1
2019-12-15 01:51:00;NORTE;1;0;1;1
2019-12-15 02:00:00;NORTE;1;0;1;1
2019-12-15 02:39:00;NORTE;1;0;1;1
2019-12-15 03:00:00;NORTE;3;0;3;1
2019-12-15 03:30:00;NORTE;2;0;2;1
2019-12-15 04:00:00;NORTE;3;0;3;1
2019-12-15 04:30:00;NORTE;7;0;7;1
2019-12-15 05:00:00;NORTE;3;0;3;1
2019-12-15 05:21:00;NORTE;3;0;3;1
2019-12-15 05:30:00;NORTE;15;0;15;1
2019-12-15 06:00:00;NORTE;18;0;18;1
2019-12-15 06:30:00;NORTE;23;0;23;1
2019-12-15 07:00:00;NORTE;19;0;19;1
2019-12-15 07:30:00;NORTE;21;0;21;1
2019-12-15 08:00:00;NORTE;30;0;30;1
2019-12-15 08:30:00;NORTE;30;0;30;1
2019-12-15 09:00:00;NORTE;39;0;39;1
2019-12-15 09:30:00;NORTE;35;0;35;1
2019-12-15 10:00:00;NORTE;27;0;27;1
2019-12-15 10:30:00;NORTE;33;0;33;1
2019-12-15 11:00:00;NORTE;34;0;34;1
2019-12-15 11:30:00;NORTE;34;0;34;1
2019-12-15 12:00:00;NORTE;37;0;37;1
2019-12-15 12:30:00;NORTE;30;0;30;1
2019-12-15 13:00:00;SUR;0;32;32;1
2019-12-15 13:30:00;SUR;0;29;29;1
2019-12-15 14:00:00;SUR;0;41;41;1
2019-12-15 14:30:00;SUR;0;38;38;1
2019-12-15 15:00:00;SUR;0;40;40;1
2019-12-15 15:30:00;SUR;0;29;29;1
2019-12-15 16:00:00;NORTE;34;0;34;1
2019-12-15 16:30:00;NORTE;19;0;19;1
2019-12-15 17:00:00;NORTE;19;0;19;1
2019-12-15 17:30:00;NORTE;32;0;32;1
2019-12-15 18:00:00;NORTE;29;0;29;1
2019-12-15 18:30:00;NORTE;31;0;31;1
2019-12-15 19:00:00;NORTE;34;0;34;1
2019-12-15 19:30:00;NORTE;34;0;34;1
2019-12-15 20:00:00;NORTE;31;0;31;1
2019-12-15 20:30:00;NORTE;27;0;27;1
2019-12-15 21:00:00;NORTE;30;0;30;1
2019-12-15 21:30:00;NORTE;26;0;26;1
2019-12-15 22:00:00;NORTE;17;0;17;1
2019-12-15 22:30:00;NORTE;16;0;16;1
2019-12-15 23:00:00;NORTE;11;0;11;1
2019-12-15 23:30:00;NORTE;8;0;8;1
2019-12-16 00:00:00;NORTE;1;0;1;1
2019-12-16 00:30:00;NORTE;1;0;1;1
2019-12-16 01:00:00;NORTE;2;0;2;1
2019-12-16 02:00:00;NORTE;2;0;2;1
2019-12-16 02:30:00;NORTE;3;0;3;1
2019-12-16 03:00:00;NORTE;3;0;3;1
2019-12-16 03:30:00;NORTE;6;0;6;1
2019-12-16 04:00:00;NORTE;4;0;4;1
2019-12-16 04:30:00;NORTE;7;0;7;1
2019-12-16 05:00:00;SUR;0;3;3;1
2019-12-16 05:30:00;SUR;0;15;15;1
2019-12-16 06:00:00;SUR;0;24;24;1
2019-12-16 06:30:00;SUR;0;31;31;1
2019-12-16 07:00:00;SUR;0;31;31;1
2019-12-16 07:30:00;SUR;0;24;24;1
2019-12-16 08:00:00;SUR;0;37;37;1
2019-12-16 08:30:00;SUR;0;27;27;1
2019-12-16 09:00:00;SUR;0;31;31;1
2019-12-16 09:30:00;SUR;0;42;42;1
2019-12-16 10:00:00;SUR;0;30;30;1
2019-12-16 10:30:00;SUR;0;40;40;1
2019-12-16 11:00:00;SUR;0;42;42;1
2019-12-16 11:30:00;SUR;0;30;30;1
2019-12-16 12:00:00;SUR;0;33;33;1
2019-12-16 12:30:00;SUR;0;34;34;1
2019-12-16 13:00:00;SUR;0;31;31;1
2019-12-16 13:30:00;SUR;0;29;29;1
2019-12-16 14:00:00;SUR;0;39;39;1
2019-12-16 14:30:00;SUR;0;36;36;1
2019-12-16 15:00:00;SUR;0;40;40;1
2019-12-16 15:30:00;SUR;0;35;35;1
2019-12-16 16:00:00;SUR;0;37;37;1
2019-12-16 16:30:00;SUR;0;24;24;1
2019-12-16 17:00:00;SUR;0;15;15;1
2019-12-16 17:30:00;SUR;0;34;34;1
2019-12-16 18:00:00;SUR;0;32;32;1
2019-12-16 18:30:00;SUR;0;24;24;1
2019-12-16 19:00:00;SUR;0;34;34;1
2019-12-16 19:30:00;SUR;0;32;32;1
2019-12-16 20:00:00;SUR;0;31;31;1
2019-12-16 20:30:00;SUR;0;29;29;1
2019-12-16 21:00:00;SUR;0;30;30;1
2019-12-16 21:30:00;SUR;0;24;24;1
2019-12-16 22:00:00;SUR;0;16;16;1
2019-12-16 22:30:00;SUR;0;14;14;1
2019-12-16 23:00:00;SUR;0;11;11;1
2019-12-16 23:30:00;SUR;0;5;5;1
2019-12-17 00:00:00;SUR;0;2;2;1
2019-12-17 01:00:00;SUR;0;4;4;1
2019-12-17 02:00:00;NORTE;1;0;1;1
2019-12-17 02:30:00;NORTE;2;0;2;1
2019-12-17 03:00:00;NORTE;2;0;2;1
2019-12-17 03:30:00;NORTE;8;0;8;1
2019-12-17 04:00:00;NORTE;3;0;3;1
2019-12-17 04:30:00;NORTE;6;0;6;1
2019-12-17 05:00:00;NORTE;9;0;9;1
2019-12-17 05:30:00;SUR;0;15;15;1
2019-12-17 06:00:00;SUR;0;21;21;1
2019-12-17 06:30:00;SUR;0;33;33;1
2019-12-17 07:00:00;SUR;0;28;28;1
2019-12-17 07:30:00;SUR;0;21;21;1
2019-12-17 08:00:00;SUR;0;28;28;1
2019-12-17 08:30:00;SUR;0;21;21;1
2019-12-17 09:00:00;SUR;0;38;38;1
2019-12-17 09:30:00;SUR;0;37;37;1
2019-12-17 10:00:00;SUR;0;20;20;1
2019-12-17 10:18:00;SUR;0;10;10;1
2019-12-17 10:30:00;SUR;0;31;31;1
2019-12-17 11:00:00;SUR;0;39;39;1
2019-12-17 11:30:00;SUR;0;35;35;1
2019-12-17 12:00:00;SUR;0;31;31;1
2019-12-17 12:30:00;SUR;0;31;31;1
2019-12-17 13:00:00;SUR;0;18;18;1
2019-12-17 13:30:00;SUR;0;31;31;1
2019-12-17 14:00:00;SUR;0;39;39;1
2019-12-17 14:30:00;SUR;0;41;41;1
2019-12-17 15:00:00;SUR;0;36;36;1
2019-12-17 15:30:00;SUR;0;29;29;1
2019-12-17 16:00:00;SUR;0;31;31;1
2019-12-17 16:30:00;SUR;0;21;21;1
2019-12-17 17:00:00;SUR;0;23;23;1
2019-12-17 17:30:00;SUR;0;32;32;1
2019-12-17 18:00:00;SUR;0;26;26;1
2019-12-17 18:30:00;SUR;0;23;23;1
2019-12-17 19:00:00;SUR;0;31;31;1
2019-12-17 19:30:00;SUR;0;25;25;1
2019-12-17 20:00:00;SUR;0;21;21;1
2019-12-17 20:30:00;SUR;0;22;22;1
2019-12-17 21:00:00;SUR;1;26;27;1
2019-12-17 21:30:00;SUR;0;24;24;1
2019-12-17 22:00:00;NORTE;12;0;12;1
2019-12-17 22:30:00;NORTE;9;0;9;1
2019-12-17 23:00:00;NORTE;9;0;9;1
2019-12-17 23:30:00;NORTE;9;0;9;1
2019-12-18 00:00:00;NORTE;3;0;3;1
2019-12-18 00:30:00;NORTE;1;0;1;1
2019-12-18 01:00:00;NORTE;1;0;1;1
2019-12-18 01:30:00;NORTE;2;0;2;1
2019-12-18 02:30:00;NORTE;3;0;3;1
2019-12-18 03:00:00;NORTE;3;0;3;1
2019-12-18 03:30:00;NORTE;7;0;7;1
2019-12-18 04:00:00;NORTE;3;0;3;1
2019-12-18 04:30:00;NORTE;13;0;13;1
2019-12-18 05:00:00;NORTE;7;0;7;1
2019-12-18 05:30:00;NORTE;20;0;20;1
2019-12-18 06:00:00;NORTE;17;0;17;1
2019-12-18 06:30:00;NORTE;33;0;33;1
2019-12-18 07:00:00;NORTE;29;0;29;1
2019-12-18 07:30:00;NORTE;21;0;21;1
2019-12-18 08:00:00;NORTE;34;0;34;1
2019-12-18 08:30:00;NORTE;31;0;31;1
2019-12-18 09:00:00;NORTE;39;0;39;1
2019-12-18 09:30:00;NORTE;32;0;32;1
2019-12-18 10:00:00;NORTE;21;0;21;1
2019-12-18 10:30:00;NORTE;36;0;36;1
2019-12-18 11:00:00;NORTE;35;0;35;1
2019-12-18 11:30:00;NORTE;33;0;33;1
2019-12-18 12:00:00;NORTE;32;0;32;1
2019-12-18 12:30:00;NORTE;36;0;36;1
2019-12-18 13:00:00;NORTE;24;1;25;1
2019-12-18 13:30:00;NORTE;41;0;41;1
2019-12-18 14:00:00;NORTE;39;0;39;1
2019-12-18 14:30:00;NORTE;31;0;31;1
2019-12-18 15:00:00;NORTE;32;0;32;1
2019-12-18 15:30:00;NORTE;39;0;39;1
2019-12-18 16:00:00;NORTE;31;0;31;1
2019-12-18 16:30:00;NORTE;20;0;20;1
2019-12-18 17:00:00;NORTE;20;0;20;1
2019-12-18 17:30:00;NORTE;36;0;36;1
2019-12-18 18:00:00;NORTE;18;0;18;1
2019-12-18 18:30:00;NORTE;27;0;27;1
2019-12-18 19:00:00;NORTE;37;0;37;1
2019-12-18 19:30:00;NORTE;32;0;32;1
2019-12-18 20:00:00;NORTE;23;0;23;1
2019-12-18 20:30:00;NORTE;30;0;30;1
2019-12-18 21:00:00;NORTE;30;0;30;1
2019-12-18 21:30:00;NORTE;28;0;28;1
2019-12-18 22:00:00;NORTE;7;0;7;1
2019-12-18 22:30:00;NORTE;12;0;12;1
2019-12-18 23:00:00;NORTE;13;0;13;1
2019-12-18 23:30:00;NORTE;5;0;5;1
2019-12-19 00:00:00;NORTE;2;0;2;1
2019-12-19 00:30:00;NORTE;1;0;1;1
2019-12-19 02:00:00;NORTE;1;0;1;1
2019-12-19 02:30:00;NORTE;1;0;1;1
2019-12-19 03:00:00;NORTE;4;0;4;1
2019-12-19 03:30:00;NORTE;5;0;5;1
2019-12-19 04:00:00;NORTE;3;0;3;1
2019-12-19 04:30:00;NORTE;6;0;6;1
2019-12-19 05:00:00;SUR;0;11;11;1
2019-12-19 05:30:00;SUR;0;17;17;1
2019-12-19 06:00:00;SUR;0;23;23;1
2019-12-19 06:30:00;SUR;0;34;34;1
2019-12-19 07:00:00;SUR;0;23;23;1
2019-12-19 07:30:00;SUR;0;21;21;1
2019-12-19 08:00:00;SUR;0;38;38;1
2019-12-19 08:30:00;SUR;0;26;26;1
2019-12-19 09:00:00;SUR;0;36;36;1
2019-12-19 09:30:00;SUR;0;37;37;1
2019-12-19 10:00:00;SUR;0;31;31;1
2019-12-19 10:30:00;SUR;0;38;38;1
2019-12-19 11:00:00;SUR;0;33;33;1
2019-12-19 11:30:00;SUR;0;32;32;1
2019-12-19 12:00:00;SUR;0;34;34;1
2019-12-19 12:30:00;SUR;0;39;39;1
2019-12-19 13:00:00;SUR;0;20;20;1
2019-12-19 13:30:00;SUR;0;31;31;1
2019-12-19 14:00:00;SUR;0;34;34;1
2019-12-19 14:30:00;SUR;0;38;38;1
2019-12-19 15:00:00;SUR;0;33;33;1
2019-12-19 15:30:00;SUR;0;41;41;1
2019-12-19 16:00:00;SUR;0;31;31;1
2019-12-19 16:30:00;SUR;0;31;31;1
2019-12-19 17:00:00;SUR;0;14;14;1
2019-12-19 17:30:00;SUR;0;27;27;1
2019-12-19 18:00:00;SUR;0;33;33;1
2019-12-19 18:31:04;SUR;0;1;1;1
2019-12-19 18:31:11;SUR;0;1;1;1
2019-12-19 18:32:00;SUR;0;11;11;1
2019-12-19 18:45:00;SUR;0;17;17;1
2019-12-19 19:00:00;SUR;0;39;39;1
2019-12-19 19:30:00;SUR;0;34;34;1
2019-12-19 20:00:00;SUR;0;32;32;1
2019-12-19 20:30:00;SUR;0;29;29;1
2019-12-19 21:00:00;SUR;0;24;24;1
2019-12-19 21:30:00;SUR;0;31;31;1
2019-12-19 22:00:00;SUR;0;10;10;1
2019-12-19 22:18:00;CONFLICTIVA;1;8;9;2
2019-12-19 22:30:00;SUR;0;16;16;1
2019-12-19 23:00:00;SUR;0;15;15;1
2019-12-19 23:30:00;SUR;0;9;9;1
2019-12-20 00:00:00;SUR;0;8;8;1
2019-12-20 00:30:00;SUR;0;5;5;1
2019-12-20 01:00:00;SUR;0;1;1;1
2019-12-20 01:30:00;SUR;0;1;1;1
2019-12-20 02:00:00;SUR;0;2;2;1
2019-12-20 02:30:00;SUR;0;2;2;1
2019-12-20 03:00:00;SUR;0;3;3;1
2019-12-20 03:30:00;SUR;0;4;4;1
2019-12-20 04:00:00;SUR;0;7;7;1
2019-12-20 04:30:00;SUR;0;6;6;1
2019-12-20 05:00:00;SUR;0;10;10;1
2019-12-20 05:30:00;SUR;0;11;11;1
2019-12-20 06:00:00;SUR;0;28;28;1
2019-12-20 06:30:00;SUR;0;31;31;1
2019-12-20 07:00:00;SUR;0;23;23;1
2019-12-20 07:30:00;SUR;0;24;24;1
2019-12-20 08:00:00;SUR;0;26;26;1
2019-12-20 08:30:00;SUR;0;31;31;1
2019-12-20 09:00:00;SUR;0;38;38;1
2019-12-20 09:30:00;SUR;0;33;33;1
2019-12-20 10:00:00;SUR;0;38;38;1
2019-12-20 10:30:00;SUR;0;39;39;1
2019-12-20 11:00:00;SUR;0;34;34;1
2019-12-20 11:30:00;SUR;0;30;30;1
2019-12-20 12:00:00;SUR;0;30;30;1
2019-12-20 12:30:00;SUR;0;33;33;1
2019-12-20 13:00:00;SUR;0;27;27;1
2019-12-20 13:30:00;SUR;0;35;35;1
2019-12-20 14:00:00;SUR;0;37;37;1
2019-12-20 14:30:00;SUR;0;37;37;1
2019-12-20 15:00:00;SUR;0;43;43;1
2019-12-20 15:30:00;SUR;0;14;14;1
2019-12-20 15:41:00;SUR;0;24;24;1
2019-12-20 16:00:00;SUR;0;33;33;1
2019-12-20 16:30:00;SUR;0;25;25;1
2019-12-20 17:00:00;SUR;0;11;11;1
2019-12-20 17:15:00;SUR;0;10;10;1
2019-12-20 17:30:00;SUR;0;31;31;1
2019-12-20 18:00:00;SUR;0;28;28;1
2019-12-20 18:30:21;SUR;0;1;1;1
2019-12-20 18:30:54;SUR;0;1;1;1
2019-12-20 18:30:58;SUR;0;1;1;1
2019-12-20 18:32:00;SUR;0;22;22;1
2019-12-20 18:55:00;SUR;0;4;4;1
2019-12-20 19:00:00;SUR;0;31;31;1
2019-12-20 19:30:00;SUR;0;27;27;1
2019-12-20 19:50:00;SUR;0;10;10;1
2019-12-20 20:00:00;SUR;0;32;32;1
2019-12-20 20:30:00;SUR;0;33;33;1
2019-12-20 21:00:00;SUR;0;29;29;1
2019-12-20 21:30:00;SUR;0;29;29;1
2019-12-20 22:00:00;SUR;0;17;17;1
2019-12-20 22:30:00;SUR;0;19;19;1
2019-12-20 23:00:00;SUR;0;22;22;1
2019-12-20 23:30:00;SUR;0;17;17;1
2019-12-21 00:00:00;SUR;0;4;4;1
2019-12-21 00:30:00;SUR;0;3;3;1
2019-12-21 01:00:00;SUR;0;1;1;1
2019-12-21 02:30:00;SUR;0;3;3;1
2019-12-21 03:00:00;SUR;0;3;3;1
2019-12-21 03:30:00;SUR;0;8;8;1
2019-12-21 04:00:00;SUR;0;4;4;1
2019-12-21 04:30:00;SUR;0;3;3;1
2019-12-21 05:00:00;SUR;0;7;7;1
2019-12-21 05:30:00;SUR;0;15;15;1
2019-12-21 06:00:00;SUR;0;27;27;1
2019-12-21 06:30:00;SUR;0;24;24;1
2019-12-21 07:00:00;SUR;0;23;23;1
2019-12-21 07:31:11;SUR;0;1;1;1
2019-12-21 07:33:42;SUR;0;1;1;1
2019-12-21 07:34:00;SUR;0;17;17;1
2019-12-21 08:00:00;SUR;0;39;39;1
2019-12-21 08:30:00;SUR;0;30;30;1
2019-12-21 09:00:00;SUR;0;32;32;1
2019-12-21 09:30:00;SUR;0;33;33;1
2019-12-21 10:00:00;SUR;0;36;36;1
2019-12-21 10:30:00;SUR;0;35;35;1
2019-12-21 11:00:00;SUR;0;33;33;1
2019-12-21 11:30:00;SUR;0;24;24;1
2019-12-21 12:00:00;SUR;0;29;29;1
2019-12-21 12:30:00;SUR;0;27;27;1
2019-12-21 13:00:00;SUR;0;24;24;1
2019-12-21 13:30:00;SUR;0;25;25;1
2019-12-21 14:00:00;SUR;0;28;28;1
2019-12-21 14:30:00;SUR;0;36;36;1
2019-12-21 15:00:00;SUR;0;28;28;1
2019-12-21 15:30:00;SUR;0;26;26;1
2019-12-21 16:00:00;SUR;0;31;31;1
2019-12-21 16:30:00;SUR;0;13;13;1
2019-12-21 17:00:00;SUR;0;22;22;1
2019-12-21 17:30:00;SUR;0;16;16;1
2019-12-21 18:00:00;SUR;0;27;27;1
2019-12-21 18:30:00;SUR;0;36;36;1
2019-12-21 19:00:00;SUR;0;37;37;1
2019-12-21 19:30:00;SUR;0;27;27;1
2019-12-21 20:00:00;SUR;0;17;17;1
2019-12-21 20:30:00;SUR;0;28;28;1
2019-12-21 21:00:00;SUR;0;15;15;1
2019-12-21 21:30:00;SUR;0;17;17;1
2019-12-21 22:00:00;SUR;0;21;21;1
2019-12-21 22:30:00;SUR;0;12;12;1
2019-12-21 23:00:00;SUR;0;16;16;1
2019-12-21 23:30:00;SUR;0;19;19;1
2019-12-22 00:00:00;SUR;0;9;9;1
2019-12-22 00:30:00;SUR;0;7;7;1
2019-12-22 01:00:00;SUR;0;7;7;1
2019-12-22 01:30:00;SUR;0;1;1;1
2019-12-22 02:00:00;SUR;0;1;1;1
2019-12-22 02:30:00;SUR;0;2;2;1
2019-12-22 03:00:00;SUR;0;4;4;1
2019-12-22 03:30:00;SUR;0;5;5;1
2019-12-22 04:00:00;SUR;0;3;3;1
2019-12-22 04:30:00;SUR;0;5;5;1
2019-12-22 05:00:00;SUR;0;6;6;1
2019-12-22 05:30:00;SUR;0;14;14;1
2019-12-22 06:00:00;SUR;0;18;18;1
2019-12-22 06:30:00;SUR;0;20;20;1
2019-12-22 07:00:00;SUR;0;18;18;1
2019-12-22 07:30:00;SUR;0;16;16;1
2019-12-22 08:00:00;SUR;0;43;43;1
2019-12-22 08:30:00;SUR;0;22;22;1
2019-12-22 09:00:00;SUR;0;31;31;1
2019-12-22 09:30:00;SUR;0;39;39;1
2019-12-22 10:00:00;SUR;0;33;33;1
2019-12-22 10:30:00;SUR;0;31;31;1
2019-12-22 11:00:00;SUR;0;34;34;1
2019-12-22 11:30:00;SUR;0;35;35;1
2019-12-22 12:00:00;SUR;0;36;36;1
2019-12-22 12:30:00;SUR;0;32;32;1
2019-12-22 13:00:00;SUR;0;27;27;1
2019-12-22 13:30:00;SUR;0;36;36;1
2019-12-22 14:00:00;SUR;0;35;35;1
2019-12-22 14:30:00;SUR;0;37;37;1
2019-12-22 15:00:00;SUR;0;49;49;1
2019-12-22 15:30:00;SUR;0;37;37;1
2019-12-22 16:00:00;SUR;0;30;30;1
2019-12-22 16:30:00;SUR;0;33;33;1
2019-12-22 17:00:00;SUR;0;29;29;1
2019-12-22 17:30:00;SUR;0;27;27;1
2019-12-22 18:00:00;SUR;0;31;31;1
2019-12-22 18:30:00;SUR;0;28;28;1
2019-12-22 19:00:00;CONFLICTIVA;13;18;31;2
2019-12-22 19:30:00;NORTE;35;0;35;1
2019-12-22 20:00:00;NORTE;27;0;27;1
2019-12-22 20:30:00;NORTE;33;0;33;1
2019-12-22 21:00:00;NORTE;29;0;29;1
2019-12-22 21:30:00;NORTE;27;0;27;1
2019-12-22 22:00:00;NORTE;21;0;21;1
2019-12-22 22:30:00;NORTE;15;0;15;1
2019-12-22 23:00:00;NORTE;10;0;10;1
2019-12-22 23:30:00;NORTE;11;0;11;1
2019-12-23 00:00:00;NORTE;8;0;8;1
2019-12-23 00:30:00;NORTE;1;0;1;1
2019-12-23 01:00:00;NORTE;5;0;5;1
2019-12-23 02:00:00;NORTE;1;0;1;1
2019-12-23 02:30:00;NORTE;3;0;3;1
2019-12-23 03:30:00;NORTE;7;0;7;1
2019-12-23 04:00:00;NORTE;2;0;2;1
2019-12-23 04:30:00;NORTE;7;0;7;1
2019-12-23 05:00:00;NORTE;3;0;3;1
2019-12-23 05:30:00;NORTE;14;0;14;1
2019-12-23 06:00:00;NORTE;24;0;24;1
2019-12-23 06:30:00;NORTE;32;0;32;1
2019-12-23 07:00:00;NORTE;19;0;19;1
2019-12-23 07:30:00;NORTE;25;0;25;1
2019-12-23 08:00:00;NORTE;31;0;31;1
2019-12-23 08:30:00;NORTE;36;0;36;1
2019-12-23 09:00:00;NORTE;38;0;38;1
2019-12-23 09:30:00;NORTE;37;0;37;1
2019-12-23 10:00:00;NORTE;31;0;31;1
2019-12-23 10:30:00;NORTE;40;0;40;1
2019-12-23 11:00:00;NORTE;35;0;35;1
2019-12-23 11:30:00;NORTE;33;0;33;1
2019-12-23 12:00:00;NORTE;23;0;23;1
2019-12-23 12:30:00;NORTE;32;0;32;1
2019-12-23 13:00:00;NORTE;27;0;27;1
2019-12-23 13:30:00;NORTE;27;0;27;1
2019-12-23 14:00:00;NORTE;38;0;38;1
2019-12-23 14:30:00;NORTE;38;0;38;1
2019-12-23 15:00:00;NORTE;36;0;36;1
2019-12-23 15:30:00;NORTE;39;0;39;1
2019-12-23 16:00:00;NORTE;30;0;30;1
2019-12-23 16:30:00;NORTE;20;0;20;1
2019-12-23 17:00:00;NORTE;15;0;15;1
2019-12-23 17:30:00;NORTE;32;0;32;1
2019-12-23 18:00:00;NORTE;24;1;25;1
2019-12-23 18:30:00;NORTE;28;0;28;1
2019-12-23 19:00:00;NORTE;38;0;38;1
2019-12-23 19:30:00;NORTE;34;0;34;1
2019-12-23 20:00:00;NORTE;23;0;23;1
2019-12-23 20:30:00;NORTE;33;0;33;1
2019-12-23 21:00:00;NORTE;31;0;31;1
2019-12-23 21:30:00;NORTE;22;0;22;1
2019-12-23 22:00:00;NORTE;15;0;15;1
2019-12-23 22:30:00;NORTE;11;0;11;1
2019-12-23 23:00:00;NORTE;14;0;14;1
2019-12-23 23:30:00;NORTE;2;0;2;1
2019-12-24 00:00:00;NORTE;1;0;1;1
2019-12-24 00:30:00;NORTE;2;0;2;1
2019-12-24 01:00:00;NORTE;1;0;1;1
2019-12-24 01:30:00;NORTE;1;0;1;1
2019-12-24 02:00:00;NORTE;1;0;1;1
2019-12-24 02:30:00;NORTE;1;0;1;1
2019-12-24 03:00:00;NORTE;6;0;6;1
2019-12-24 03:30:00;NORTE;5;0;5;1
2019-12-24 04:00:00;NORTE;4;0;4;1
2019-12-24 04:30:00;NORTE;10;0;10;1
2019-12-24 05:00:00;NORTE;4;0;4;1
2019-12-24 05:30:00;NORTE;15;0;15;1
2019-12-24 06:00:00;NORTE;22;0;22;1
2019-12-24 06:30:00;NORTE;33;0;33;1
2019-12-24 07:00:00;NORTE;20;0;20;1
2019-12-24 07:30:00;NORTE;27;0;27;1
2019-12-24 08:00:00;NORTE;31;0;31;1
2019-12-24 08:30:00;NORTE;31;0;31;1
2019-12-24 09:00:00;NORTE;40;0;40;1
2019-12-24 09:30:00;NORTE;30;0;30;1
2019-12-24 10:00:00;NORTE;14;0;14;1
2019-12-24 10:30:00;NORTE;39;0;39;1
2019-12-24 11:00:00;NORTE;37;0;37;1
2019-12-24 11:30:00;NORTE;28;0;28;1
2019-12-24 12:00:00;NORTE;30;0;30;1
2019-12-24 12:30:00;NORTE;30;0;30;1
2019-12-24 13:00:00;NORTE;28;0;28;1
2019-12-24 13:30:00;NORTE;34;0;34;1
2019-12-24 14:00:00;NORTE;32;0;32;1
2019-12-24 14:30:00;NORTE;27;0;27;1
2019-12-24 15:00:00;NORTE;37;0;37;1
2019-12-24 15:30:00;NORTE;18;0;18;1
2019-12-24 16:00:00;NORTE;21;0;21;1
2019-12-24 16:30:00;NORTE;12;0;12;1
2019-12-24 17:00:00;NORTE;14;0;14;1
2019-12-24 17:30:00;NORTE;24;0;24;1
2019-12-24 18:00:00;NORTE;10;0;10;1
2019-12-24 18:30:00;NORTE;16;0;16;1
2019-12-24 19:00:00;NORTE;20;0;20;1
2019-12-24 19:30:00;NORTE;13;0;13;1
2019-12-24 20:00:00;NORTE;12;0;12;1
2019-12-24 20:30:00;NORTE;10;0;10;1
2019-12-24 21:00:00;NORTE;15;0;15;1
2019-12-24 21:30:00;NORTE;7;0;7;1
2019-12-24 22:00:00;NORTE;3;0;3;1
2019-12-24 22:30:00;NORTE;3;0;3;1
2019-12-24 23:00:00;NORTE;11;0;11;1
2019-12-24 23:30:00;NORTE;2;0;2;1
2019-12-25 01:00:00;NORTE;1;0;1;1
2019-12-25 02:30:00;NORTE;3;0;3;1
2019-12-25 03:00:00;NORTE;2;0;2;1
2019-12-25 03:30:00;NORTE;4;0;4;1
2019-12-25 04:00:00;NORTE;2;0;2;1
2019-12-25 04:30:00;NORTE;5;0;5;1
2019-12-25 05:00:00;NORTE;6;0;6;1
2019-12-25 05:30:00;NORTE;3;0;3;1
2019-12-25 06:00:00;NORTE;12;0;12;1
2019-12-25 06:30:00;NORTE;23;0;23;1
2019-12-25 07:00:00;NORTE;10;0;10;1
2019-12-25 07:30:00;NORTE;17;0;17;1
2019-12-25 08:00:00;NORTE;19;0;19;1
2019-12-25 08:30:00;NORTE;21;0;21;1
2019-12-25 09:00:00;NORTE;28;0;28;1
2019-12-25 09:30:00;NORTE;20;0;20;1
2019-12-25 10:00:00;NORTE;17;0;17;1
2019-12-25 10:30:00;NORTE;26;0;26;1
2019-12-25 11:00:00;NORTE;23;0;23;1
2019-12-25 11:30:00;NORTE;23;0;23;1
2019-12-25 12:00:00;NORTE;25;0;25;1
2019-12-25 12:30:00;NORTE;17;0;17;1
2019-12-25 13:00:00;NORTE;20;0;20;1
2019-12-25 13:30:00;NORTE;16;0;16;1
2019-12-25 14:00:00;NORTE;27;0;27;1
2019-12-25 14:30:00;NORTE;22;0;22;1
2019-12-25 15:00:00;NORTE;30;0;30;1
2019-12-25 15:30:00;NORTE;26;0;26;1
2019-12-25 16:00:00;NORTE;21;0;21;1
2019-12-25 16:30:00;NORTE;12;0;12;1
2019-12-25 17:00:00;NORTE;20;0;20;1
2019-12-25 17:30:00;NORTE;31;1;32;1
2019-12-25 18:00:00;NORTE;11;0;11;1
2019-12-25 18:30:00;NORTE;21;0;21;1
2019-12-25 19:00:00;NORTE;29;0;29;1
2019-12-25 19:30:00;NORTE;22;0;22;1
2019-12-25 20:00:00;NORTE;20;0;20;1
2019-12-25 20:30:00;NORTE;25;0;25;1
2019-12-25 21:00:00;NORTE;18;0;18;1
2019-12-25 21:30:00;NORTE;11;0;11;1
2019-12-25 22:00:00;NORTE;7;0;7;1
2019-12-25 22:30:00;NORTE;6;0;6;1
2019-12-25 23:00:00;NORTE;11;0;11;1
2019-12-25 23:30:00;NORTE;1;0;1;1
2019-12-26 00:00:00;NORTE;1;0;1;1
2019-12-26 01:00:00;NORTE;1;0;1;1
2019-12-26 01:30:00;NORTE;1;0;1;1
2019-12-26 02:30:00;NORTE;2;0;2;1
2019-12-26 03:00:00;NORTE;5;0;5;1
2019-12-26 03:30:00;NORTE;4;0;4;1
2019-12-26 04:00:00;NORTE;3;0;3;1
2019-12-26 04:30:00;NORTE;4;0;4;1
2019-12-26 05:00:00;NORTE;8;0;8;1
2019-12-26 05:30:00;NORTE;8;0;8;1
2019-12-26 06:00:00;NORTE;18;0;18;1
2019-12-26 06:30:00;NORTE;28;0;28;1
2019-12-26 07:00:00;NORTE;23;0;23;1
2019-12-26 07:30:00;NORTE;11;0;11;1
2019-12-26 07:46:00;NORTE;13;0;13;1
2019-12-26 08:00:00;NORTE;11;0;11;1
2019-12-26 08:09:00;NORTE;18;0;18;1
2019-12-26 08:30:00;NORTE;26;0;26;1
2019-12-26 09:00:00;NORTE;34;0;34;1
2019-12-26 09:30:00;NORTE;31;0;31;1
2019-12-26 10:00:00;NORTE;32;0;32;1
2019-12-26 10:30:00;NORTE;36;0;36;1
2019-12-26 11:00:00;NORTE;39;0;39;1
2019-12-26 11:30:00;NORTE;42;0;42;1
2019-12-26 12:00:00;NORTE;33;0;33;1
2019-12-26 12:30:00;NORTE;30;0;30;1
2019-12-26 13:00:00;NORTE;31;0;31;1
2019-12-26 13:30:00;NORTE;37;0;37;1
2019-12-26 14:00:00;NORTE;31;0;31;1
2019-12-26 14:30:00;NORTE;37;0;37;1
2019-12-26 15:00:00;NORTE;40;0;40;1
2019-12-26 15:30:00;NORTE;29;0;29;1
2019-12-26 16:00:00;NORTE;26;0;26;1
2019-12-26 16:30:00;NORTE;17;0;17;1
2019-12-26 17:00:00;NORTE;21;0;21;1
2019-12-26 17:30:00;NORTE;44;0;44;1
2019-12-26 18:00:00;NORTE;28;0;28;1
2019-12-26 18:30:00;NORTE;28;0;28;1
2019-12-26 19:00:00;NORTE;34;0;34;1
2019-12-26 19:30:00;NORTE;33;0;33;1
2019-12-26 20:00:00;NORTE;27;0;27;1
2019-12-26 20:30:00;NORTE;17;0;17;1
2019-12-26 21:00:00;NORTE;17;0;17;1
2019-12-26 21:30:00;NORTE;24;0;24;1
2019-12-26 22:00:00;NORTE;12;0;12;1
2019-12-26 22:30:00;NORTE;9;0;9;1
2019-12-26 23:00:00;NORTE;11;0;11;1
2019-12-26 23:30:00;NORTE;4;0;4;1
2019-12-27 00:30:00;NORTE;2;0;2;1
2019-12-27 01:00:00;NORTE;1;0;1;1
2019-12-27 02:00:00;NORTE;1;0;1;1
2019-12-27 02:30:00;NORTE;3;0;3;1
2019-12-27 03:00:00;NORTE;3;0;3;1
2019-12-27 03:30:00;NORTE;5;0;5;1
2019-12-27 04:00:00;NORTE;3;0;3;1
2019-12-27 04:30:00;NORTE;7;0;7;1
2019-12-27 05:00:00;NORTE;9;0;9;1
2019-12-27 05:30:00;NORTE;12;0;12;1
2019-12-27 06:00:00;NORTE;22;0;22;1
2019-12-27 06:30:00;NORTE;27;0;27;1
2019-12-27 07:00:00;NORTE;15;0;15;1
2019-12-27 07:30:00;NORTE;30;0;30;1
2019-12-27 08:00:00;NORTE;29;0;29;1
2019-12-27 08:30:00;NORTE;32;0;32;1
2019-12-27 09:00:00;NORTE;36;0;36;1
2019-12-27 09:30:00;NORTE;40;0;40;1
2019-12-27 10:00:00;NORTE;13;0;13;1
2019-12-27 10:30:00;NORTE;39;0;39;1
2019-12-27 11:00:00;NORTE;39;0;39;1
2019-12-27 11:30:00;NORTE;29;0;29;1
2019-12-27 12:00:00;NORTE;37;0;37;1
2019-12-27 12:30:00;NORTE;29;0;29;1
2019-12-27 13:00:00;NORTE;28;0;28;1
2019-12-27 13:30:00;NORTE;33;0;33;1
2019-12-27 14:00:00;NORTE;42;0;42;1
2019-12-27 14:30:00;NORTE;31;0;31;1
2019-12-27 15:00:00;NORTE;40;0;40;1
2019-12-27 15:30:00;NORTE;38;0;38;1
2019-12-27 16:00:00;NORTE;37;0;37;1
2019-12-27 16:30:00;NORTE;18;0;18;1
2019-12-27 17:00:00;NORTE;21;0;21;1
2019-12-27 17:30:00;NORTE;29;0;29;1
2019-12-27 18:00:00;NORTE;24;0;24;1
2019-12-27 18:30:00;NORTE;32;0;32;1
2019-12-27 19:00:00;NORTE;43;0;43;1
2019-12-27 19:30:00;NORTE;32;0;32;1
2019-12-27 20:00:00;NORTE;29;0;29;1
2019-12-27 20:30:00;NORTE;33;0;33;1
2019-12-27 21:00:00;NORTE;21;0;21;1
2019-12-27 21:30:00;NORTE;22;0;22;1
2019-12-27 22:00:00;NORTE;11;0;11;1
2019-12-27 22:30:00;NORTE;7;0;7;1
2019-12-27 23:00:00;NORTE;17;0;17;1
2019-12-27 23:30:00;NORTE;3;0;3;1
2019-12-28 00:00:00;NORTE;2;0;2;1
2019-12-28 00:30:00;NORTE;1;0;1;1
2019-12-28 01:30:00;NORTE;1;0;1;1
2019-12-28 02:00:00;NORTE;2;0;2;1
2019-12-28 02:30:00;NORTE;1;0;1;1
2019-12-28 03:00:00;NORTE;7;0;7;1
2019-12-28 03:30:00;NORTE;4;0;4;1
2019-12-28 04:00:00;NORTE;3;0;3;1
2019-12-28 04:30:00;NORTE;4;0;4;1
2019-12-28 05:00:00;NORTE;8;0;8;1
2019-12-28 05:30:00;NORTE;4;0;4;1
2019-12-28 06:00:00;NORTE;24;0;24;1
2019-12-28 06:30:00;NORTE;27;0;27;1
2019-12-28 07:00:00;NORTE;4;0;4;1
2019-12-28 07:30:00;NORTE;23;0;23;1
2019-12-28 08:00:00;NORTE;38;0;38;1
2019-12-28 08:30:00;NORTE;33;0;33;1
2019-12-28 09:00:00;NORTE;35;0;35;1
2019-12-28 09:30:00;NORTE;37;0;37;1
2019-12-28 10:00:00;NORTE;27;0;27;1
2019-12-28 10:30:00;NORTE;36;0;36;1
2019-12-28 11:00:00;NORTE;36;0;36;1
2019-12-28 11:30:00;NORTE;35;0;35;1
2019-12-28 12:00:00;NORTE;31;0;31;1
2019-12-28 12:30:00;NORTE;31;0;31;1
2019-12-28 13:00:00;NORTE;38;0;38;1
2019-12-28 13:30:00;NORTE;34;0;34;1
2019-12-28 14:00:00;NORTE;35;0;35;1
2019-12-28 14:30:00;NORTE;30;0;30;1
2019-12-28 15:00:00;NORTE;38;0;38;1
2019-12-28 15:30:00;NORTE;24;0;24;1
2019-12-28 16:00:00;NORTE;23;0;23;1
2019-12-28 16:30:00;NORTE;19;0;19;1
2019-12-28 17:00:00;NORTE;24;0;24;1
2019-12-28 17:30:00;NORTE;32;0;32;1
2019-12-28 18:00:00;NORTE;17;0;17;1
2019-12-28 18:30:00;NORTE;20;0;20;1
2019-12-28 19:00:00;NORTE;38;0;38;1
2019-12-28 19:30:00;NORTE;21;0;21;1
2019-12-28 20:00:00;NORTE;19;0;19;1
2019-12-28 20:30:00;NORTE;30;0;30;1
2019-12-28 21:00:00;NORTE;23;0;23;1
2019-12-28 21:30:00;NORTE;13;0;13;1
2019-12-28 22:00:00;NORTE;7;0;7;1
2019-12-28 22:30:00;NORTE;4;0;4;1
2019-12-28 23:00:00;NORTE;13;0;13;1
2019-12-28 23:30:00;NORTE;6;0;6;1
2019-12-29 00:00:00;NORTE;3;0;3;1
2019-12-29 01:00:00;NORTE;3;0;3;1
2019-12-29 01:30:00;NORTE;1;0;1;1
2019-12-29 02:00:00;NORTE;1;0;1;1
2019-12-29 02:30:00;NORTE;1;0;1;1
2019-12-29 03:00:00;NORTE;4;0;4;1
2019-12-29 03:30:00;NORTE;2;0;2;1
2019-12-29 04:00:00;NORTE;3;0;3;1
2019-12-29 04:30:00;NORTE;3;0;3;1
2019-12-29 05:00:00;NORTE;13;0;13;1
2019-12-29 05:30:00;NORTE;9;0;9;1
2019-12-29 06:00:00;NORTE;20;0;20;1
2019-12-29 06:30:00;NORTE;24;0;24;1
2019-12-29 07:00:00;NORTE;16;0;16;1
2019-12-29 07:30:00;NORTE;27;0;27;1
2019-12-29 08:00:00;NORTE;26;0;26;1
2019-12-29 08:30:00;NORTE;19;0;19;1
2019-12-29 09:00:00;NORTE;40;0;40;1
2019-12-29 09:30:00;NORTE;30;0;30;1
2019-12-29 10:00:00;NORTE;15;0;15;1
2019-12-29 10:30:00;NORTE;24;0;24;1
2019-12-29 11:00:14;NORTE;1;0;1;1
2019-12-29 11:00:31;NORTE;1;0;1;1
2019-12-29 11:01:21;NORTE;1;0;1;1
2019-12-29 11:01:51;NORTE;1;0;1;1
2019-12-29 11:02:33;NORTE;1;0;1;1
2019-12-29 11:03:23;NORTE;1;0;1;1
2019-12-29 11:03:53;NORTE;1;0;1;1
2019-12-29 11:04:27;NORTE;1;0;1;1
2019-12-29 11:04:32;NORTE;1;0;1;1
2019-12-29 11:05:28;NORTE;1;0;1;1
2019-12-29 11:05:51;NORTE;1;0;1;1
2019-12-29 11:06:23;NORTE;1;0;1;1
2019-12-29 11:07:09;NORTE;1;0;1;1
2019-12-29 11:08:26;NORTE;1;0;1;1
2019-12-29 11:08:41;NORTE;1;0;1;1
2019-12-29 11:09:25;NORTE;1;0;1;1
2019-12-29 11:09:46;NORTE;1;0;1;1
2019-12-29 11:10:44;NORTE;1;0;1;1
2019-12-29 11:11:43;NORTE;1;0;1;1
2019-12-29 11:12:15;NORTE;1;0;1;1
2019-12-29 11:12:18;NORTE;1;0;1;1
2019-12-29 11:13:10;NORTE;1;0;1;1
2019-12-29 11:13:24;NORTE;1;0;1;1
2019-12-29 11:14:18;NORTE;1;0;1;1
2019-12-29 11:15:59;NORTE;1;0;1;1
2019-12-29 11:16:38;NORTE;1;0;1;1
2019-12-29 11:17:00;NORTE;1;0;1;1
2019-12-29 11:17:29;NORTE;1;0;1;1
2019-12-29 11:17:38;NORTE;1;0;1;1
2019-12-29 11:19:19;NORTE;1;0;1;1
2019-12-29 11:19:43;NORTE;1;0;1;1
2019-12-29 11:20:17;NORTE;1;0;1;1
2019-12-29 11:23:03;NORTE;1;0;1;1
2019-12-29 11:23:35;NORTE;1;0;1;1
2019-12-29 11:24:46;NORTE;1;0;1;1
2019-12-29 11:27:06;NORTE;1;0;1;1
2019-12-29 11:27:09;NORTE;1;0;1;1
2019-12-29 11:28:15;NORTE;1;0;1;1
2019-12-29 11:29:15;NORTE;1;0;1;1
2019-12-29 11:29:43;NORTE;1;0;1;1
2019-12-29 11:30:00;NORTE;37;0;37;1
2019-12-29 12:00:00;NORTE;30;0;30;1
2019-12-29 12:30:00;NORTE;23;0;23;1
2019-12-29 13:00:00;NORTE;37;0;37;1
2019-12-29 13:30:00;NORTE;21;0;21;1
2019-12-29 14:00:00;NORTE;42;0;42;1
2019-12-29 14:30:00;NORTE;45;0;45;1
2019-12-29 15:00:00;NORTE;29;0;29;1
2019-12-29 15:30:00;NORTE;30;0;30;1
2019-12-29 16:00:00;NORTE;34;0;34;1
2019-12-29 16:30:00;NORTE;15;0;15;1
2019-12-29 17:00:00;NORTE;26;0;26;1
2019-12-29 17:30:00;NORTE;35;0;35;1
2019-12-29 18:00:00;NORTE;27;0;27;1
2019-12-29 18:30:00;NORTE;19;0;19;1
2019-12-29 19:00:00;NORTE;37;0;37;1
2019-12-29 19:30:00;NORTE;27;0;27;1
2019-12-29 20:00:00;NORTE;31;0;31;1
2019-12-29 20:30:00;NORTE;28;0;28;1
2019-12-29 21:00:00;NORTE;22;1;23;1
2019-12-29 21:30:00;NORTE;26;0;26;1
2019-12-29 22:00:00;NORTE;13;0;13;1
2019-12-29 22:30:00;NORTE;11;0;11;1
2019-12-29 23:00:00;NORTE;14;0;14;1
2019-12-29 23:30:00;NORTE;3;0;3;1
2019-12-30 00:00:00;NORTE;2;0;2;1
2019-12-30 00:30:00;NORTE;2;0;2;1
2019-12-30 01:00:00;NORTE;1;0;1;1
2019-12-30 01:30:00;NORTE;1;0;1;1
2019-12-30 02:00:00;NORTE;2;0;2;1
2019-12-30 02:30:00;NORTE;3;0;3;1
2019-12-30 03:00:00;NORTE;8;0;8;1
2019-12-30 03:30:00;NORTE;4;0;4;1
2019-12-30 04:30:00;NORTE;4;0;4;1
2019-12-30 05:00:00;NORTE;10;0;10;1
2019-12-30 05:30:00;NORTE;9;0;9;1
2019-12-30 06:00:00;NORTE;21;0;21;1
2019-12-30 06:30:00;NORTE;32;0;32;1
2019-12-30 07:00:00;NORTE;29;0;29;1
2019-12-30 07:30:00;NORTE;13;0;13;1
2019-12-30 08:00:00;NORTE;28;0;28;1
2019-12-30 08:30:00;NORTE;33;0;33;1
2019-12-30 09:00:00;NORTE;38;0;38;1
2019-12-30 09:30:00;NORTE;33;0;33;1
2019-12-30 10:00:00;NORTE;38;0;38;1
2019-12-30 10:30:00;NORTE;29;0;29;1
2019-12-30 11:00:00;NORTE;40;0;40;1
2019-12-30 11:30:00;NORTE;39;0;39;1
2019-12-30 12:00:00;NORTE;33;0;33;1
2019-12-30 12:30:00;NORTE;19;0;19;1
2019-12-30 13:00:00;NORTE;28;0;28;1
2019-12-30 13:30:00;NORTE;29;0;29;1
2019-12-30 14:00:00;NORTE;31;0;31;1
2019-12-30 14:30:00;NORTE;26;0;26;1
2019-12-30 15:00:00;NORTE;41;0;41;1
2019-12-30 15:30:00;NORTE;29;0;29;1
2019-12-30 16:00:00;NORTE;34;0;34;1
2019-12-30 16:30:00;NORTE;15;0;15;1
2019-12-30 17:00:00;NORTE;23;0;23;1
2019-12-30 17:30:00;NORTE;36;0;36;1
2019-12-30 18:00:00;NORTE;12;0;12;1
2019-12-30 18:30:00;NORTE;30;0;30;1
2019-12-30 19:00:00;NORTE;35;0;35;1
2019-12-30 19:30:00;NORTE;34;0;34;1
2019-12-30 20:00:00;NORTE;20;0;20;1
2019-12-30 20:30:00;NORTE;31;0;31;1
2019-12-30 21:00:00;NORTE;28;0;28;1
2019-12-30 21:30:00;NORTE;21;0;21;1
2019-12-30 22:00:00;NORTE;13;0;13;1
2019-12-30 22:30:00;NORTE;12;0;12;1
2019-12-30 23:00:00;NORTE;15;0;15;1
2019-12-30 23:30:00;NORTE;1;0;1;1
2019-12-31 00:00:00;NORTE;6;0;6;1
2019-12-31 01:00:00;NORTE;1;0;1;1
2019-12-31 01:30:00;NORTE;1;0;1;1
2019-12-31 02:30:00;NORTE;3;0;3;1
2019-12-31 03:00:00;NORTE;4;0;4;1
2019-12-31 03:30:00;NORTE;4;0;4;1
2019-12-31 04:00:00;NORTE;3;0;3;1
2019-12-31 04:30:00;NORTE;9;0;9;1
2019-12-31 05:00:00;NORTE;4;0;4;1
2019-12-31 05:30:00;NORTE;12;0;12;1
2019-12-31 06:00:00;NORTE;12;0;12;1
2019-12-31 06:30:00;NORTE;28;0;28;1
2019-12-31 07:00:00;NORTE;19;0;19;1
2019-12-31 07:30:00;NORTE;24;0;24;1
2019-12-31 08:00:00;NORTE;34;0;34;1
2019-12-31 08:30:00;NORTE;33;0;33;1
2019-12-31 09:00:00;NORTE;24;0;24;1
2019-12-31 09:30:00;NORTE;34;0;34;1
2019-12-31 10:00:00;NORTE;21;0;21;1
2019-12-31 10:30:00;NORTE;38;0;38;1
2019-12-31 11:00:00;NORTE;39;0;39;1
2019-12-31 11:30:00;NORTE;38;0;38;1
2019-12-31 12:00:00;NORTE;26;0;26;1
2019-12-31 12:30:00;NORTE;30;0;30;1
2019-12-31 13:00:00;NORTE;32;0;32;1
2019-12-31 13:30:00;NORTE;33;0;33;1
2019-12-31 14:00:00;NORTE;29;0;29;1
2019-12-31 14:30:00;NORTE;9;0;9;1
2019-12-31 15:00:00;NORTE;32;0;32;1
2019-12-31 15:30:00;NORTE;21;0;21;1
2019-12-31 16:00:00;NORTE;20;0;20;1
2019-12-31 16:30:00;NORTE;17;0;17;1
2019-12-31 17:00:00;NORTE;17;0;17;1
2019-12-31 17:30:00;NORTE;25;0;25;1
2019-12-31 18:00:00;NORTE;14;0;14;1
2019-12-31 18:30:00;NORTE;18;0;18;1
2019-12-31 19:00:00;NORTE;32;0;32;1
2019-12-31 19:30:00;NORTE;13;0;13;1
2019-12-31 20:00:00;NORTE;17;0;17;1
2019-12-31 20:30:00;NORTE;15;0;15;1
2019-12-31 21:00:00;NORTE;8;0;8;1
2019-12-31 21:30:00;NORTE;7;0;7;1
2019-12-31 22:00:00;NORTE;5;0;5;1
2019-12-31 22:30:00;NORTE;6;0;6;1
2019-12-31 23:00:00;NORTE;8;0;8;1
